MONTH,BENE_STATE_ABRVTN,BENE_STATE_DESC,BENE_COUNTY_DESC,BENE_FIPS_CD,TOT_BENES,ORGNL_MDCR_BENES,MA_AND_OTH_BENES,AGED_TOT_BENES,AGED_ESRD_BENES,AGED_NO_ESRD_BENES,DSBLD_TOT_BENES,DSBLD_ESRD_AND_ESRD_ONLY_BENES,DSBLD_NO_ESRD_BENES,A_B_TOT_BENES,A_B_ORGNL_MDCR_BENES,A_B_MA_AND_OTH_BENES,PRSCRPTN_DRUG_TOT_BENES,PRSCRPTN_DRUG_PDP_BENES,PRSCRPTN_DRUG_MAPD_BENES,PRSCRPTN_DRUG_DEEMED_ELIGIBLE_FULL_LIS_BENES,PRSCRPTN_DRUG_FULL_LIS_BENES,PRSCRPTN_DRUG_PARTIAL_LIS_BENES,PRSCRPTN_DRUG_NO_LIS_BENES
4/1/2013,VA,Virginia,Accomack,51001,7978,7056,922,6736,46,6690,1242,46,1196,7430,6509,921,5105,4298,807,1524,315,87,3179
4/1/2013,VA,Virginia,Albemarle,51003,16379,15035,1344,14899,49,14850,1480,55,1425,14735,13391,1344,10114,8908,1206,1443,242,89,8340
4/1/2013,VA,Virginia,Alexandria City,51510,14732,13434,1298,13362,82,13280,1370,88,1282,11918,10622,1296,6118,4899,1219,1819,329,63,3907
4/1/2013,VA,Virginia,Alleghany,51005,4322,3890,432,3444,22,3422,878,11,867,4090,3658,432,3119,2829,290,801,106,42,2170
4/1/2013,VA,Virginia,Amelia,51007,2615,2118,497,2158,*,*,457,*,*,2401,1904,497,1774,1311,463,445,74,26,1229
4/1/2013,VA,Virginia,Amherst,51009,6989,6010,979,5685,51,5634,1304,34,1270,6518,5539,979,5014,4109,905,1148,198,83,3585
4/1/2013,VA,Virginia,Appomattox,51011,3470,2986,484,2791,27,2764,679,14,665,3272,2788,484,2515,2066,449,662,96,54,1703
4/1/2013,VA,Virginia,Arlington,51013,20633,18773,1860,19008,57,18951,1625,81,1544,16521,14662,1859,8568,6823,1745,2681,322,108,5457
4/1/2013,VA,Virginia,Augusta,51015,15753,13823,1930,13344,58,13286,2409,45,2364,14773,12843,1930,10537,8991,1546,1802,349,128,8258
4/1/2013,VA,Virginia,Bath,51017,1228,1149,79,1066,*,*,162,*,*,1155,1076,79,884,825,59,198,37,23,626
4/1/2013,VA,Virginia,Bedford,51019,16701,14135,2566,14016,62,13954,2685,50,2635,15518,12955,2563,11330,9201,2129,1880,416,161,8873
4/1/2013,VA,Virginia,Bland,51021,1647,1369,278,1238,*,*,409,*,*,1565,1287,278,1118,886,232,231,57,21,809
4/1/2013,VA,Virginia,Botetourt,51023,7376,5868,1508,6269,28,6241,1107,13,1094,6821,5313,1508,4965,3587,1378,812,165,69,3919
4/1/2013,VA,Virginia,Bristol City,51520,4404,2802,1602,3363,*,*,1041,*,*,4126,2524,1602,3314,1757,1557,1030,142,56,2086
4/1/2013,VA,Virginia,Brunswick,51025,3667,3175,492,2931,27,2904,736,36,700,3446,2954,492,2632,2189,443,1036,110,42,1444
4/1/2013,VA,Virginia,Buchanan,51027,7416,5372,2044,4289,16,4273,3127,17,3110,7062,5019,2043,5462,3736,1726,1572,445,122,3323
4/1/2013,VA,Virginia,Buckingham,51029,3079,2707,372,2448,13,2435,631,14,617,2834,2462,372,2092,1780,312,692,133,51,1216
4/1/2013,VA,Virginia,Buena Vista City,51530,1366,1129,237,1088,*,*,278,*,*,1289,1052,237,985,781,204,309,61,19,596
4/1/2013,VA,Virginia,Campbell,51031,11507,9942,1565,9365,65,9300,2142,61,2081,10781,9216,1565,8242,6821,1421,1955,354,175,5758
4/1/2013,VA,Virginia,Caroline,51033,4904,4246,658,4045,30,4015,859,32,827,4465,3807,658,2911,2294,617,753,214,58,1886
4/1/2013,VA,Virginia,Carroll,51035,7431,6528,903,5847,21,5826,1584,15,1569,7066,6163,903,5379,4701,678,1705,268,131,3275
4/1/2013,VA,Virginia,Charles City,51036,1577,1219,358,1317,11,1306,260,17,243,1453,1095,358,1049,744,305,235,77,22,715
4/1/2013,VA,Virginia,Charlotte,51037,3178,2740,438,2568,22,2546,610,14,596,3006,2568,438,2282,1887,395,782,137,42,1321
4/1/2013,VA,Virginia,Charlottesville City,51540,5579,5178,401,4427,24,4403,1152,48,1104,5010,4610,400,3785,3405,380,1193,142,55,2395
4/1/2013,VA,Virginia,Chesapeake City,51550,30827,26162,4665,26151,206,25945,4676,229,4447,27739,23075,4664,15437,11331,4106,3510,751,235,10941
4/1/2013,VA,Virginia,Chesterfield,51041,46563,37714,8849,39767,182,39585,6796,209,6587,41743,32894,8849,29096,20829,8267,4427,853,276,23540
4/1/2013,VA,Virginia,Clarke,51043,2641,2362,279,2408,*,*,233,*,*,2383,2104,279,1465,1221,244,256,78,30,1101
4/1/2013,VA,Virginia,Colonial Heights City,51570,3967,3568,399,3450,*,*,517,18,499,3631,3232,399,2069,1695,374,405,84,16,1564
4/1/2013,VA,Virginia,Covington City,51580,1672,1527,145,1275,*,*,397,*,*,1550,1405,145,1173,1043,130,348,48,25,752
4/1/2013,VA,Virginia,Craig,51045,1192,979,213,900,*,*,292,*,*,1080,867,213,802,595,207,196,40,14,552
4/1/2013,VA,Virginia,Culpeper,51047,7666,6779,887,6521,50,6471,1145,37,1108,7004,6117,887,4402,3639,763,1050,225,72,3055
4/1/2013,VA,Virginia,Cumberland,51049,2044,1706,338,1672,*,*,372,*,*,1900,1563,337,1402,1088,314,415,70,29,888
4/1/2013,VA,Virginia,Danville City,51590,10872,9271,1601,8471,77,8394,2401,111,2290,10304,8703,1601,8263,7161,1102,3056,423,161,4623
4/1/2013,VA,Virginia,Dickenson,51051,4645,3366,1279,2710,*,*,1935,*,*,4400,3121,1279,3077,1933,1144,1067,221,101,1688
4/1/2013,VA,Virginia,Dinwiddie,51053,5082,4271,811,4004,29,3975,1078,26,1052,4654,3843,811,3258,2480,778,859,156,49,2194
4/1/2013,VA,Virginia,Emporia City,51595,1184,958,226,895,13,882,289,12,277,1113,887,226,907,734,173,452,52,16,387
4/1/2013,VA,Virginia,Essex,51057,2568,2235,333,2169,14,2155,399,13,386,2384,2051,333,1682,1394,288,409,90,19,1164
4/1/2013,VA,Virginia,Fairfax,51059,123116,109818,13298,115105,446,114659,8011,435,7576,99760,86484,13276,48130,35815,12315,12110,2109,438,33473
4/1/2013,VA,Virginia,Fairfax City,51600,3186,2803,383,2955,14,2941,231,12,219,2696,2313,383,1294,938,356,304,*,*,930
4/1/2013,VA,Virginia,Falls Church City,51610,1586,1421,165,1489,*,*,97,*,*,1276,1113,163,650,498,152,135,*,*,491
4/1/2013,VA,Virginia,Fauquier,51061,10161,9212,949,9148,45,9103,1013,33,980,8970,8022,948,4904,4133,771,809,166,52,3877
4/1/2013,VA,Virginia,Floyd,51063,3516,2923,593,2974,12,2962,542,*,*,3276,2683,593,2443,1895,548,508,86,45,1804
4/1/2013,VA,Virginia,Fluvanna,51065,4907,4397,510,4365,22,4343,542,19,523,4526,4016,510,2970,2525,445,447,104,19,2400
4/1/2013,VA,Virginia,Franklin,51067,12914,9927,2987,10485,46,10439,2429,22,2407,12088,9101,2987,9163,6444,2719,1928,405,152,6678
4/1/2013,VA,Virginia,Franklin City,51620,1807,1637,170,1398,12,1386,409,21,388,1689,1519,170,1304,1153,151,491,77,16,720
4/1/2013,VA,Virginia,Frederick,51069,13105,11686,1419,11509,45,11464,1596,39,1557,11964,10546,1418,7482,6225,1257,1327,318,139,5698
4/1/2013,VA,Virginia,Fredericksburg City,51630,3454,3202,252,2810,21,2789,644,27,617,3119,2867,252,1979,1747,232,694,80,43,1162
4/1/2013,VA,Virginia,Galax City,51640,1942,1827,115,1480,*,*,462,11,451,1851,1736,115,1431,1353,78,672,78,32,649
4/1/2013,VA,Virginia,Giles,51071,4321,3428,893,3343,19,3324,978,18,960,4062,3170,892,2890,2044,846,752,127,31,1980
4/1/2013,VA,Virginia,Gloucester,51073,7095,6097,998,6046,32,6014,1049,22,1027,6499,5501,998,3650,2782,868,826,166,59,2599
4/1/2013,VA,Virginia,Goochland,51075,4492,3712,780,4023,22,4001,469,14,455,4019,3239,780,3001,2279,722,408,96,41,2456
4/1/2013,VA,Virginia,Grayson,51077,4384,3922,462,3517,12,3505,867,*,*,4222,3760,462,3043,2647,396,1028,165,81,1769
4/1/2013,VA,Virginia,Greene,51079,3130,2810,320,2696,16,2680,434,12,422,2877,2557,320,1930,1640,290,434,72,31,1393
4/1/2013,VA,Virginia,Greensville,51081,2258,1727,531,1793,20,1773,465,22,443,2098,1567,531,1702,1247,455,522,125,33,1022
4/1/2013,VA,Virginia,Halifax,51083,9059,7908,1151,7178,62,7116,1881,56,1825,8558,7408,1150,6754,5686,1068,2235,405,136,3978
4/1/2013,VA,Virginia,Hampton City,51650,22138,18395,3743,17958,187,17771,4180,201,3979,20254,16511,3743,10535,7139,3396,3240,739,189,6367
4/1/2013,VA,Virginia,Hanover,51085,16845,13683,3162,15062,74,14988,1783,48,1735,15382,12220,3162,11100,8266,2834,1264,331,105,9400
4/1/2013,VA,Virginia,Harrisonburg City,51660,4681,4199,482,3926,20,3906,755,21,734,4274,3792,482,3162,2903,259,834,112,44,2172
4/1/2013,VA,Virginia,Henrico,51087,47208,37880,9328,40551,286,40265,6657,316,6341,42787,33462,9325,31174,22519,8655,5462,1144,362,24206
4/1/2013,VA,Virginia,Henry,51089,14540,10760,3780,11295,57,11238,3245,67,3178,13894,10114,3780,11506,8651,2855,3030,636,231,7609
4/1/2013,VA,Virginia,Highland,51091,684,629,55,619,*,*,65,0,65,647,592,55,449,399,50,74,*,*,347
4/1/2013,VA,Virginia,Hopewell City,51670,4197,3706,491,3262,24,3238,935,36,899,3908,3417,491,2501,2025,476,855,130,40,1476
4/1/2013,VA,Virginia,Isle of Wight,51093,6802,5508,1294,5817,37,5780,985,33,952,6298,5004,1294,3963,2746,1217,901,167,74,2821
4/1/2013,VA,Virginia,James City,51095,16559,14933,1626,15478,43,15435,1081,40,1041,15276,13653,1623,8175,6752,1423,781,178,47,7169
4/1/2013,VA,Virginia,King and Queen,51097,1509,1322,187,1252,*,*,257,*,*,1414,1227,187,1031,853,178,252,*,*,687
4/1/2013,VA,Virginia,King George,51099,3054,2852,202,2617,20,2597,437,23,414,2670,2468,202,1267,1082,185,391,78,24,774
4/1/2013,VA,Virginia,King William,51101,2748,2377,371,2335,18,2317,413,17,396,2525,2154,371,1890,1550,340,366,74,21,1429
4/1/2013,VA,Virginia,Lancaster,51103,3998,3592,406,3675,14,3661,323,13,310,3806,3400,406,2447,2144,303,460,90,31,1866
4/1/2013,VA,Virginia,Lee,51105,6141,4356,1785,3985,12,3973,2156,18,2138,5792,4010,1782,4510,2852,1658,1863,258,80,2309
4/1/2013,VA,Virginia,Lexington City,51678,1550,1414,136,1412,*,*,138,*,*,1447,1311,136,1057,949,108,191,*,*,822
4/1/2013,VA,Virginia,Loudoun,51107,26238,22753,3485,24260,85,24175,1978,88,1890,21776,18296,3480,12281,9082,3199,2232,467,112,9470
4/1/2013,VA,Virginia,Louisa,51109,6437,5551,886,5311,32,5279,1126,29,1097,5878,4992,886,4000,3169,831,1009,230,73,2688
4/1/2013,VA,Virginia,Lunenburg,51111,2758,2475,283,2216,12,2204,542,25,517,2560,2277,283,1850,1587,263,664,102,40,1044
4/1/2013,VA,Virginia,Lynchburg City,51680,13869,12266,1603,10861,85,10776,3008,102,2906,12931,11328,1603,10014,8567,1447,3203,422,149,6240
4/1/2013,VA,Virginia,Madison,51113,2624,2344,280,2298,12,2286,326,*,*,2463,2183,280,1672,1414,258,396,80,24,1172
4/1/2013,VA,Virginia,Manassas City,51683,3611,3171,440,3120,21,3099,491,29,462,3101,2661,440,1913,1536,377,505,97,21,1290
4/1/2013,VA,Virginia,Manassas Park City,51685,996,837,159,853,11,842,143,*,*,849,690,159,550,407,143,137,*,*,367
4/1/2013,VA,Virginia,Martinsville City,51690,3858,3070,788,2856,19,2837,1002,31,971,3685,2897,788,3123,2523,600,1272,151,52,1648
4/1/2013,VA,Virginia,Mathews,51115,2563,2243,320,2323,*,*,240,*,*,2426,2106,320,1426,1133,293,255,41,20,1110
4/1/2013,VA,Virginia,Mecklenburg,51117,8565,7311,1254,6922,54,6868,1643,41,1602,8057,6805,1252,6109,5109,1000,1854,367,111,3777
4/1/2013,VA,Virginia,Middlesex,51119,3250,2839,411,2881,16,2865,369,11,358,3065,2654,411,2118,1791,327,413,86,23,1596
4/1/2013,VA,Virginia,Montgomery,51121,12128,10435,1693,9864,30,9834,2264,30,2234,11045,9352,1693,8468,6867,1601,1756,267,105,6340
4/1/2013,VA,Virginia,Nelson,51125,3882,3507,375,3348,*,*,534,16,518,3581,3206,375,2439,2105,334,598,106,39,1696
4/1/2013,VA,Virginia,New Kent,51127,3320,2809,511,2886,19,2867,434,12,422,3011,2500,511,1935,1501,434,272,71,24,1568
4/1/2013,VA,Virginia,Newport News City,51700,24707,20126,4581,20174,174,20000,4533,219,4314,22631,18051,4580,12831,8567,4264,4129,736,220,7746
4/1/2013,VA,Virginia,Norfolk City,51710,29246,24274,4972,23050,226,22824,6196,330,5866,26416,21444,4972,16210,11807,4403,6564,1096,295,8255
4/1/2013,VA,Virginia,Northampton,51131,3235,2889,346,2718,24,2694,517,33,484,3047,2701,346,2355,2044,311,899,96,34,1326
4/1/2013,VA,Virginia,Northumberland,51133,4354,3982,372,4000,12,3988,354,11,343,4085,3713,372,2419,2144,275,425,91,27,1876
4/1/2013,VA,Virginia,Norton City,51720,1148,905,243,715,*,*,433,*,*,1052,809,243,807,581,226,353,52,20,382
4/1/2013,VA,Virginia,Nottoway,51135,3461,3021,440,2816,22,2794,645,14,631,3204,2764,440,2404,2122,282,887,117,43,1357
4/1/2013,VA,Virginia,Orange,51137,7746,7053,693,6763,37,6726,983,30,953,7144,6452,692,4182,3609,573,908,226,67,2981
4/1/2013,VA,Virginia,Page,51139,5551,4920,631,4506,17,4489,1045,15,1030,5182,4551,631,3534,2964,570,1067,205,89,2173
4/1/2013,VA,Virginia,Patrick,51141,4874,3913,961,3938,15,3923,936,11,925,4658,3698,960,3617,2831,786,992,195,73,2357
4/1/2013,VA,Virginia,Petersburg City,51730,6915,6006,909,5004,71,4933,1911,77,1834,6324,5415,909,4404,3587,817,2070,309,75,1950
4/1/2013,VA,Virginia,Pittsylvania,51143,14646,11799,2847,11712,84,11628,2934,79,2855,13907,11060,2847,11046,9068,1978,2977,540,238,7291
4/1/2013,VA,Virginia,Poquoson City,51735,2293,2083,210,2117,*,*,176,*,*,2091,1881,210,825,633,192,109,*,*,684
4/1/2013,VA,Virginia,Portsmouth City,51740,16615,13627,2988,12815,167,12648,3800,201,3599,14863,11875,2988,8897,6213,2684,3535,686,143,4533
4/1/2013,VA,Virginia,Powhatan,51145,4736,3884,852,4142,19,4123,594,20,574,4304,3452,852,3114,2341,773,367,84,33,2630
4/1/2013,VA,Virginia,Prince Edward,51147,4223,3656,567,3292,18,3274,931,34,897,3930,3363,567,2937,2485,452,1000,180,48,1709
4/1/2013,VA,Virginia,Prince George,51149,4872,4354,518,4042,24,4018,830,25,805,4500,3983,517,2537,2050,487,510,107,24,1896
4/1/2013,VA,Virginia,Prince William,51153,36373,31717,4656,31943,186,31757,4430,264,4166,30982,26329,4653,15782,11594,4188,4047,776,179,10780
4/1/2013,VA,Virginia,Pulaski,51155,8376,7181,1195,6447,30,6417,1929,26,1903,7857,6662,1195,5805,4664,1141,1625,312,121,3747
4/1/2013,VA,Virginia,Radford City,51750,1958,1669,289,1560,*,*,398,11,387,1811,1522,289,1449,1167,282,319,47,33,1050
4/1/2013,VA,Virginia,Rappahannock,51157,1762,1652,110,1576,*,*,186,*,*,1609,1499,110,951,861,90,173,*,*,736
4/1/2013,VA,Virginia,Richmond,51159,1747,1486,261,1506,13,1493,241,*,*,1652,1391,261,1139,916,223,269,77,25,768
4/1/2013,VA,Virginia,Richmond City,51760,30067,23345,6722,23009,267,22742,7058,341,6717,27134,20414,6720,21300,14857,6443,7928,1265,306,11801
4/1/2013,VA,Virginia,Roanoke,51161,20543,17022,3521,17954,70,17884,2589,43,2546,19013,15492,3521,13475,10117,3358,1835,364,128,11148
4/1/2013,VA,Virginia,Roanoke City,51770,18806,15133,3673,13738,118,13620,5068,124,4944,17203,13531,3672,13111,9592,3519,4463,737,229,7682
4/1/2013,VA,Virginia,Rockbridge,51163,5359,4508,851,4439,22,4417,920,13,907,5014,4163,851,3586,2914,672,799,154,69,2564
4/1/2013,VA,Virginia,Rockingham,51165,14880,12562,2318,12920,59,12861,1960,40,1920,13819,11502,2317,9888,8872,1016,1678,414,152,7644
4/1/2013,VA,Virginia,Russell,51167,7512,5716,1796,4779,14,4765,2733,12,2721,7159,5363,1796,5368,3727,1641,1696,276,118,3278
4/1/2013,VA,Virginia,Salem City,51775,5594,4745,849,4684,27,4657,910,16,894,5123,4274,849,3756,2945,811,802,122,51,2781
4/1/2013,VA,Virginia,Scott,51169,6347,3438,2909,4630,13,4617,1717,*,*,6063,3154,2909,5074,2223,2851,1506,239,106,3223
4/1/2013,VA,Virginia,Shenandoah,51171,9311,8341,970,8131,18,8113,1180,26,1154,8706,7736,970,5572,4729,843,1190,205,99,4078
4/1/2013,VA,Virginia,Smyth,51173,8411,6923,1488,6049,23,6026,2362,23,2339,7942,6454,1488,6115,4750,1365,2106,360,152,3497
4/1/2013,VA,Virginia,Southampton,51175,3626,3220,406,3015,28,2987,611,23,588,3378,2972,406,2538,2185,353,679,125,39,1695
4/1/2013,VA,Virginia,Spotsylvania,51177,16157,14602,1555,13816,91,13725,2341,87,2254,14339,12784,1555,7933,6575,1358,1575,474,122,5762
4/1/2013,VA,Virginia,Stafford,51179,12872,11976,896,11214,65,11149,1658,93,1565,11279,10384,895,5210,4455,755,1082,288,84,3756
4/1/2013,VA,Virginia,Staunton City,51790,5596,5061,535,4524,29,4495,1072,21,1051,5238,4704,534,3901,3450,451,991,149,53,2708
4/1/2013,VA,Virginia,Suffolk City,51800,13229,11054,2175,10611,71,10540,2618,77,2541,12068,9894,2174,7757,5904,1853,2497,380,110,4770
4/1/2013,VA,Virginia,Surry,51181,1373,1074,299,1131,*,*,242,12,230,1259,960,299,874,595,279,207,67,13,587
4/1/2013,VA,Virginia,Sussex,51183,2244,1888,356,1783,31,1752,461,*,*,2078,1722,356,1515,1178,337,499,138,29,849
4/1/2013,VA,Virginia,Tazewell,51185,11313,9136,2177,7964,40,7924,3349,35,3314,10714,8537,2177,7848,6130,1718,2155,431,162,5100
4/1/2013,VA,Virginia,Unknown,51999,*,*,*,*,*,*,*,*,*,*,*,*,*,*,*,*,*,*,*
4/1/2013,VA,Virginia,Virginia Beach City,51810,58528,51311,7217,51138,308,50830,7390,284,7106,53432,46221,7211,27314,20952,6362,5816,1128,340,20030
4/1/2013,VA,Virginia,Warren,51187,6317,5728,589,5343,28,5315,974,22,952,5770,5181,589,3526,3007,519,812,203,66,2445
4/1/2013,VA,Virginia,Washington,51191,13834,9995,3839,10658,46,10612,3176,15,3161,12981,9144,3837,9766,6150,3616,2448,472,190,6656
4/1/2013,VA,Virginia,Waynesboro City,51820,4519,4036,483,3678,21,3657,841,24,817,4231,3748,483,3171,2762,409,823,102,45,2201
4/1/2013,VA,Virginia,Westmoreland,51193,4388,4024,364,3840,28,3812,548,13,535,4040,3676,364,2375,2057,318,740,121,35,1479
4/1/2013,VA,Virginia,Williamsburg City,51830,2258,1993,265,2065,*,*,193,*,*,2028,1763,265,1271,1040,231,199,*,*,1030
4/1/2013,VA,Virginia,Winchester City,51840,4697,4251,446,3974,14,3960,723,19,704,4314,3868,446,2886,2482,404,789,119,48,1930
4/1/2013,VA,Virginia,Wise,51195,10099,7209,2890,6407,19,6388,3692,18,3674,9501,6612,2889,6885,4241,2644,2412,460,176,3837
4/1/2013,VA,Virginia,Wythe,51197,7105,5828,1277,5411,20,5391,1694,24,1670,6730,5453,1277,5025,3894,1131,1523,258,92,3152
4/1/2013,VA,Virginia,York,51199,9857,8854,1003,9011,35,8976,846,27,819,8985,7984,1001,3912,2988,924,574,135,42,3161
8/1/2013,VA,Virginia,Accomack,51001,8054,7123,931,6779,42,6737,1275,47,1228,7531,6601,930,5165,4349,816,1555,317,89,3204
8/1/2013,VA,Virginia,Albemarle,51003,16579,15230,1349,15051,46,15005,1528,57,1471,14943,13594,1349,10406,9189,1217,1488,242,88,8588
8/1/2013,VA,Virginia,Alexandria City,51510,14963,13650,1313,13568,79,13489,1395,90,1305,12117,10806,1311,6262,5028,1234,1859,322,66,4015
8/1/2013,VA,Virginia,Alleghany,51005,4368,3912,456,3469,21,3448,899,11,888,4149,3693,456,3154,2841,313,812,100,43,2199
8/1/2013,VA,Virginia,Amelia,51007,2649,2143,506,2181,*,*,468,11,457,2446,1940,506,1794,1322,472,453,76,28,1237
8/1/2013,VA,Virginia,Amherst,51009,7052,6070,982,5716,46,5670,1336,34,1302,6595,5613,982,5062,4153,909,1168,193,86,3615
8/1/2013,VA,Virginia,Appomattox,51011,3513,3027,486,2818,26,2792,695,14,681,3307,2821,486,2536,2088,448,680,95,52,1709
8/1/2013,VA,Virginia,Arlington,51013,20973,19080,1893,19315,54,19261,1658,81,1577,16829,14937,1892,8796,7021,1775,2749,319,113,5615
8/1/2013,VA,Virginia,Augusta,51015,15882,13882,2000,13429,52,13377,2453,46,2407,14912,12912,2000,10642,9048,1594,1839,334,131,8338
8/1/2013,VA,Virginia,Bath,51017,1241,1163,78,1075,*,*,166,*,*,1172,1094,78,891,833,58,199,36,25,631
8/1/2013,VA,Virginia,Bedford,51019,16897,14322,2575,14153,60,14093,2744,51,2693,15725,13153,2572,11475,9335,2140,1938,413,158,8966
8/1/2013,VA,Virginia,Bland,51021,1639,1366,273,1229,*,*,410,*,*,1562,1289,273,1107,879,228,232,56,21,798
8/1/2013,VA,Virginia,Botetourt,51023,7476,5949,1527,6341,24,6317,1135,13,1122,6917,5390,1527,5028,3629,1399,835,163,67,3963
8/1/2013,VA,Virginia,Bristol City,51520,4422,2797,1625,3366,*,*,1056,*,*,4156,2531,1625,3335,1756,1579,1043,135,60,2097
8/1/2013,VA,Virginia,Brunswick,51025,3691,3185,506,2936,23,2913,755,36,719,3486,2980,506,2663,2211,452,1052,113,41,1457
8/1/2013,VA,Virginia,Buchanan,51027,7448,5393,2055,4299,15,4284,3149,16,3133,7107,5053,2054,5489,3748,1741,1607,434,120,3328
8/1/2013,VA,Virginia,Buckingham,51029,3120,2742,378,2473,*,*,647,14,633,2890,2512,378,2128,1811,317,704,134,51,1239
8/1/2013,VA,Virginia,Buena Vista City,51530,1378,1135,243,1091,*,*,287,*,*,1300,1057,243,989,779,210,319,57,20,593
8/1/2013,VA,Virginia,Campbell,51031,11615,10025,1590,9415,65,9350,2200,63,2137,10905,9315,1590,8356,6906,1450,2003,354,179,5820
8/1/2013,VA,Virginia,Caroline,51033,4981,4322,659,4094,28,4066,887,32,855,4532,3873,659,2931,2314,617,762,210,54,1905
8/1/2013,VA,Virginia,Carroll,51035,7472,6528,944,5854,19,5835,1618,15,1603,7120,6176,944,5415,4700,715,1721,265,128,3301
8/1/2013,VA,Virginia,Charles City,51036,1601,1237,364,1332,11,1321,269,17,252,1483,1119,364,1068,758,310,244,72,22,730
8/1/2013,VA,Virginia,Charlotte,51037,3187,2744,443,2567,21,2546,620,13,607,3014,2571,443,2284,1884,400,783,137,42,1322
8/1/2013,VA,Virginia,Charlottesville City,51540,5669,5267,402,4484,22,4462,1185,50,1135,5110,4709,401,3892,3511,381,1223,142,58,2469
8/1/2013,VA,Virginia,Chesapeake City,51550,31231,26529,4702,26389,190,26199,4842,233,4609,28172,23471,4701,15683,11519,4164,3625,744,235,11079
8/1/2013,VA,Virginia,Chesterfield,51041,47244,38212,9032,40303,173,40130,6941,208,6733,42404,33372,9032,29623,21173,8450,4555,854,278,23936
8/1/2013,VA,Virginia,Clarke,51043,2678,2391,287,2435,*,*,243,*,*,2420,2133,287,1500,1249,251,260,74,28,1138
8/1/2013,VA,Virginia,Colonial Heights City,51570,3984,3588,396,3455,*,*,529,17,512,3651,3255,396,2094,1720,374,413,85,15,1581
8/1/2013,VA,Virginia,Covington City,51580,1679,1530,149,1275,*,*,404,*,*,1564,1415,149,1182,1047,135,348,48,24,762
8/1/2013,VA,Virginia,Craig,51045,1212,993,219,910,*,*,302,*,*,1104,885,219,827,614,213,201,42,14,570
8/1/2013,VA,Virginia,Culpeper,51047,7769,6871,898,6585,46,6539,1184,40,1144,7098,6200,898,4518,3749,769,1072,225,71,3150
8/1/2013,VA,Virginia,Cumberland,51049,2061,1721,340,1678,*,*,383,*,*,1922,1583,339,1421,1102,319,423,70,27,901
8/1/2013,VA,Virginia,Danville City,51590,10922,9258,1664,8476,71,8405,2446,111,2335,10351,8687,1664,8297,7141,1156,3115,418,167,4597
8/1/2013,VA,Virginia,Dickenson,51051,4655,3370,1285,2706,*,*,1949,11,1938,4432,3147,1285,3097,1940,1157,1086,220,98,1693
8/1/2013,VA,Virginia,Dinwiddie,51053,5139,4326,813,4042,30,4012,1097,27,1070,4706,3893,813,3299,2519,780,874,161,48,2216
8/1/2013,VA,Virginia,Emporia City,51595,1188,957,231,895,12,883,293,12,281,1115,884,231,901,730,171,446,57,16,382
8/1/2013,VA,Virginia,Essex,51057,2583,2252,331,2178,13,2165,405,14,391,2408,2077,331,1699,1413,286,424,83,20,1172
8/1/2013,VA,Virginia,Fairfax,51059,125624,111899,13725,117387,421,116966,8237,446,7791,101959,88256,13703,51019,38297,12722,12367,2131,448,36073
8/1/2013,VA,Virginia,Fairfax City,51600,3227,2833,394,2993,13,2980,234,13,221,2728,2335,393,1401,1033,368,311,*,*,1031
8/1/2013,VA,Virginia,Falls Church City,51610,1608,1438,170,1509,*,*,99,*,*,1291,1122,169,693,540,153,141,*,*,528
8/1/2013,VA,Virginia,Fauquier,51061,10336,9391,945,9290,44,9246,1046,34,1012,9134,8190,944,5075,4309,766,832,161,55,4027
8/1/2013,VA,Virginia,Floyd,51063,3554,2951,603,2995,11,2984,559,*,*,3303,2700,603,2469,1911,558,520,86,45,1818
8/1/2013,VA,Virginia,Fluvanna,51065,4973,4463,510,4410,19,4391,563,19,544,4600,4090,510,3037,2593,444,456,103,20,2458
8/1/2013,VA,Virginia,Franklin,51067,13042,10033,3009,10570,41,10529,2472,22,2450,12216,9207,3009,9295,6550,2745,1973,400,151,6771
8/1/2013,VA,Virginia,Franklin City,51620,1819,1649,170,1401,*,*,418,21,397,1701,1531,170,1322,1172,150,496,75,19,732
8/1/2013,VA,Virginia,Frederick,51069,13249,11814,1435,11601,44,11557,1648,39,1609,12113,10679,1434,7638,6366,1272,1356,311,136,5835
8/1/2013,VA,Virginia,Fredericksburg City,51630,3473,3218,255,2813,19,2794,660,27,633,3141,2887,254,2003,1768,235,707,80,42,1174
8/1/2013,VA,Virginia,Galax City,51640,1938,1821,117,1478,*,*,460,*,*,1856,1739,117,1431,1351,80,672,73,34,652
8/1/2013,VA,Virginia,Giles,51071,4374,3466,908,3366,16,3350,1008,16,992,4110,3203,907,2938,2077,861,780,122,34,2002
8/1/2013,VA,Virginia,Gloucester,51073,7193,6185,1008,6123,30,6093,1070,20,1050,6609,5601,1008,3718,2834,884,853,163,62,2640
8/1/2013,VA,Virginia,Goochland,51075,4555,3764,791,4076,21,4055,479,16,463,4091,3300,791,3053,2321,732,406,100,40,2507
8/1/2013,VA,Virginia,Grayson,51077,4389,3930,459,3521,12,3509,868,*,*,4231,3772,459,3034,2642,392,1027,158,79,1770
8/1/2013,VA,Virginia,Greene,51079,3162,2839,323,2721,16,2705,441,11,430,2911,2588,323,1951,1658,293,442,70,27,1412
8/1/2013,VA,Virginia,Greensville,51081,2272,1722,550,1792,19,1773,480,22,458,2116,1566,550,1719,1245,474,534,119,31,1035
8/1/2013,VA,Virginia,Halifax,51083,9085,7924,1161,7175,57,7118,1910,56,1854,8576,7416,1160,6762,5686,1076,2254,400,134,3974
8/1/2013,VA,Virginia,Hampton City,51650,22342,18531,3811,18060,175,17885,4282,209,4073,20461,16650,3811,10651,7186,3465,3336,733,191,6391
8/1/2013,VA,Virginia,Hanover,51085,17039,13829,3210,15202,68,15134,1837,48,1789,15546,12336,3210,11223,8347,2876,1294,324,106,9499
8/1/2013,VA,Virginia,Harrisonburg City,51660,4740,4240,500,3964,17,3947,776,21,755,4333,3833,500,3213,2944,269,849,114,44,2206
8/1/2013,VA,Virginia,Henrico,51087,47713,38184,9529,40922,258,40664,6791,317,6474,43279,33752,9527,31568,22713,8855,5570,1163,376,24459
8/1/2013,VA,Virginia,Henry,51089,14617,10572,4045,11308,56,11252,3309,66,3243,13978,9933,4045,11552,8478,3074,3114,637,229,7572
8/1/2013,VA,Virginia,Highland,51091,688,630,58,620,*,*,68,0,68,647,589,58,456,403,53,74,*,*,355
8/1/2013,VA,Virginia,Hopewell City,51670,4233,3740,493,3277,22,3255,956,37,919,3950,3457,493,2517,2038,479,871,126,42,1478
8/1/2013,VA,Virginia,Isle of Wight,51093,6893,5578,1315,5884,37,5847,1009,32,977,6396,5081,1315,4018,2784,1234,924,168,76,2850
8/1/2013,VA,Virginia,James City,51095,16751,15103,1648,15642,41,15601,1109,41,1068,15454,13809,1645,8331,6885,1446,796,179,48,7308
8/1/2013,VA,Virginia,King and Queen,51097,1534,1344,190,1271,*,*,263,*,*,1438,1248,190,1042,861,181,260,*,*,696
8/1/2013,VA,Virginia,King George,51099,3095,2891,204,2648,18,2630,447,21,426,2711,2507,204,1267,1079,188,393,73,23,778
8/1/2013,VA,Virginia,King William,51101,2782,2417,365,2360,18,2342,422,19,403,2562,2197,365,1914,1580,334,370,78,20,1446
8/1/2013,VA,Virginia,Lancaster,51103,4030,3620,410,3696,11,3685,334,15,319,3831,3421,410,2489,2183,306,477,84,32,1896
8/1/2013,VA,Virginia,Lee,51105,6187,4353,1834,3984,13,3971,2203,19,2184,5856,4025,1831,4549,2840,1709,1881,255,81,2332
8/1/2013,VA,Virginia,Lexington City,51678,1556,1419,137,1416,*,*,140,*,*,1452,1315,137,1063,953,110,196,35,11,821
8/1/2013,VA,Virginia,Loudoun,51107,26783,23239,3544,24725,79,24646,2058,92,1966,22251,18712,3539,12735,9469,3266,2300,474,116,9845
8/1/2013,VA,Virginia,Louisa,51109,6552,5657,895,5393,30,5363,1159,29,1130,5997,5102,895,4102,3261,841,1030,231,76,2765
8/1/2013,VA,Virginia,Lunenburg,51111,2789,2504,285,2239,11,2228,550,23,527,2590,2305,285,1870,1604,266,671,104,40,1055
8/1/2013,VA,Virginia,Lynchburg City,51680,13949,12329,1620,10897,77,10820,3052,104,2948,13005,11385,1620,10064,8597,1467,3231,421,148,6264
8/1/2013,VA,Virginia,Madison,51113,2658,2378,280,2325,11,2314,333,*,*,2494,2214,280,1712,1454,258,395,74,24,1219
8/1/2013,VA,Virginia,Manassas City,51683,3672,3226,446,3163,17,3146,509,30,479,3167,2721,446,1977,1590,387,515,99,20,1343
8/1/2013,VA,Virginia,Manassas Park City,51685,1018,859,159,867,*,*,151,*,*,859,700,159,561,418,143,144,*,*,373
8/1/2013,VA,Virginia,Martinsville City,51690,3881,3056,825,2860,18,2842,1021,31,990,3709,2884,825,3146,2520,626,1307,146,51,1642
8/1/2013,VA,Virginia,Mathews,51115,2572,2253,319,2327,*,*,245,*,*,2433,2114,319,1435,1142,293,262,41,19,1113
8/1/2013,VA,Virginia,Mecklenburg,51117,8613,7256,1357,6937,49,6888,1676,42,1634,8129,6774,1355,6159,5084,1075,1878,362,111,3808
8/1/2013,VA,Virginia,Middlesex,51119,3271,2859,412,2895,14,2881,376,11,365,3085,2674,411,2139,1816,323,424,84,22,1609
8/1/2013,VA,Virginia,Montgomery,51121,12239,10510,1729,9918,29,9889,2321,28,2293,11174,9445,1729,8610,6968,1642,1789,271,106,6444
8/1/2013,VA,Virginia,Nelson,51125,3930,3555,375,3382,*,*,548,16,532,3648,3273,375,2482,2146,336,609,109,40,1724
8/1/2013,VA,Virginia,New Kent,51127,3380,2862,518,2932,16,2916,448,12,436,3073,2555,518,1975,1532,443,279,73,25,1598
8/1/2013,VA,Virginia,Newport News City,51700,25003,20329,4674,20342,161,20181,4661,215,4446,22919,18246,4673,12985,8624,4361,4225,741,227,7792
8/1/2013,VA,Virginia,Norfolk City,51710,29543,24514,5029,23223,212,23011,6320,332,5988,26705,21676,5029,16380,11915,4465,6712,1081,301,8286
8/1/2013,VA,Virginia,Northampton,51131,3245,2894,351,2722,23,2699,523,31,492,3052,2701,351,2370,2054,316,906,100,31,1333
8/1/2013,VA,Virginia,Northumberland,51133,4383,4012,371,4024,*,*,359,*,*,4129,3758,371,2451,2177,274,437,89,27,1898
8/1/2013,VA,Virginia,Norton City,51720,1159,914,245,711,*,*,448,*,*,1067,822,245,821,591,230,365,51,20,385
8/1/2013,VA,Virginia,Nottoway,51135,3494,3059,435,2821,22,2799,673,13,660,3231,2796,435,2414,2135,279,896,118,45,1355
8/1/2013,VA,Virginia,Orange,51137,7825,7124,701,6809,36,6773,1016,31,985,7215,6515,700,4254,3682,572,920,224,67,3043
8/1/2013,VA,Virginia,Page,51139,5611,4974,637,4525,17,4508,1086,16,1070,5239,4602,637,3605,3030,575,1085,199,86,2235
8/1/2013,VA,Virginia,Patrick,51141,4892,3861,1031,3935,15,3920,957,*,*,4677,3647,1030,3625,2779,846,1000,191,76,2358
8/1/2013,VA,Virginia,Petersburg City,51730,6956,6013,943,5010,65,4945,1946,80,1866,6368,5425,943,4411,3562,849,2107,289,78,1937
8/1/2013,VA,Virginia,Pittsylvania,51143,14764,11774,2990,11778,83,11695,2986,81,2905,14040,11050,2990,11178,9091,2087,3042,537,231,7368
8/1/2013,VA,Virginia,Poquoson City,51735,2314,2098,216,2131,*,*,183,*,*,2118,1902,216,835,638,197,112,*,*,693
8/1/2013,VA,Virginia,Portsmouth City,51740,16766,13747,3019,12890,160,12730,3876,206,3670,15014,11995,3019,8954,6240,2714,3600,665,147,4542
8/1/2013,VA,Virginia,Powhatan,51145,4826,3968,858,4219,19,4200,607,20,587,4388,3530,858,3174,2395,779,375,84,34,2681
8/1/2013,VA,Virginia,Prince Edward,51147,4247,3677,570,3297,17,3280,950,34,916,3959,3389,570,2963,2517,446,1024,182,47,1710
8/1/2013,VA,Virginia,Prince George,51149,4965,4443,522,4108,24,4084,857,25,832,4597,4076,521,2572,2082,490,529,104,24,1915
8/1/2013,VA,Virginia,Prince William,51153,37208,32453,4755,32637,173,32464,4571,271,4300,31771,27019,4752,16417,12126,4291,4187,776,182,11272
8/1/2013,VA,Virginia,Pulaski,51155,8436,7205,1231,6472,30,6442,1964,27,1937,7928,6697,1231,5861,4685,1176,1663,309,119,3770
8/1/2013,VA,Virginia,Radford City,51750,1968,1675,293,1562,*,*,406,*,*,1826,1533,293,1460,1175,285,324,49,32,1055
8/1/2013,VA,Virginia,Rappahannock,51157,1791,1679,112,1602,*,*,189,*,*,1628,1516,112,976,884,92,176,34,11,755
8/1/2013,VA,Virginia,Richmond,51159,1762,1502,260,1514,13,1501,248,*,*,1666,1406,260,1165,945,220,277,77,27,784
8/1/2013,VA,Virginia,Richmond City,51760,30407,23566,6841,23155,254,22901,7252,348,6904,27465,20626,6839,21545,14984,6561,8130,1273,306,11836
8/1/2013,VA,Virginia,Roanoke,51161,20774,17199,3575,18116,64,18052,2658,41,2617,19229,15654,3575,13651,10238,3413,1863,369,124,11295
8/1/2013,VA,Virginia,Roanoke City,51770,18945,15239,3706,13786,115,13671,5159,130,5029,17385,13680,3705,13206,9653,3553,4542,733,228,7703
8/1/2013,VA,Virginia,Rockbridge,51163,5421,4521,900,4478,21,4457,943,12,931,5091,4191,900,3668,2956,712,838,151,69,2610
8/1/2013,VA,Virginia,Rockingham,51165,15017,12658,2359,13005,54,12951,2012,44,1968,13959,11601,2358,10035,8986,1049,1707,414,149,7765
8/1/2013,VA,Virginia,Russell,51167,7549,5757,1792,4765,11,4754,2784,11,2773,7207,5415,1792,5377,3738,1639,1714,275,116,3272
8/1/2013,VA,Virginia,Salem City,51775,5608,4753,855,4672,26,4646,936,17,919,5140,4285,855,3779,2963,816,791,125,51,2812
8/1/2013,VA,Virginia,Scott,51169,6396,3446,2950,4645,12,4633,1751,*,*,6122,3172,2950,5118,2226,2892,1535,234,108,3241
8/1/2013,VA,Virginia,Shenandoah,51171,9379,8404,975,8171,18,8153,1208,26,1182,8798,7823,975,5668,4822,846,1219,200,99,4150
8/1/2013,VA,Virginia,Smyth,51173,8453,6944,1509,6058,18,6040,2395,24,2371,7989,6480,1509,6158,4779,1379,2114,363,150,3531
8/1/2013,VA,Virginia,Southampton,51175,3677,3271,406,3054,26,3028,623,22,601,3414,3008,406,2556,2205,351,689,124,38,1705
8/1/2013,VA,Virginia,Spotsylvania,51177,16402,14824,1578,13982,86,13896,2420,86,2334,14610,13032,1578,8125,6750,1375,1621,465,121,5918
8/1/2013,VA,Virginia,Stafford,51179,13076,12156,920,11372,60,11312,1704,92,1612,11479,10560,919,5331,4557,774,1112,290,84,3845
8/1/2013,VA,Virginia,Staunton City,51790,5646,5088,558,4545,24,4521,1101,24,1077,5312,4755,557,3966,3505,461,1026,142,53,2745
8/1/2013,VA,Virginia,Suffolk City,51800,13367,11166,2201,10690,69,10621,2677,78,2599,12199,9999,2200,7821,5939,1882,2543,370,116,4792
8/1/2013,VA,Virginia,Surry,51181,1397,1094,303,1154,*,*,243,12,231,1287,984,303,885,601,284,212,66,12,595
8/1/2013,VA,Virginia,Sussex,51183,2258,1902,356,1786,29,1757,472,*,*,2094,1738,356,1523,1185,338,509,140,29,845
8/1/2013,VA,Virginia,Tazewell,51185,11394,9196,2198,7989,38,7951,3405,34,3371,10818,8620,2198,7905,6159,1746,2210,424,164,5107
8/1/2013,VA,Virginia,Unknown,51999,*,*,*,*,*,*,*,*,*,*,*,*,*,*,*,*,*,*,*
8/1/2013,VA,Virginia,Virginia Beach City,51810,59311,52041,7270,51715,291,51424,7596,299,7297,54178,46913,7265,27700,21288,6412,5916,1125,340,20319
8/1/2013,VA,Virginia,Warren,51187,6397,5806,591,5390,24,5366,1007,24,983,5870,5279,591,3600,3076,524,831,198,69,2502
8/1/2013,VA,Virginia,Washington,51191,13938,10039,3899,10721,43,10678,3217,13,3204,13121,9224,3897,9894,6220,3674,2491,481,187,6735
8/1/2013,VA,Virginia,Waynesboro City,51820,4553,4056,497,3699,21,3678,854,24,830,4284,3787,497,3215,2797,418,853,100,45,2217
8/1/2013,VA,Virginia,Westmoreland,51193,4413,4041,372,3856,25,3831,557,14,543,4077,3705,372,2399,2073,326,752,119,34,1494
8/1/2013,VA,Virginia,Williamsburg City,51830,2268,2001,267,2076,*,*,192,*,*,2047,1780,267,1290,1059,231,198,*,*,1053
8/1/2013,VA,Virginia,Winchester City,51840,4727,4276,451,3984,13,3971,743,20,723,4339,3888,451,2926,2517,409,804,117,47,1958
8/1/2013,VA,Virginia,Wise,51195,10163,7216,2947,6412,14,6398,3751,18,3733,9575,6629,2946,6946,4240,2706,2447,452,175,3872
8/1/2013,VA,Virginia,Wythe,51197,7146,5864,1282,5412,18,5394,1734,25,1709,6768,5486,1282,5069,3932,1137,1552,255,94,3168
8/1/2013,VA,Virginia,York,51199,9990,8974,1016,9108,32,9076,882,27,855,9099,8086,1013,3970,3033,937,591,139,44,3196
12/1/2013,VA,Virginia,Accomack,51001,8115,7163,952,6812,41,6771,1303,43,1260,7575,6624,951,5189,4355,834,1569,334,85,3201
12/1/2013,VA,Virginia,Albemarle,51003,16752,15396,1356,15188,45,15143,1564,60,1504,15073,13717,1356,10503,9277,1226,1504,244,87,8668
12/1/2013,VA,Virginia,Alexandria City,51510,15258,13904,1354,13825,74,13751,1433,91,1342,12273,10922,1351,6321,5048,1273,1878,329,62,4052
12/1/2013,VA,Virginia,Alleghany,51005,4412,3958,454,3481,20,3461,931,11,920,4180,3726,454,3171,2858,313,822,100,42,2207
12/1/2013,VA,Virginia,Amelia,51007,2699,2190,509,2209,*,*,490,11,479,2483,1974,509,1826,1350,476,466,76,30,1254
12/1/2013,VA,Virginia,Amherst,51009,7114,6123,991,5760,44,5716,1354,35,1319,6639,5648,991,5097,4177,920,1168,203,87,3639
12/1/2013,VA,Virginia,Appomattox,51011,3559,3077,482,2846,24,2822,713,14,699,3338,2856,482,2557,2112,445,696,96,52,1713
12/1/2013,VA,Virginia,Arlington,51013,21322,19401,1921,19614,50,19564,1708,82,1626,17022,15102,1920,8894,7093,1801,2799,312,118,5665
12/1/2013,VA,Virginia,Augusta,51015,16049,14036,2013,13541,47,13494,2508,46,2462,15054,13041,2013,10735,9132,1603,1870,332,139,8394
12/1/2013,VA,Virginia,Bath,51017,1239,1160,79,1072,*,*,167,*,*,1168,1089,79,882,824,58,201,32,24,625
12/1/2013,VA,Virginia,Bedford,51019,17132,14531,2601,14310,56,14254,2822,51,2771,15929,13331,2598,11575,9407,2168,1960,425,159,9031
12/1/2013,VA,Virginia,Bland,51021,1660,1386,274,1240,*,*,420,*,*,1574,1300,274,1115,886,229,241,57,20,797
12/1/2013,VA,Virginia,Botetourt,51023,7562,6037,1525,6406,22,6384,1156,12,1144,6981,5456,1525,5056,3654,1402,858,158,63,3977
12/1/2013,VA,Virginia,Bristol City,51520,4440,2806,1634,3372,*,*,1068,*,*,4172,2538,1634,3336,1748,1588,1051,137,58,2090
12/1/2013,VA,Virginia,Brunswick,51025,3721,3215,506,2949,20,2929,772,34,738,3503,2997,506,2675,2227,448,1064,113,39,1459
12/1/2013,VA,Virginia,Buchanan,51027,7468,5404,2064,4297,14,4283,3171,14,3157,7125,5062,2063,5514,3753,1761,1631,435,119,3329
12/1/2013,VA,Virginia,Buckingham,51029,3132,2752,380,2464,*,*,668,13,655,2904,2524,380,2133,1815,318,714,134,49,1236
12/1/2013,VA,Virginia,Buena Vista City,51530,1390,1150,240,1095,*,*,295,*,*,1306,1066,240,997,790,207,321,59,20,597
12/1/2013,VA,Virginia,Campbell,51031,11725,10128,1597,9483,64,9419,2242,60,2182,10992,9395,1597,8406,6944,1462,2032,349,180,5845
12/1/2013,VA,Virginia,Caroline,51033,5042,4381,661,4136,26,4110,906,31,875,4567,3906,661,2949,2329,620,775,211,53,1910
12/1/2013,VA,Virginia,Carroll,51035,7525,6578,947,5871,17,5854,1654,15,1639,7158,6211,947,5424,4707,717,1748,259,123,3294
12/1/2013,VA,Virginia,Charles City,51036,1627,1264,363,1349,11,1338,278,17,261,1513,1150,363,1089,779,310,248,73,22,746
12/1/2013,VA,Virginia,Charlotte,51037,3206,2763,443,2576,20,2556,630,11,619,3032,2589,443,2297,1897,400,779,141,47,1330
12/1/2013,VA,Virginia,Charlottesville City,51540,5730,5324,406,4526,18,4508,1204,50,1154,5137,4732,405,3922,3537,385,1237,139,59,2487
12/1/2013,VA,Virginia,Chesapeake City,51550,31641,26869,4772,26677,178,26499,4964,233,4731,28476,23705,4771,15895,11648,4247,3700,758,237,11200
12/1/2013,VA,Virginia,Chesterfield,51041,48018,38845,9173,40880,164,40716,7138,203,6935,43052,33879,9173,30065,21480,8585,4648,836,278,24303
12/1/2013,VA,Virginia,Clarke,51043,2710,2425,285,2463,*,*,247,*,*,2448,2163,285,1513,1261,252,264,72,28,1149
12/1/2013,VA,Virginia,Colonial Heights City,51570,3998,3599,399,3459,*,*,539,17,522,3662,3263,399,2112,1735,377,423,85,17,1587
12/1/2013,VA,Virginia,Covington City,51580,1671,1521,150,1263,*,*,408,*,*,1554,1404,150,1178,1042,136,351,49,23,755
12/1/2013,VA,Virginia,Craig,51045,1234,1010,224,926,*,*,308,*,*,1124,900,224,837,619,218,201,43,15,578
12/1/2013,VA,Virginia,Culpeper,51047,7879,6974,905,6648,41,6607,1231,39,1192,7183,6278,905,4551,3774,777,1079,221,77,3174
12/1/2013,VA,Virginia,Cumberland,51049,2084,1738,346,1694,*,*,390,*,*,1945,1600,345,1439,1113,326,427,69,27,916
12/1/2013,VA,Virginia,Danville City,51590,10938,9302,1636,8441,67,8374,2497,111,2386,10375,8739,1636,8314,7176,1138,3154,407,167,4586
12/1/2013,VA,Virginia,Dickenson,51051,4670,3388,1282,2698,*,*,1972,*,*,4450,3168,1282,3109,1948,1161,1096,217,101,1695
12/1/2013,VA,Virginia,Dinwiddie,51053,5187,4380,807,4066,28,4038,1121,27,1094,4749,3942,807,3313,2539,774,878,163,49,2223
12/1/2013,VA,Virginia,Emporia City,51595,1188,956,232,887,*,*,301,12,289,1107,875,232,893,721,172,446,56,16,375
12/1/2013,VA,Virginia,Essex,51057,2608,2261,347,2197,12,2185,411,14,397,2433,2086,347,1725,1428,297,428,83,18,1196
12/1/2013,VA,Virginia,Fairfax,51059,128182,114086,14096,119643,395,119248,8539,444,8095,103572,89497,14075,51744,38659,13085,12541,2205,467,36531
12/1/2013,VA,Virginia,Fairfax City,51600,3302,2901,401,3061,11,3050,241,13,228,2777,2376,401,1423,1047,376,317,50,11,1045
12/1/2013,VA,Virginia,Falls Church City,51610,1655,1483,172,1549,*,*,106,*,*,1313,1142,171,697,543,154,144,*,*,531
12/1/2013,VA,Virginia,Fauquier,51061,10512,9564,948,9435,41,9394,1077,34,1043,9260,8313,947,5118,4348,770,837,163,54,4064
12/1/2013,VA,Virginia,Floyd,51063,3578,2964,614,3013,*,*,565,*,*,3329,2715,614,2483,1915,568,526,92,44,1821
12/1/2013,VA,Virginia,Fluvanna,51065,5041,4531,510,4461,18,4443,580,21,559,4648,4138,510,3071,2625,446,468,103,20,2480
12/1/2013,VA,Virginia,Franklin,51067,13165,10137,3028,10638,38,10600,2527,22,2505,12316,9288,3028,9359,6589,2770,2014,400,148,6797
12/1/2013,VA,Virginia,Franklin City,51620,1823,1652,171,1399,*,*,424,20,404,1704,1533,171,1319,1169,150,497,75,18,729
12/1/2013,VA,Virginia,Frederick,51069,13448,12007,1441,11724,38,11686,1724,43,1681,12241,10801,1440,7714,6439,1275,1391,316,135,5872
12/1/2013,VA,Virginia,Fredericksburg City,51630,3526,3267,259,2852,16,2836,674,26,648,3176,2917,259,2025,1785,240,730,77,41,1177
12/1/2013,VA,Virginia,Galax City,51640,1942,1829,113,1476,*,*,466,*,*,1854,1741,113,1429,1352,77,671,71,34,653
12/1/2013,VA,Virginia,Giles,51071,4409,3490,919,3380,15,3365,1029,14,1015,4143,3225,918,2964,2091,873,791,124,34,2015
12/1/2013,VA,Virginia,Gloucester,51073,7300,6282,1018,6201,28,6173,1099,21,1078,6700,5682,1018,3744,2850,894,863,163,64,2654
12/1/2013,VA,Virginia,Goochland,51075,4637,3831,806,4150,18,4132,487,15,472,4161,3355,806,3099,2353,746,417,102,40,2540
12/1/2013,VA,Virginia,Grayson,51077,4416,3959,457,3536,12,3524,880,*,*,4251,3794,457,3030,2639,391,1025,162,78,1765
12/1/2013,VA,Virginia,Greene,51079,3192,2868,324,2741,15,2726,451,11,440,2930,2606,324,1965,1668,297,441,72,26,1426
12/1/2013,VA,Virginia,Greensville,51081,2287,1745,542,1793,18,1775,494,23,471,2126,1584,542,1726,1258,468,549,123,32,1022
12/1/2013,VA,Virginia,Halifax,51083,9139,7994,1145,7200,55,7145,1939,58,1881,8603,7459,1144,6753,5691,1062,2256,403,137,3957
12/1/2013,VA,Virginia,Hampton City,51650,22596,18712,3884,18197,166,18031,4399,205,4194,20679,16795,3884,10770,7218,3552,3399,722,190,6459
12/1/2013,VA,Virginia,Hanover,51085,17231,13984,3247,15353,62,15291,1878,49,1829,15698,12451,3247,11329,8412,2917,1309,320,105,9595
12/1/2013,VA,Virginia,Harrisonburg City,51660,4787,4285,502,3994,15,3979,793,20,773,4372,3870,502,3247,2976,271,876,117,44,2210
12/1/2013,VA,Virginia,Henrico,51087,48227,38595,9632,41288,252,41036,6939,312,6627,43633,34003,9630,31803,22839,8964,5642,1147,378,24636
12/1/2013,VA,Virginia,Henry,51089,14671,10645,4026,11306,52,11254,3365,66,3299,14001,9975,4026,11537,8476,3061,3174,625,227,7511
12/1/2013,VA,Virginia,Highland,51091,690,634,56,622,*,*,68,0,68,649,593,56,455,404,51,73,*,*,355
12/1/2013,VA,Virginia,Hopewell City,51670,4266,3766,500,3287,21,3266,979,38,941,3970,3470,500,2548,2062,486,891,131,43,1483
12/1/2013,VA,Virginia,Isle of Wight,51093,6985,5660,1325,5950,33,5917,1035,32,1003,6481,5156,1325,4066,2820,1246,925,167,81,2893
12/1/2013,VA,Virginia,James City,51095,16916,15256,1660,15776,41,15735,1140,41,1099,15599,13942,1657,8410,6951,1459,822,179,50,7359
12/1/2013,VA,Virginia,King and Queen,51097,1549,1360,189,1279,*,*,270,*,*,1446,1257,189,1051,872,179,266,*,*,702
12/1/2013,VA,Virginia,King George,51099,3148,2944,204,2687,17,2670,461,21,440,2743,2539,204,1278,1090,188,400,75,20,783
12/1/2013,VA,Virginia,King William,51101,2825,2470,355,2389,17,2372,436,20,416,2592,2237,355,1938,1612,326,373,82,21,1462
12/1/2013,VA,Virginia,Lancaster,51103,4072,3662,410,3727,*,*,345,15,330,3875,3465,410,2505,2198,307,489,78,30,1908
12/1/2013,VA,Virginia,Lee,51105,6225,4384,1841,3978,11,3967,2247,18,2229,5895,4057,1838,4577,2863,1714,1918,249,78,2332
12/1/2013,VA,Virginia,Lexington City,51678,1552,1417,135,1409,*,*,143,*,*,1446,1311,135,1054,946,108,198,36,11,809
12/1/2013,VA,Virginia,Loudoun,51107,27339,23704,3635,25177,75,25102,2162,96,2066,22604,18974,3630,12926,9573,3353,2329,495,126,9976
12/1/2013,VA,Virginia,Louisa,51109,6642,5732,910,5461,27,5434,1181,28,1153,6085,5175,910,4168,3312,856,1049,230,76,2813
12/1/2013,VA,Virginia,Lunenburg,51111,2800,2513,287,2242,*,*,558,23,535,2592,2305,287,1873,1605,268,672,107,40,1054
12/1/2013,VA,Virginia,Lynchburg City,51680,13994,12358,1636,10913,71,10842,3081,103,2978,13034,11398,1636,10084,8599,1485,3278,422,143,6241
12/1/2013,VA,Virginia,Madison,51113,2678,2395,283,2328,*,*,350,*,*,2503,2220,283,1725,1463,262,406,68,22,1229
12/1/2013,VA,Virginia,Manassas City,51683,3724,3266,458,3194,16,3178,530,30,500,3208,2750,458,1998,1601,397,525,98,21,1354
12/1/2013,VA,Virginia,Manassas Park City,51685,1032,878,154,875,*,*,157,11,146,872,718,154,561,422,139,146,*,*,372
12/1/2013,VA,Virginia,Martinsville City,51690,3885,3060,825,2840,17,2823,1045,33,1012,3708,2883,825,3139,2516,623,1318,146,55,1620
12/1/2013,VA,Virginia,Mathews,51115,2589,2270,319,2336,*,*,253,*,*,2446,2127,319,1439,1145,294,261,42,21,1115
12/1/2013,VA,Virginia,Mecklenburg,51117,8673,7325,1348,6962,42,6920,1711,44,1667,8180,6834,1346,6167,5101,1066,1909,355,119,3784
12/1/2013,VA,Virginia,Middlesex,51119,3300,2884,416,2922,12,2910,378,*,*,3103,2688,415,2147,1819,328,424,82,23,1618
12/1/2013,VA,Virginia,Montgomery,51121,12350,10609,1741,9973,23,9950,2377,28,2349,11261,9520,1741,8658,7003,1655,1804,268,110,6476
12/1/2013,VA,Virginia,Nelson,51125,4003,3624,379,3442,*,*,561,15,546,3708,3329,379,2517,2177,340,619,102,38,1758
12/1/2013,VA,Virginia,New Kent,51127,3443,2914,529,2985,16,2969,458,12,446,3121,2592,529,2003,1548,455,282,73,25,1623
12/1/2013,VA,Virginia,Newport News City,51700,25249,20475,4774,20489,149,20340,4760,215,4545,23132,18359,4773,13127,8655,4472,4312,736,233,7846
12/1/2013,VA,Virginia,Norfolk City,51710,29815,24662,5153,23339,197,23142,6476,337,6139,26906,21753,5153,16565,11953,4612,6803,1088,301,8373
12/1/2013,VA,Virginia,Northampton,51131,3248,2898,350,2721,23,2698,527,31,496,3054,2704,350,2366,2050,316,906,96,34,1330
12/1/2013,VA,Virginia,Northumberland,51133,4424,4050,374,4054,*,*,370,11,359,4168,3794,374,2469,2191,278,437,91,29,1912
12/1/2013,VA,Virginia,Norton City,51720,1169,921,248,715,*,*,454,*,*,1074,826,248,824,590,234,366,48,21,389
12/1/2013,VA,Virginia,Nottoway,51135,3509,3069,440,2812,21,2791,697,13,684,3235,2795,440,2419,2137,282,915,118,48,1338
12/1/2013,VA,Virginia,Orange,51137,7899,7189,710,6862,33,6829,1037,31,1006,7281,6572,709,4306,3733,573,929,228,63,3086
12/1/2013,VA,Virginia,Page,51139,5652,5020,632,4540,17,4523,1112,14,1098,5284,4652,632,3623,3053,570,1092,196,86,2249
12/1/2013,VA,Virginia,Patrick,51141,4912,3878,1034,3942,14,3928,970,*,*,4696,3663,1033,3622,2775,847,1008,187,75,2352
12/1/2013,VA,Virginia,Petersburg City,51730,6997,6048,949,5017,61,4956,1980,79,1901,6373,5424,949,4416,3557,859,2100,295,81,1940
12/1/2013,VA,Virginia,Pittsylvania,51143,14885,11919,2966,11849,81,11768,3036,81,2955,14119,11153,2966,11223,9153,2070,3120,537,224,7342
12/1/2013,VA,Virginia,Poquoson City,51735,2337,2117,220,2146,*,*,191,*,*,2140,1920,220,851,650,201,114,*,*,703
12/1/2013,VA,Virginia,Portsmouth City,51740,16917,13845,3072,12966,152,12814,3951,210,3741,15116,12044,3072,9037,6265,2772,3650,671,152,4564
12/1/2013,VA,Virginia,Powhatan,51145,4913,4042,871,4289,17,4272,624,20,604,4446,3575,871,3211,2418,793,376,86,35,2714
12/1/2013,VA,Virginia,Prince Edward,51147,4269,3695,574,3309,16,3293,960,31,929,3985,3411,574,2974,2528,446,1048,180,45,1701
12/1/2013,VA,Virginia,Prince George,51149,5051,4521,530,4168,22,4146,883,25,858,4667,4137,530,2592,2095,497,543,107,24,1918
12/1/2013,VA,Virginia,Prince William,51153,38113,33255,4858,33362,165,33197,4751,274,4477,32449,27594,4855,16673,12300,4373,4257,788,184,11444
12/1/2013,VA,Virginia,Pulaski,51155,8501,7263,1238,6501,24,6477,2000,26,1974,7960,6722,1238,5877,4695,1182,1689,304,121,3763
12/1/2013,VA,Virginia,Radford City,51750,1977,1678,299,1561,*,*,416,*,*,1824,1525,299,1461,1170,291,337,42,33,1049
12/1/2013,VA,Virginia,Rappahannock,51157,1811,1694,117,1614,*,*,197,*,*,1638,1521,117,986,890,96,177,33,11,765
12/1/2013,VA,Virginia,Richmond,51159,1767,1503,264,1518,13,1505,249,*,*,1667,1403,264,1160,939,221,280,78,27,775
12/1/2013,VA,Virginia,Richmond City,51760,30684,23744,6940,23253,244,23009,7431,353,7078,27678,20740,6938,21683,15015,6668,8208,1280,311,11884
12/1/2013,VA,Virginia,Roanoke,51161,21002,17411,3591,18277,60,18217,2725,42,2683,19420,15829,3591,13755,10326,3429,1894,371,124,11366
12/1/2013,VA,Virginia,Roanoke City,51770,19088,15332,3756,13845,106,13739,5243,130,5113,17472,13717,3755,13300,9691,3609,4616,734,227,7723
12/1/2013,VA,Virginia,Rockbridge,51163,5476,4588,888,4513,21,4492,963,12,951,5141,4253,888,3690,2990,700,858,162,70,2600
12/1/2013,VA,Virginia,Rockingham,51165,15174,12844,2330,13082,45,13037,2092,47,2045,14087,11758,2329,10104,9067,1037,1741,414,149,7800
12/1/2013,VA,Virginia,Russell,51167,7585,5769,1816,4762,11,4751,2823,11,2812,7229,5413,1816,5396,3732,1664,1731,283,115,3267
12/1/2013,VA,Virginia,Salem City,51775,5654,4791,863,4689,24,4665,965,16,949,5175,4312,863,3798,2976,822,793,123,52,2830
12/1/2013,VA,Virginia,Scott,51169,6418,3451,2967,4637,12,4625,1781,11,1770,6150,3183,2967,5162,2253,2909,1560,227,107,3268
12/1/2013,VA,Virginia,Shenandoah,51171,9490,8507,983,8242,17,8225,1248,27,1221,8903,7920,983,5736,4878,858,1237,213,98,4188
12/1/2013,VA,Virginia,Smyth,51173,8509,6983,1526,6078,16,6062,2431,22,2409,8043,6517,1526,6200,4803,1397,2143,366,149,3542
12/1/2013,VA,Virginia,Southampton,51175,3710,3291,419,3063,24,3039,647,20,627,3440,3021,419,2570,2209,361,697,126,37,1710
12/1/2013,VA,Virginia,Spotsylvania,51177,16715,15135,1580,14219,81,14138,2496,86,2410,14869,13290,1579,8251,6878,1373,1658,473,125,5995
12/1/2013,VA,Virginia,Stafford,51179,13332,12414,918,11573,58,11515,1759,90,1669,11662,10745,917,5407,4636,771,1152,293,78,3884
12/1/2013,VA,Virginia,Staunton City,51790,5691,5133,558,4568,23,4545,1123,26,1097,5347,4789,558,3991,3529,462,1053,134,52,2752
12/1/2013,VA,Virginia,Suffolk City,51800,13509,11276,2233,10757,67,10690,2752,79,2673,12322,10090,2232,7868,5949,1919,2583,373,121,4791
12/1/2013,VA,Virginia,Surry,51181,1416,1109,307,1162,*,*,254,12,242,1304,997,307,895,607,288,216,67,12,600
12/1/2013,VA,Virginia,Sussex,51183,2286,1925,361,1801,28,1773,485,*,*,2121,1760,361,1537,1195,342,515,141,26,855
12/1/2013,VA,Virginia,Tazewell,51185,11453,9248,2205,7987,32,7955,3466,36,3430,10871,8666,2205,7927,6166,1761,2237,418,161,5111
12/1/2013,VA,Virginia,Unknown,51999,*,*,*,*,*,*,*,*,*,*,*,*,*,*,*,*,*,*,*
12/1/2013,VA,Virginia,Virginia Beach City,51810,60189,52817,7372,52391,266,52125,7798,299,7499,54906,47539,7367,28122,21592,6530,6011,1144,352,20615
12/1/2013,VA,Virginia,Warren,51187,6497,5892,605,5456,23,5433,1041,25,1016,5962,5357,605,3654,3117,537,848,203,73,2530
12/1/2013,VA,Virginia,Washington,51191,14061,10112,3949,10789,40,10749,3272,13,3259,13215,9268,3947,9984,6258,3726,2532,482,179,6791
12/1/2013,VA,Virginia,Waynesboro City,51820,4594,4100,494,3710,21,3689,884,23,861,4306,3812,494,3241,2826,415,888,96,46,2211
12/1/2013,VA,Virginia,Westmoreland,51193,4455,4084,371,3876,23,3853,579,14,565,4114,3743,371,2422,2097,325,770,114,38,1500
12/1/2013,VA,Virginia,Williamsburg City,51830,2283,2016,267,2083,*,*,200,*,*,2064,1797,267,1306,1074,232,198,*,*,1068
12/1/2013,VA,Virginia,Winchester City,51840,4769,4319,450,4000,13,3987,769,19,750,4365,3915,450,2933,2522,411,810,116,47,1960
12/1/2013,VA,Virginia,Wise,51195,10236,7260,2976,6426,13,6413,3810,16,3794,9636,6661,2975,7019,4275,2744,2485,459,172,3903
12/1/2013,VA,Virginia,Wythe,51197,7211,5919,1292,5435,15,5420,1776,24,1752,6822,5530,1292,5089,3942,1147,1572,254,96,3167
12/1/2013,VA,Virginia,York,51199,10142,9130,1012,9239,31,9208,903,28,875,9223,8214,1009,3999,3062,937,600,143,44,3212
2/1/2013,VA,Virginia,Accomack,51001,7958,7036,922,6731,48,6683,1227,45,1182,7408,6487,921,5090,4286,804,1504,320,89,3177
2/1/2013,VA,Virginia,Albemarle,51003,16298,14954,1344,14843,51,14792,1455,51,1404,14696,13352,1344,10073,8869,1204,1441,247,87,8298
2/1/2013,VA,Virginia,Alexandria City,51510,14639,13357,1282,13289,83,13206,1350,88,1262,11882,10602,1280,6096,4895,1201,1809,334,66,3887
2/1/2013,VA,Virginia,Alleghany,51005,4297,3821,476,3434,23,3411,863,11,852,4068,3592,476,3120,2800,320,791,108,42,2179
2/1/2013,VA,Virginia,Amelia,51007,2602,2105,497,2148,*,*,454,*,*,2395,1898,497,1768,1306,462,443,81,28,1216
2/1/2013,VA,Virginia,Amherst,51009,6960,5978,982,5661,52,5609,1299,35,1264,6497,5515,982,4982,4077,905,1135,199,86,3562
2/1/2013,VA,Virginia,Appomattox,51011,3441,2965,476,2774,27,2747,667,14,653,3249,2773,476,2504,2061,443,652,100,54,1698
2/1/2013,VA,Virginia,Arlington,51013,20476,18637,1839,18867,58,18809,1609,78,1531,16423,14585,1838,8517,6794,1723,2636,333,113,5435
2/1/2013,VA,Virginia,Augusta,51015,15685,13586,2099,13303,60,13243,2382,45,2337,14723,12624,2099,10512,8843,1669,1788,361,134,8229
2/1/2013,VA,Virginia,Bath,51017,1224,1137,87,1065,*,*,159,*,*,1153,1066,87,883,817,66,195,42,25,621
2/1/2013,VA,Virginia,Bedford,51019,16613,14053,2560,13960,69,13891,2653,50,2603,15454,12897,2557,11263,9143,2120,1851,420,168,8824
2/1/2013,VA,Virginia,Bland,51021,1648,1376,272,1244,*,*,404,*,*,1564,1292,272,1122,895,227,235,59,23,805
2/1/2013,VA,Virginia,Botetourt,51023,7332,5832,1500,6232,30,6202,1100,13,1087,6793,5293,1500,4928,3559,1369,804,166,72,3886
2/1/2013,VA,Virginia,Bristol City,51520,4403,2800,1603,3366,11,3355,1037,11,1026,4124,2521,1603,3317,1761,1556,1026,145,60,2086
2/1/2013,VA,Virginia,Brunswick,51025,3646,3124,522,2924,28,2896,722,36,686,3429,2907,522,2620,2152,468,1025,110,43,1442
2/1/2013,VA,Virginia,Buchanan,51027,7401,5360,2041,4289,16,4273,3112,17,3095,7045,5004,2041,5455,3734,1721,1557,454,125,3319
2/1/2013,VA,Virginia,Buckingham,51029,3068,2696,372,2442,13,2429,626,14,612,2821,2449,372,2073,1762,311,688,135,52,1198
2/1/2013,VA,Virginia,Buena Vista City,51530,1361,1120,241,1085,*,*,276,*,*,1285,1044,241,984,777,207,311,60,19,594
2/1/2013,VA,Virginia,Campbell,51031,11486,9935,1551,9377,67,9310,2109,59,2050,10760,9209,1551,8208,6802,1406,1922,356,181,5749
2/1/2013,VA,Virginia,Caroline,51033,4878,4223,655,4026,30,3996,852,32,820,4454,3799,655,2895,2279,616,745,216,66,1868
2/1/2013,VA,Virginia,Carroll,51035,7420,6470,950,5847,21,5826,1573,14,1559,7061,6111,950,5358,4632,726,1696,273,133,3256
2/1/2013,VA,Virginia,Charles City,51036,1564,1205,359,1305,11,1294,259,17,242,1439,1080,359,1035,729,306,230,77,23,705
2/1/2013,VA,Virginia,Charlotte,51037,3172,2733,439,2566,22,2544,606,13,593,3000,2561,439,2283,1888,395,782,137,44,1320
2/1/2013,VA,Virginia,Charlottesville City,51540,5536,5138,398,4396,26,4370,1140,45,1095,4977,4580,397,3766,3390,376,1182,144,60,2380
2/1/2013,VA,Virginia,Chesapeake City,51550,30672,26031,4641,26052,212,25840,4620,225,4395,27633,22993,4640,15307,11215,4092,3461,765,246,10835
2/1/2013,VA,Virginia,Chesterfield,51041,46194,37336,8858,39491,191,39300,6703,210,6493,41468,32610,8858,28783,20512,8271,4332,872,291,23288
2/1/2013,VA,Virginia,Clarke,51043,2635,2351,284,2404,*,*,231,*,*,2380,2096,284,1467,1220,247,258,78,32,1099
2/1/2013,VA,Virginia,Colonial Heights City,51570,3957,3561,396,3446,*,*,511,17,494,3621,3225,396,2051,1679,372,400,86,17,1548
2/1/2013,VA,Virginia,Covington City,51580,1672,1511,161,1274,11,1263,398,*,*,1548,1387,161,1172,1035,137,344,49,25,754
2/1/2013,VA,Virginia,Craig,51045,1185,973,212,896,*,*,289,*,*,1077,865,212,801,595,206,191,42,14,554
2/1/2013,VA,Virginia,Culpeper,51047,7629,6734,895,6507,51,6456,1122,37,1085,6981,6086,895,4392,3622,770,1030,235,82,3045
2/1/2013,VA,Virginia,Cumberland,51049,2034,1694,340,1667,*,*,367,*,*,1890,1551,339,1393,1077,316,419,70,30,874
2/1/2013,VA,Virginia,Danville City,51590,10881,9154,1727,8492,80,8412,2389,112,2277,10314,8587,1727,8256,7049,1207,3041,434,167,4614
2/1/2013,VA,Virginia,Dickenson,51051,4620,3339,1281,2711,*,*,1909,*,*,4376,3095,1281,3075,1932,1143,1059,225,109,1682
2/1/2013,VA,Virginia,Dinwiddie,51053,5084,4272,812,4019,30,3989,1065,25,1040,4661,3849,812,3256,2476,780,851,158,53,2194
2/1/2013,VA,Virginia,Emporia City,51595,1193,947,246,905,13,892,288,12,276,1116,870,246,917,727,190,453,54,16,394
2/1/2013,VA,Virginia,Essex,51057,2562,2230,332,2164,15,2149,398,13,385,2380,2048,332,1685,1398,287,405,91,22,1167
2/1/2013,VA,Virginia,Fairfax,51059,122095,108850,13245,114204,454,113750,7891,424,7467,99124,85902,13222,47807,35535,12272,11976,2151,467,33213
2/1/2013,VA,Virginia,Fairfax City,51600,3174,2790,384,2943,15,2928,231,12,219,2682,2298,384,1297,940,357,295,*,*,939
2/1/2013,VA,Virginia,Falls Church City,51610,1571,1409,162,1476,*,*,95,*,*,1267,1107,160,641,493,148,132,*,*,485
2/1/2013,VA,Virginia,Fauquier,51061,10086,9125,961,9092,46,9046,994,33,961,8917,7957,960,4883,4103,780,807,168,58,3850
2/1/2013,VA,Virginia,Floyd,51063,3475,2887,588,2940,12,2928,535,*,*,3253,2665,588,2424,1881,543,504,90,47,1783
2/1/2013,VA,Virginia,Fluvanna,51065,4878,4375,503,4343,22,4321,535,19,516,4500,3997,503,2950,2511,439,446,109,20,2375
2/1/2013,VA,Virginia,Franklin,51067,12839,9873,2966,10444,47,10397,2395,24,2371,12019,9053,2966,9127,6430,2697,1915,401,158,6653
2/1/2013,VA,Virginia,Franklin City,51620,1813,1639,174,1408,13,1395,405,22,383,1697,1523,174,1307,1154,153,486,78,20,723
2/1/2013,VA,Virginia,Frederick,51069,12997,11576,1421,11426,46,11380,1571,39,1532,11896,10476,1420,7440,6182,1258,1290,330,142,5678
2/1/2013,VA,Virginia,Fredericksburg City,51630,3442,3180,262,2806,22,2784,636,26,610,3108,2846,262,1978,1739,239,677,82,48,1171
2/1/2013,VA,Virginia,Galax City,51640,1958,1835,123,1495,*,*,463,11,452,1867,1744,123,1438,1352,86,673,80,35,650
2/1/2013,VA,Virginia,Giles,51071,4314,3427,887,3346,20,3326,968,19,949,4055,3169,886,2880,2040,840,756,127,31,1966
2/1/2013,VA,Virginia,Gloucester,51073,7075,6079,996,6039,34,6005,1036,22,1014,6478,5482,996,3630,2764,866,820,171,65,2574
2/1/2013,VA,Virginia,Goochland,51075,4465,3692,773,3999,22,3977,466,15,451,4000,3227,773,2957,2242,715,407,102,41,2407
2/1/2013,VA,Virginia,Grayson,51077,4373,3910,463,3517,12,3505,856,*,*,4212,3749,463,3035,2640,395,1024,167,85,1759
2/1/2013,VA,Virginia,Greene,51079,3102,2785,317,2673,16,2657,429,12,417,2852,2535,317,1917,1629,288,424,74,36,1383
2/1/2013,VA,Virginia,Greensville,51081,2247,1688,559,1787,21,1766,460,22,438,2086,1527,559,1694,1212,482,513,123,32,1026
2/1/2013,VA,Virginia,Halifax,51083,9029,7890,1139,7167,65,7102,1862,54,1808,8541,7403,1138,6721,5664,1057,2221,408,144,3948
2/1/2013,VA,Virginia,Hampton City,51650,22038,18308,3730,17921,189,17732,4117,204,3913,20188,16458,3730,10477,7099,3378,3181,738,202,6356
2/1/2013,VA,Virginia,Hanover,51085,16779,13632,3147,15010,75,14935,1769,50,1719,15349,12202,3147,11010,8197,2813,1260,338,109,9303
2/1/2013,VA,Virginia,Harrisonburg City,51660,4660,4150,510,3910,21,3889,750,21,729,4266,3756,510,3155,2868,287,825,113,46,2171
2/1/2013,VA,Virginia,Henrico,51087,46954,37630,9324,40378,294,40084,6576,317,6259,42586,33264,9322,30843,22190,8653,5378,1171,372,23922
2/1/2013,VA,Virginia,Henry,51089,14508,10345,4163,11282,60,11222,3226,66,3160,13862,9699,4163,11489,8283,3206,2991,654,242,7602
2/1/2013,VA,Virginia,Highland,51091,680,616,64,615,*,*,65,0,65,644,580,64,451,392,59,75,*,*,349
2/1/2013,VA,Virginia,Hopewell City,51670,4190,3706,484,3263,25,3238,927,36,891,3904,3420,484,2497,2028,469,847,133,40,1477
2/1/2013,VA,Virginia,Isle of Wight,51093,6758,5468,1290,5785,38,5747,973,33,940,6263,4973,1290,3938,2727,1211,899,174,76,2789
2/1/2013,VA,Virginia,James City,51095,16473,14852,1621,15407,45,15362,1066,40,1026,15207,13589,1618,8106,6690,1416,763,189,47,7107
2/1/2013,VA,Virginia,King and Queen,51097,1502,1313,189,1249,*,*,253,*,*,1408,1219,189,1033,853,180,247,83,12,691
2/1/2013,VA,Virginia,King George,51099,3036,2826,210,2611,22,2589,425,23,402,2658,2448,210,1277,1085,192,389,80,23,785
2/1/2013,VA,Virginia,King William,51101,2748,2379,369,2339,18,2321,409,18,391,2526,2157,369,1887,1549,338,363,80,23,1421
2/1/2013,VA,Virginia,Lancaster,51103,3978,3578,400,3662,14,3648,316,12,304,3787,3387,400,2432,2132,300,458,90,31,1853
2/1/2013,VA,Virginia,Lee,51105,6125,4346,1779,3987,12,3975,2138,17,2121,5785,4009,1776,4506,2862,1644,1850,260,82,2314
2/1/2013,VA,Virginia,Lexington City,51678,1555,1417,138,1418,*,*,137,*,*,1457,1319,138,1061,952,109,190,*,*,827
2/1/2013,VA,Virginia,Loudoun,51107,25999,22552,3447,24041,86,23955,1958,90,1868,21629,18186,3443,12180,9017,3163,2190,482,125,9383
2/1/2013,VA,Virginia,Louisa,51109,6390,5507,883,5274,34,5240,1116,29,1087,5840,4957,883,3964,3135,829,991,239,75,2659
2/1/2013,VA,Virginia,Lunenburg,51111,2743,2460,283,2207,13,2194,536,26,510,2557,2274,283,1849,1588,261,656,105,39,1049
2/1/2013,VA,Virginia,Lynchburg City,51680,13835,12258,1577,10851,88,10763,2984,100,2884,12903,11326,1577,9965,8543,1422,3183,430,160,6192
2/1/2013,VA,Virginia,Madison,51113,2612,2333,279,2291,12,2279,321,*,*,2457,2178,279,1667,1410,257,391,80,27,1169
2/1/2013,VA,Virginia,Manassas City,51683,3581,3140,441,3100,22,3078,481,28,453,3083,2642,441,1904,1526,378,505,103,23,1273
2/1/2013,VA,Virginia,Manassas Park City,51685,986,827,159,846,11,835,140,*,*,842,683,159,544,402,142,130,*,*,365
2/1/2013,VA,Virginia,Martinsville City,51690,3869,3011,858,2874,21,2853,995,31,964,3692,2834,858,3128,2474,654,1269,152,55,1652
2/1/2013,VA,Virginia,Mathews,51115,2556,2242,314,2317,*,*,239,*,*,2418,2104,314,1405,1119,286,251,42,20,1092
2/1/2013,VA,Virginia,Mecklenburg,51117,8554,7142,1412,6922,55,6867,1632,42,1590,8050,6640,1410,6100,4953,1147,1842,379,114,3765
2/1/2013,VA,Virginia,Middlesex,51119,3236,2829,407,2872,16,2856,364,11,353,3054,2647,407,2102,1776,326,406,90,22,1584
2/1/2013,VA,Virginia,Montgomery,51121,12061,10394,1667,9825,31,9794,2236,30,2206,11007,9340,1667,8435,6857,1578,1741,278,113,6303
2/1/2013,VA,Virginia,Nelson,51125,3864,3489,375,3332,*,*,532,17,515,3576,3201,375,2434,2099,335,599,107,40,1688
2/1/2013,VA,Virginia,New Kent,51127,3281,2770,511,2854,20,2834,427,11,416,2979,2468,511,1917,1482,435,271,70,23,1553
2/1/2013,VA,Virginia,Newport News City,51700,24590,20031,4559,20110,181,19929,4480,221,4259,22537,17979,4558,12766,8530,4236,4065,757,231,7713
2/1/2013,VA,Virginia,Norfolk City,51710,29131,24202,4929,23008,237,22771,6123,324,5799,26344,21415,4929,16106,11745,4361,6458,1120,315,8213
2/1/2013,VA,Virginia,Northampton,51131,3241,2895,346,2732,24,2708,509,32,477,3054,2708,346,2345,2035,310,897,98,38,1312
2/1/2013,VA,Virginia,Northumberland,51133,4339,3972,367,3994,12,3982,345,*,*,4077,3710,367,2414,2141,273,422,91,28,1873
2/1/2013,VA,Virginia,Norton City,51720,1138,898,240,715,*,*,423,*,*,1049,809,240,807,583,224,351,52,22,382
2/1/2013,VA,Virginia,Nottoway,51135,3453,3017,436,2815,22,2793,638,14,624,3202,2766,436,2408,2124,284,872,123,43,1370
2/1/2013,VA,Virginia,Orange,51137,7717,7022,695,6743,39,6704,974,29,945,7124,6430,694,4155,3583,572,911,237,69,2938
2/1/2013,VA,Virginia,Page,51139,5543,4907,636,4509,18,4491,1034,14,1020,5172,4536,636,3521,2946,575,1048,207,91,2175
2/1/2013,VA,Virginia,Patrick,51141,4859,3817,1042,3927,16,3911,932,11,921,4649,3608,1041,3610,2734,876,988,200,76,2346
2/1/2013,VA,Virginia,Petersburg City,51730,6893,5992,901,4999,74,4925,1894,76,1818,6303,5402,901,4380,3571,809,2040,309,81,1950
2/1/2013,VA,Virginia,Pittsylvania,51143,14581,11467,3114,11677,87,11590,2904,80,2824,13848,10734,3114,10993,8767,2226,2948,542,246,7257
2/1/2013,VA,Virginia,Poquoson City,51735,2277,2068,209,2106,*,*,171,*,*,2078,1869,209,822,631,191,105,*,*,684
2/1/2013,VA,Virginia,Portsmouth City,51740,16572,13597,2975,12802,175,12627,3770,202,3568,14837,11862,2975,8865,6199,2666,3489,705,156,4515
2/1/2013,VA,Virginia,Powhatan,51145,4711,3867,844,4129,21,4108,582,20,562,4288,3444,844,3098,2333,765,364,84,35,2615
2/1/2013,VA,Virginia,Prince Edward,51147,4222,3654,568,3298,18,3280,924,34,890,3921,3353,568,2928,2477,451,1001,181,51,1695
2/1/2013,VA,Virginia,Prince George,51149,4859,4342,517,4035,27,4008,824,24,800,4484,3968,516,2520,2035,485,507,109,23,1881
2/1/2013,VA,Virginia,Prince William,51153,36016,31373,4643,31658,189,31469,4358,263,4095,30760,26120,4640,15670,11492,4178,3974,785,181,10730
2/1/2013,VA,Virginia,Pulaski,51155,8336,7088,1248,6443,33,6410,1893,24,1869,7814,6566,1248,5786,4601,1185,1612,310,132,3732
2/1/2013,VA,Virginia,Radford City,51750,1947,1656,291,1557,*,*,390,*,*,1808,1517,291,1448,1165,283,315,48,33,1052
2/1/2013,VA,Virginia,Rappahannock,51157,1742,1634,108,1566,*,*,176,*,*,1596,1488,108,942,853,89,171,*,*,730
2/1/2013,VA,Virginia,Richmond,51159,1760,1500,260,1519,14,1505,241,*,*,1666,1406,260,1149,927,222,271,77,27,774
2/1/2013,VA,Virginia,Richmond City,51760,29910,23142,6768,22930,282,22648,6980,336,6644,27039,20273,6766,21140,14653,6487,7812,1297,331,11700
2/1/2013,VA,Virginia,Roanoke,51161,20451,16953,3498,17898,77,17821,2553,44,2509,18944,15446,3498,13410,10075,3335,1810,364,131,11105
2/1/2013,VA,Virginia,Roanoke City,51770,18750,15100,3650,13730,122,13608,5020,124,4896,17166,13517,3649,13075,9580,3495,4404,754,238,7679
2/1/2013,VA,Virginia,Rockbridge,51163,5315,4391,924,4413,24,4389,902,14,888,4980,4056,924,3572,2850,722,789,158,72,2553
2/1/2013,VA,Virginia,Rockingham,51165,14816,12417,2399,12885,65,12820,1931,39,1892,13756,11358,2398,9848,8773,1075,1649,421,157,7621
2/1/2013,VA,Virginia,Russell,51167,7502,5714,1788,4782,14,4768,2720,12,2708,7154,5366,1788,5362,3730,1632,1684,278,120,3280
2/1/2013,VA,Virginia,Salem City,51775,5591,4745,846,4689,26,4663,902,15,887,5122,4276,846,3742,2934,808,803,123,52,2764
2/1/2013,VA,Virginia,Scott,51169,6333,3436,2897,4632,15,4617,1701,*,*,6061,3164,2897,5067,2229,2838,1494,244,111,3218
2/1/2013,VA,Virginia,Shenandoah,51171,9280,8309,971,8119,20,8099,1161,24,1137,8686,7715,971,5559,4715,844,1176,213,104,4066
2/1/2013,VA,Virginia,Smyth,51173,8396,6904,1492,6051,23,6028,2345,22,2323,7920,6428,1492,6101,4734,1367,2092,367,163,3479
2/1/2013,VA,Virginia,Southampton,51175,3616,3216,400,3007,29,2978,609,23,586,3373,2973,400,2540,2192,348,685,129,41,1685
2/1/2013,VA,Virginia,Spotsylvania,51177,16043,14467,1576,13732,93,13639,2311,88,2223,14251,12675,1576,7869,6493,1376,1557,477,125,5710
2/1/2013,VA,Virginia,Stafford,51179,12768,11843,925,11128,66,11062,1640,90,1550,11213,10289,924,5180,4400,780,1057,298,90,3735
2/1/2013,VA,Virginia,Staunton City,51790,5593,5011,582,4528,30,4498,1065,21,1044,5242,4661,581,3893,3414,479,978,151,58,2706
2/1/2013,VA,Virginia,Suffolk City,51800,13175,11012,2163,10590,74,10516,2585,77,2508,12012,9850,2162,7686,5848,1838,2464,377,118,4727
2/1/2013,VA,Virginia,Surry,51181,1363,1066,297,1124,*,*,239,12,227,1255,958,297,862,585,277,199,73,13,577
2/1/2013,VA,Virginia,Sussex,51183,2249,1893,356,1788,31,1757,461,*,*,2083,1727,356,1517,1181,336,493,143,32,849
2/1/2013,VA,Virginia,Tazewell,51185,11297,9118,2179,7979,41,7938,3318,35,3283,10713,8534,2179,7856,6144,1712,2144,433,176,5103
2/1/2013,VA,Virginia,Unknown,51999,*,*,*,*,*,*,*,*,*,*,*,*,*,*,*,*,*,*,*
2/1/2013,VA,Virginia,Virginia Beach City,51810,58166,50991,7175,50870,318,50552,7296,285,7011,53174,46005,7169,27076,20753,6323,5739,1152,350,19835
2/1/2013,VA,Virginia,Warren,51187,6295,5706,589,5335,30,5305,960,23,937,5756,5167,589,3513,2995,518,793,212,63,2445
2/1/2013,VA,Virginia,Washington,51191,13771,9933,3838,10631,47,10584,3140,16,3124,12931,9095,3836,9756,6149,3607,2439,475,197,6645
2/1/2013,VA,Virginia,Waynesboro City,51820,4501,3982,519,3673,21,3652,828,23,805,4216,3697,519,3159,2721,438,810,103,51,2195
2/1/2013,VA,Virginia,Westmoreland,51193,4355,3971,384,3814,28,3786,541,13,528,4003,3619,384,2357,2024,333,727,122,38,1470
2/1/2013,VA,Virginia,Williamsburg City,51830,2244,1983,261,2057,*,*,187,*,*,2014,1753,261,1262,1034,228,197,*,*,1020
2/1/2013,VA,Virginia,Winchester City,51840,4708,4263,445,3985,14,3971,723,20,703,4325,3880,445,2891,2487,404,789,119,47,1936
2/1/2013,VA,Virginia,Wise,51195,10090,7207,2883,6427,21,6406,3663,18,3645,9490,6608,2882,6872,4246,2626,2391,474,190,3817
2/1/2013,VA,Virginia,Wythe,51197,7078,5805,1273,5400,23,5377,1678,25,1653,6716,5443,1273,5032,3905,1127,1517,266,101,3148
2/1/2013,VA,Virginia,York,51199,9771,8784,987,8934,36,8898,837,28,809,8901,7916,985,3874,2970,904,566,136,44,3128
1/1/2013,VA,Virginia,Accomack,51001,7951,7036,915,6728,49,6679,1223,45,1178,7400,6486,914,5081,4279,802,1498,319,89,3175
1/1/2013,VA,Virginia,Albemarle,51003,16288,14954,1334,14841,54,14787,1447,51,1396,14703,13369,1334,10041,8849,1192,1440,248,86,8267
1/1/2013,VA,Virginia,Alexandria City,51510,14597,13316,1281,13257,84,13173,1340,87,1253,11858,10579,1279,6082,4882,1200,1802,339,66,3875
1/1/2013,VA,Virginia,Alleghany,51005,4300,3813,487,3441,23,3418,859,*,*,4074,3587,487,3120,2792,328,791,110,42,2177
1/1/2013,VA,Virginia,Amelia,51007,2591,2094,497,2141,*,*,450,*,*,2390,1893,497,1767,1305,462,442,80,30,1215
1/1/2013,VA,Virginia,Amherst,51009,6959,5985,974,5667,52,5615,1292,36,1256,6502,5528,974,4970,4073,897,1134,202,85,3549
1/1/2013,VA,Virginia,Appomattox,51011,3425,2957,468,2759,27,2732,666,15,651,3235,2767,468,2477,2043,434,649,100,50,1678
1/1/2013,VA,Virginia,Arlington,51013,20455,18612,1843,18847,59,18788,1608,80,1528,16441,14599,1842,8531,6804,1727,2627,335,113,5456
1/1/2013,VA,Virginia,Augusta,51015,15651,13546,2105,13289,65,13224,2362,45,2317,14692,12587,2105,10452,8779,1673,1774,361,132,8185
1/1/2013,VA,Virginia,Bath,51017,1227,1140,87,1069,*,*,158,*,*,1156,1069,87,880,814,66,194,41,24,621
1/1/2013,VA,Virginia,Bedford,51019,16579,13999,2580,13945,70,13875,2634,49,2585,15435,12858,2577,11215,9085,2130,1839,420,169,8787
1/1/2013,VA,Virginia,Bland,51021,1644,1380,264,1243,*,*,401,*,*,1558,1294,264,1113,890,223,229,59,22,803
1/1/2013,VA,Virginia,Botetourt,51023,7327,5837,1490,6227,30,6197,1100,13,1087,6788,5298,1490,4917,3557,1360,807,167,73,3870
1/1/2013,VA,Virginia,Bristol City,51520,4398,2790,1608,3367,11,3356,1031,11,1020,4120,2512,1608,3314,1754,1560,1016,146,60,2092
1/1/2013,VA,Virginia,Brunswick,51025,3641,3117,524,2928,30,2898,713,35,678,3421,2897,524,2612,2141,471,1023,109,44,1436
1/1/2013,VA,Virginia,Buchanan,51027,7389,5343,2046,4294,17,4277,3095,17,3078,7033,4987,2046,5451,3729,1722,1543,454,128,3326
1/1/2013,VA,Virginia,Buckingham,51029,3061,2693,368,2441,14,2427,620,14,606,2811,2443,368,2050,1738,312,682,136,52,1180
1/1/2013,VA,Virginia,Buena Vista City,51530,1359,1120,239,1085,*,*,274,*,*,1283,1044,239,974,770,204,306,61,18,589
1/1/2013,VA,Virginia,Campbell,51031,11447,9931,1516,9350,69,9281,2097,60,2037,10732,9216,1516,8123,6748,1375,1910,351,181,5681
1/1/2013,VA,Virginia,Caroline,51033,4868,4211,657,4020,30,3990,848,32,816,4448,3791,657,2880,2262,618,737,222,67,1854
1/1/2013,VA,Virginia,Carroll,51035,7409,6458,951,5843,21,5822,1566,14,1552,7053,6102,951,5351,4618,733,1688,270,133,3260
1/1/2013,VA,Virginia,Charles City,51036,1563,1210,353,1302,*,*,261,17,244,1441,1088,353,1025,725,300,226,81,21,697
1/1/2013,VA,Virginia,Charlotte,51037,3169,2729,440,2567,22,2545,602,13,589,2998,2558,440,2275,1880,395,773,139,44,1319
1/1/2013,VA,Virginia,Charlottesville City,51540,5519,5126,393,4388,26,4362,1131,46,1085,4957,4565,392,3744,3373,371,1171,144,59,2370
1/1/2013,VA,Virginia,Chesapeake City,51550,30635,26013,4622,26046,215,25831,4589,225,4364,27633,23012,4621,15247,11169,4078,3458,761,249,10779
1/1/2013,VA,Virginia,Chesterfield,51041,46018,37200,8818,39364,199,39165,6654,212,6442,41351,32533,8818,28499,20274,8225,4315,867,291,23026
1/1/2013,VA,Virginia,Clarke,51043,2639,2354,285,2411,*,*,228,*,*,2381,2096,285,1463,1215,248,252,79,32,1100
1/1/2013,VA,Virginia,Colonial Heights City,51570,3948,3548,400,3444,12,3432,504,17,487,3615,3215,400,2040,1664,376,400,90,16,1534
1/1/2013,VA,Virginia,Covington City,51580,1669,1508,161,1274,11,1263,395,*,*,1546,1385,161,1172,1035,137,342,48,25,757
1/1/2013,VA,Virginia,Craig,51045,1183,971,212,898,*,*,285,*,*,1077,865,212,800,594,206,191,42,13,554
1/1/2013,VA,Virginia,Culpeper,51047,7604,6720,884,6498,51,6447,1106,38,1068,6957,6073,884,4369,3606,763,1022,239,84,3024
1/1/2013,VA,Virginia,Cumberland,51049,2024,1688,336,1661,*,*,363,*,*,1879,1544,335,1377,1061,316,413,73,30,861
1/1/2013,VA,Virginia,Danville City,51590,10891,9147,1744,8507,80,8427,2384,112,2272,10329,8585,1744,8258,7043,1215,3036,436,167,4619
1/1/2013,VA,Virginia,Dickenson,51051,4617,3330,1287,2715,*,*,1902,*,*,4372,3085,1287,3068,1925,1143,1045,227,109,1687
1/1/2013,VA,Virginia,Dinwiddie,51053,5070,4257,813,4012,30,3982,1058,25,1033,4650,3837,813,3226,2446,780,846,155,54,2171
1/1/2013,VA,Virginia,Emporia City,51595,1199,951,248,909,13,896,290,13,277,1122,874,248,923,731,192,454,56,16,397
1/1/2013,VA,Virginia,Essex,51057,2558,2224,334,2165,15,2150,393,13,380,2379,2045,334,1683,1394,289,403,94,22,1164
1/1/2013,VA,Virginia,Fairfax,51059,121641,108470,13171,113796,459,113337,7845,424,7421,98897,85751,13146,47584,35391,12193,11913,2145,466,33060
1/1/2013,VA,Virginia,Fairfax City,51600,3164,2782,382,2935,15,2920,229,12,217,2678,2296,382,1292,938,354,292,*,*,937
1/1/2013,VA,Virginia,Falls Church City,51610,1567,1405,162,1473,*,*,94,*,*,1267,1107,160,639,491,148,133,*,*,482
1/1/2013,VA,Virginia,Fauquier,51061,10058,9092,966,9073,46,9027,985,33,952,8905,7940,965,4873,4090,783,802,167,59,3845
1/1/2013,VA,Virginia,Floyd,51063,3469,2893,576,2938,12,2926,531,*,*,3245,2669,576,2417,1886,531,507,87,45,1778
1/1/2013,VA,Virginia,Fluvanna,51065,4869,4362,507,4335,23,4312,534,19,515,4499,3992,507,2928,2487,441,443,108,20,2357
1/1/2013,VA,Virginia,Franklin,51067,12828,9866,2962,10444,49,10395,2384,24,2360,12006,9044,2962,9114,6418,2696,1910,398,157,6649
1/1/2013,VA,Virginia,Franklin City,51620,1811,1637,174,1407,13,1394,404,22,382,1696,1522,174,1301,1151,150,484,77,18,722
1/1/2013,VA,Virginia,Frederick,51069,12970,11548,1422,11410,46,11364,1560,38,1522,11874,10453,1421,7412,6152,1260,1288,328,140,5656
1/1/2013,VA,Virginia,Fredericksburg City,51630,3438,3170,268,2808,22,2786,630,26,604,3112,2844,268,1968,1724,244,668,82,47,1171
1/1/2013,VA,Virginia,Galax City,51640,1958,1835,123,1497,*,*,461,11,450,1866,1743,123,1437,1351,86,670,83,33,651
1/1/2013,VA,Virginia,Giles,51071,4311,3424,887,3347,20,3327,964,19,945,4050,3164,886,2870,2029,841,749,130,31,1960
1/1/2013,VA,Virginia,Gloucester,51073,7045,6057,988,6019,36,5983,1026,20,1006,6458,5470,988,3601,2747,854,819,174,65,2543
1/1/2013,VA,Virginia,Goochland,51075,4452,3685,767,3992,22,3970,460,15,445,3995,3228,767,2936,2225,711,404,99,40,2393
1/1/2013,VA,Virginia,Grayson,51077,4370,3902,468,3521,12,3509,849,*,*,4216,3748,468,3034,2636,398,1017,167,85,1765
1/1/2013,VA,Virginia,Greene,51079,3088,2767,321,2665,17,2648,423,12,411,2837,2516,321,1904,1612,292,419,73,35,1377
1/1/2013,VA,Virginia,Greensville,51081,2232,1670,562,1780,21,1759,452,21,431,2075,1513,562,1684,1199,485,508,122,32,1022
1/1/2013,VA,Virginia,Halifax,51083,9020,7894,1126,7163,65,7098,1857,56,1801,8541,7416,1125,6689,5645,1044,2218,411,143,3917
1/1/2013,VA,Virginia,Hampton City,51650,21996,18321,3675,17905,194,17711,4091,203,3888,20149,16474,3675,10398,7071,3327,3153,734,207,6304
1/1/2013,VA,Virginia,Hanover,51085,16753,13626,3127,14993,76,14917,1760,50,1710,15346,12219,3127,10921,8131,2790,1265,339,111,9206
1/1/2013,VA,Virginia,Harrisonburg City,51660,4656,4147,509,3913,21,3892,743,20,723,4263,3754,509,3142,2858,284,819,114,47,2162
1/1/2013,VA,Virginia,Henrico,51087,46903,37630,9273,40361,299,40062,6542,319,6223,42554,33283,9271,30617,22010,8607,5343,1168,371,23735
1/1/2013,VA,Virginia,Henry,51089,14514,10328,4186,11297,61,11236,3217,66,3151,13874,9688,4186,11492,8280,3212,2969,658,246,7619
1/1/2013,VA,Virginia,Highland,51091,679,614,65,614,*,*,65,0,65,644,579,65,443,384,59,74,*,*,343
1/1/2013,VA,Virginia,Hopewell City,51670,4180,3710,470,3268,26,3242,912,36,876,3892,3422,470,2478,2024,454,844,132,41,1461
1/1/2013,VA,Virginia,Isle of Wight,51093,6741,5461,1280,5775,38,5737,966,33,933,6253,4973,1280,3909,2704,1205,894,173,76,2766
1/1/2013,VA,Virginia,James City,51095,16433,14832,1601,15376,46,15330,1057,39,1018,15177,13579,1598,8042,6643,1399,760,187,48,7047
1/1/2013,VA,Virginia,King and Queen,51097,1499,1310,189,1247,*,*,252,*,*,1405,1216,189,1025,845,180,244,83,12,686
1/1/2013,VA,Virginia,King George,51099,3028,2819,209,2606,22,2584,422,23,399,2653,2444,209,1276,1086,190,383,81,23,789
1/1/2013,VA,Virginia,King William,51101,2734,2365,369,2331,18,2313,403,18,385,2511,2142,369,1872,1534,338,358,80,23,1411
1/1/2013,VA,Virginia,Lancaster,51103,3980,3580,400,3664,15,3649,316,12,304,3791,3391,400,2423,2120,303,460,89,32,1842
1/1/2013,VA,Virginia,Lee,51105,6119,4341,1778,3994,12,3982,2125,17,2108,5778,4004,1774,4503,2864,1639,1844,264,79,2316
1/1/2013,VA,Virginia,Lexington City,51678,1554,1416,138,1418,*,*,136,*,*,1454,1316,138,1059,949,110,189,*,*,826
1/1/2013,VA,Virginia,Loudoun,51107,25892,22450,3442,23950,88,23862,1942,89,1853,21570,18132,3438,12132,8973,3159,2178,474,129,9351
1/1/2013,VA,Virginia,Louisa,51109,6383,5506,877,5271,35,5236,1112,30,1082,5838,4961,877,3929,3105,824,989,238,72,2630
1/1/2013,VA,Virginia,Lunenburg,51111,2728,2443,285,2196,13,2183,532,26,506,2548,2263,285,1840,1578,262,653,104,40,1043
1/1/2013,VA,Virginia,Lynchburg City,51680,13857,12308,1549,10886,89,10797,2971,100,2871,12937,11388,1549,9936,8542,1394,3179,429,159,6169
1/1/2013,VA,Virginia,Madison,51113,2609,2330,279,2287,13,2274,322,*,*,2458,2179,279,1662,1405,257,394,81,26,1161
1/1/2013,VA,Virginia,Manassas City,51683,3561,3123,438,3085,22,3063,476,27,449,3066,2628,438,1895,1521,374,503,105,23,1264
1/1/2013,VA,Virginia,Manassas Park City,51685,979,824,155,840,12,828,139,*,*,835,680,155,541,402,139,130,*,*,362
1/1/2013,VA,Virginia,Martinsville City,51690,3879,3018,861,2887,22,2865,992,31,961,3705,2844,861,3128,2476,652,1266,150,55,1657
1/1/2013,VA,Virginia,Mathews,51115,2555,2242,313,2316,*,*,239,*,*,2418,2105,313,1401,1116,285,252,43,20,1086
1/1/2013,VA,Virginia,Mecklenburg,51117,8556,7128,1428,6925,56,6869,1631,43,1588,8060,6634,1426,6089,4931,1158,1837,376,115,3761
1/1/2013,VA,Virginia,Middlesex,51119,3220,2815,405,2856,16,2840,364,11,353,3041,2636,405,2084,1760,324,403,91,23,1567
1/1/2013,VA,Virginia,Montgomery,51121,12043,10380,1663,9821,32,9789,2222,30,2192,11002,9339,1663,8437,6864,1573,1731,282,110,6314
1/1/2013,VA,Virginia,Nelson,51125,3850,3476,374,3325,*,*,525,16,509,3565,3191,374,2413,2079,334,593,107,40,1673
1/1/2013,VA,Virginia,New Kent,51127,3274,2765,509,2851,20,2831,423,11,412,2972,2463,509,1899,1466,433,268,72,23,1536
1/1/2013,VA,Virginia,Newport News City,51700,24551,20024,4527,20090,183,19907,4461,224,4237,22501,17975,4526,12714,8517,4197,4041,763,229,7681
1/1/2013,VA,Virginia,Norfolk City,51710,29104,24183,4921,23008,240,22768,6096,324,5772,26328,21407,4921,16072,11719,4353,6428,1135,316,8193
1/1/2013,VA,Virginia,Northampton,51131,3240,2894,346,2732,24,2708,508,33,475,3054,2708,346,2344,2033,311,900,97,38,1309
1/1/2013,VA,Virginia,Northumberland,51133,4323,3959,364,3981,12,3969,342,*,*,4060,3696,364,2395,2126,269,419,92,29,1855
1/1/2013,VA,Virginia,Norton City,51720,1142,901,241,720,*,*,422,*,*,1055,814,241,810,585,225,354,52,22,382
1/1/2013,VA,Virginia,Nottoway,51135,3460,3024,436,2825,23,2802,635,14,621,3210,2774,436,2404,2122,282,872,122,43,1367
1/1/2013,VA,Virginia,Orange,51137,7707,7007,700,6737,39,6698,970,28,942,7115,6416,699,4124,3546,578,896,239,69,2920
1/1/2013,VA,Virginia,Page,51139,5524,4883,641,4500,18,4482,1024,14,1010,5155,4514,641,3510,2930,580,1042,204,90,2174
1/1/2013,VA,Virginia,Patrick,51141,4858,3816,1042,3928,16,3912,930,11,919,4652,3611,1041,3608,2722,886,984,201,77,2346
1/1/2013,VA,Virginia,Petersburg City,51730,6868,5976,892,4993,76,4917,1875,75,1800,6290,5398,892,4366,3560,806,2025,313,79,1949
1/1/2013,VA,Virginia,Pittsylvania,51143,14574,11431,3143,11682,87,11595,2892,78,2814,13839,10696,3143,10980,8737,2243,2942,541,249,7248
1/1/2013,VA,Virginia,Poquoson City,51735,2265,2060,205,2096,*,*,169,*,*,2066,1861,205,817,630,187,106,*,*,679
1/1/2013,VA,Virginia,Portsmouth City,51740,16576,13605,2971,12827,179,12648,3749,201,3548,14839,11868,2971,8850,6190,2660,3491,698,158,4503
1/1/2013,VA,Virginia,Powhatan,51145,4696,3857,839,4121,21,4100,575,20,555,4272,3433,839,3066,2307,759,364,84,32,2586
1/1/2013,VA,Virginia,Prince Edward,51147,4216,3648,568,3294,19,3275,922,34,888,3923,3355,568,2915,2459,456,996,184,55,1680
1/1/2013,VA,Virginia,Prince George,51149,4847,4326,521,4028,27,4001,819,23,796,4474,3954,520,2507,2018,489,503,112,22,1870
1/1/2013,VA,Virginia,Prince William,51153,35863,31251,4612,31538,192,31346,4325,260,4065,30657,26048,4609,15592,11444,4148,3955,782,179,10676
1/1/2013,VA,Virginia,Pulaski,51155,8331,7076,1255,6452,33,6419,1879,23,1856,7816,6561,1255,5772,4586,1186,1597,308,131,3736
1/1/2013,VA,Virginia,Radford City,51750,1940,1647,293,1553,*,*,387,*,*,1805,1512,293,1446,1161,285,313,48,33,1052
1/1/2013,VA,Virginia,Rappahannock,51157,1736,1627,109,1561,*,*,175,*,*,1593,1484,109,937,846,91,171,*,*,726
1/1/2013,VA,Virginia,Richmond,51159,1767,1505,262,1526,14,1512,241,*,*,1670,1408,262,1143,920,223,270,76,28,769
1/1/2013,VA,Virginia,Richmond City,51760,29894,23136,6758,22951,291,22660,6943,336,6607,27027,20271,6756,21059,14582,6477,7769,1298,335,11657
1/1/2013,VA,Virginia,Roanoke,51161,20434,16941,3493,17902,77,17825,2532,44,2488,18938,15445,3493,13413,10084,3329,1813,366,129,11105
1/1/2013,VA,Virginia,Roanoke City,51770,18733,15091,3642,13750,126,13624,4983,125,4858,17155,13514,3641,13059,9572,3487,4386,756,232,7685
1/1/2013,VA,Virginia,Rockbridge,51163,5311,4385,926,4415,24,4391,896,13,883,4975,4049,926,3565,2844,721,785,159,70,2551
1/1/2013,VA,Virginia,Rockingham,51165,14784,12376,2408,12873,67,12806,1911,38,1873,13730,11323,2407,9813,8730,1083,1641,420,155,7597
1/1/2013,VA,Virginia,Russell,51167,7503,5719,1784,4796,14,4782,2707,12,2695,7151,5367,1784,5353,3729,1624,1676,279,118,3280
1/1/2013,VA,Virginia,Salem City,51775,5596,4751,845,4702,29,4673,894,14,880,5130,4285,845,3755,2949,806,804,128,51,2772
1/1/2013,VA,Virginia,Scott,51169,6333,3437,2896,4645,15,4630,1688,*,*,6069,3173,2896,5067,2230,2837,1490,246,111,3220
1/1/2013,VA,Virginia,Shenandoah,51171,9259,8297,962,8112,20,8092,1147,25,1122,8677,7715,962,5527,4692,835,1164,217,106,4040
1/1/2013,VA,Virginia,Smyth,51173,8390,6900,1490,6055,23,6032,2335,22,2313,7909,6419,1490,6086,4718,1368,2085,366,165,3470
1/1/2013,VA,Virginia,Southampton,51175,3613,3210,403,3005,30,2975,608,23,585,3375,2972,403,2536,2185,351,676,129,43,1688
1/1/2013,VA,Virginia,Spotsylvania,51177,15989,14413,1576,13689,98,13591,2300,87,2213,14204,12628,1576,7813,6438,1375,1548,479,125,5661
1/1/2013,VA,Virginia,Stafford,51179,12709,11785,924,11088,69,11019,1621,90,1531,11177,10254,923,5154,4377,777,1045,300,89,3720
1/1/2013,VA,Virginia,Staunton City,51790,5599,5011,588,4541,31,4510,1058,21,1037,5244,4657,587,3896,3413,483,982,150,58,2706
1/1/2013,VA,Virginia,Suffolk City,51800,13169,11025,2144,10593,75,10518,2576,76,2500,12008,9865,2143,7661,5837,1824,2452,371,118,4720
1/1/2013,VA,Virginia,Surry,51181,1352,1055,297,1119,*,*,233,12,221,1242,945,297,852,574,278,198,73,12,569
1/1/2013,VA,Virginia,Sussex,51183,2249,1890,359,1794,31,1763,455,*,*,2085,1726,359,1518,1180,338,495,145,32,846
1/1/2013,VA,Virginia,Tazewell,51185,11299,9116,2183,7989,43,7946,3310,36,3274,10718,8535,2183,7856,6141,1715,2132,437,172,5115
1/1/2013,VA,Virginia,Unknown,51999,*,*,*,*,*,*,*,*,*,*,*,*,*,*,*,*,*,*,*
1/1/2013,VA,Virginia,Virginia Beach City,51810,57984,50861,7123,50751,321,50430,7233,284,6949,53039,45922,7117,26924,20650,6274,5709,1150,352,19713
1/1/2013,VA,Virginia,Warren,51187,6273,5679,594,5321,30,5291,952,24,928,5741,5147,594,3502,2981,521,788,210,63,2441
1/1/2013,VA,Virginia,Washington,51191,13782,9938,3844,10646,48,10598,3136,16,3120,12934,9092,3842,9751,6135,3616,2436,475,198,6642
1/1/2013,VA,Virginia,Waynesboro City,51820,4506,3987,519,3686,21,3665,820,24,796,4219,3700,519,3151,2712,439,798,106,52,2195
1/1/2013,VA,Virginia,Westmoreland,51193,4347,3966,381,3805,28,3777,542,13,529,3997,3616,381,2342,2012,330,719,127,38,1458
1/1/2013,VA,Virginia,Williamsburg City,51830,2242,1983,259,2055,*,*,187,*,*,2018,1759,259,1256,1029,227,194,*,*,1017
1/1/2013,VA,Virginia,Winchester City,51840,4707,4261,446,3988,15,3973,719,20,699,4326,3880,446,2887,2482,405,781,120,48,1938
1/1/2013,VA,Virginia,Wise,51195,10088,7198,2890,6435,22,6413,3653,18,3635,9491,6602,2889,6863,4237,2626,2377,478,189,3819
1/1/2013,VA,Virginia,Wythe,51197,7085,5811,1274,5411,23,5388,1674,22,1652,6722,5448,1274,5029,3899,1130,1517,266,102,3144
1/1/2013,VA,Virginia,York,51199,9760,8785,975,8922,37,8885,838,29,809,8885,7912,973,3836,2945,891,565,137,44,3090
7/1/2013,VA,Virginia,Accomack,51001,8029,7106,923,6763,43,6720,1266,47,1219,7498,6576,922,5141,4331,810,1544,314,88,3195
7/1/2013,VA,Virginia,Albemarle,51003,16522,15176,1346,15003,47,14956,1519,56,1463,14896,13550,1346,10342,9128,1214,1479,241,89,8533
7/1/2013,VA,Virginia,Alexandria City,51510,14890,13579,1311,13502,80,13422,1388,90,1298,12072,10763,1309,6160,4927,1233,1841,329,65,3925
7/1/2013,VA,Virginia,Alleghany,51005,4358,3903,455,3463,21,3442,895,12,883,4140,3685,455,3147,2835,312,810,103,42,2192
7/1/2013,VA,Virginia,Amelia,51007,2636,2132,504,2171,*,*,465,*,*,2430,1926,504,1785,1315,470,450,77,28,1230
7/1/2013,VA,Virginia,Amherst,51009,7026,6045,981,5700,48,5652,1326,34,1292,6576,5595,981,5049,4141,908,1163,192,86,3608
7/1/2013,VA,Virginia,Appomattox,51011,3504,3020,484,2814,26,2788,690,15,675,3297,2813,484,2534,2086,448,676,94,52,1712
7/1/2013,VA,Virginia,Arlington,51013,20894,19004,1890,19240,55,19185,1654,81,1573,16782,14893,1889,8683,6908,1775,2727,319,113,5524
7/1/2013,VA,Virginia,Augusta,51015,15857,13868,1989,13414,53,13361,2443,45,2398,14890,12901,1989,10609,9025,1584,1821,340,128,8320
7/1/2013,VA,Virginia,Bath,51017,1241,1162,79,1076,*,*,165,*,*,1172,1093,79,892,833,59,197,35,23,637
7/1/2013,VA,Virginia,Bedford,51019,16813,14239,2574,14099,60,14039,2714,50,2664,15652,13081,2571,11392,9254,2138,1920,411,157,8904
7/1/2013,VA,Virginia,Bland,51021,1636,1361,275,1228,*,*,408,*,*,1561,1286,275,1106,877,229,230,56,21,799
7/1/2013,VA,Virginia,Botetourt,51023,7449,5925,1524,6320,25,6295,1129,13,1116,6892,5368,1524,4998,3603,1395,823,163,68,3944
7/1/2013,VA,Virginia,Bristol City,51520,4416,2786,1630,3365,*,*,1051,*,*,4152,2522,1630,3338,1754,1584,1036,140,59,2103
7/1/2013,VA,Virginia,Brunswick,51025,3692,3184,508,2940,24,2916,752,36,716,3490,2982,508,2665,2210,455,1052,113,41,1459
7/1/2013,VA,Virginia,Buchanan,51027,7439,5387,2052,4295,16,4279,3144,16,3128,7104,5053,2051,5473,3739,1734,1600,437,120,3316
7/1/2013,VA,Virginia,Buckingham,51029,3117,2737,380,2471,11,2460,646,15,631,2886,2507,379,2121,1802,319,702,135,51,1233
7/1/2013,VA,Virginia,Buena Vista City,51530,1375,1134,241,1090,*,*,285,*,*,1300,1059,241,990,781,209,314,60,20,596
7/1/2013,VA,Virginia,Campbell,51031,11578,9988,1590,9393,65,9328,2185,63,2122,10874,9284,1590,8324,6876,1448,1997,353,180,5794
7/1/2013,VA,Virginia,Caroline,51033,4969,4311,658,4085,28,4057,884,32,852,4522,3864,658,2921,2305,616,761,214,55,1891
7/1/2013,VA,Virginia,Carroll,51035,7464,6518,946,5854,20,5834,1610,15,1595,7110,6164,946,5407,4690,717,1716,267,129,3295
7/1/2013,VA,Virginia,Charles City,51036,1593,1230,363,1326,11,1315,267,17,250,1475,1112,363,1061,752,309,240,73,22,726
7/1/2013,VA,Virginia,Charlotte,51037,3174,2732,442,2560,21,2539,614,13,601,3007,2565,442,2275,1876,399,781,138,44,1312
7/1/2013,VA,Virginia,Charlottesville City,51540,5645,5241,404,4468,22,4446,1177,50,1127,5092,4689,403,3880,3497,383,1221,143,58,2458
7/1/2013,VA,Virginia,Chesapeake City,51550,31117,26425,4692,26307,195,26112,4810,230,4580,28103,23412,4691,15640,11491,4149,3601,750,232,11057
7/1/2013,VA,Virginia,Chesterfield,51041,47039,38029,9010,40140,176,39964,6899,208,6691,42257,33247,9010,29482,21056,8426,4525,855,278,23824
7/1/2013,VA,Virginia,Clarke,51043,2665,2381,284,2425,*,*,240,*,*,2411,2127,284,1482,1233,249,261,74,28,1119
7/1/2013,VA,Virginia,Colonial Heights City,51570,3974,3575,399,3447,*,*,527,17,510,3644,3245,399,2082,1707,375,409,83,16,1574
7/1/2013,VA,Virginia,Covington City,51580,1675,1527,148,1274,*,*,401,*,*,1561,1413,148,1179,1046,133,345,49,24,761
7/1/2013,VA,Virginia,Craig,51045,1211,992,219,910,*,*,301,*,*,1103,884,219,824,611,213,200,42,14,568
7/1/2013,VA,Virginia,Culpeper,51047,7734,6838,896,6559,48,6511,1175,39,1136,7070,6174,896,4442,3674,768,1069,227,72,3074
7/1/2013,VA,Virginia,Cumberland,51049,2053,1717,336,1671,*,*,382,*,*,1915,1580,335,1412,1098,314,421,67,28,896
7/1/2013,VA,Virginia,Danville City,51590,10909,9242,1667,8471,75,8396,2438,111,2327,10341,8674,1667,8288,7132,1156,3099,423,169,4597
7/1/2013,VA,Virginia,Dickenson,51051,4656,3371,1285,2707,*,*,1949,11,1938,4431,3146,1285,3096,1940,1156,1085,219,98,1694
7/1/2013,VA,Virginia,Dinwiddie,51053,5128,4314,814,4032,29,4003,1096,28,1068,4696,3882,814,3287,2506,781,868,161,50,2208
7/1/2013,VA,Virginia,Emporia City,51595,1185,954,231,892,12,880,293,12,281,1111,880,231,900,728,172,449,55,16,380
7/1/2013,VA,Virginia,Essex,51057,2575,2244,331,2171,13,2158,404,13,391,2402,2071,331,1689,1403,286,422,85,20,1162
7/1/2013,VA,Virginia,Fairfax,51059,124993,111371,13622,116797,427,116370,8196,446,7750,101549,87949,13600,48794,36168,12626,12310,2128,446,33910
7/1/2013,VA,Virginia,Fairfax City,51600,3214,2825,389,2980,13,2967,234,13,221,2723,2334,389,1308,944,364,309,*,*,940
7/1/2013,VA,Virginia,Falls Church City,51610,1601,1433,168,1501,*,*,100,*,*,1289,1122,167,667,514,153,142,*,*,501
7/1/2013,VA,Virginia,Fauquier,51061,10274,9335,939,9233,45,9188,1041,35,1006,9085,8147,938,4929,4167,762,822,160,55,3892
7/1/2013,VA,Virginia,Floyd,51063,3550,2951,599,2990,12,2978,560,*,*,3301,2702,599,2463,1909,554,521,87,46,1809
7/1/2013,VA,Virginia,Fluvanna,51065,4947,4438,509,4389,19,4370,558,19,539,4585,4076,509,3017,2573,444,454,106,20,2437
7/1/2013,VA,Virginia,Franklin,51067,13009,10001,3008,10549,43,10506,2460,22,2438,12193,9185,3008,9270,6528,2742,1969,403,152,6746
7/1/2013,VA,Virginia,Franklin City,51620,1820,1650,170,1403,*,*,417,22,395,1701,1531,170,1321,1170,151,498,76,18,729
7/1/2013,VA,Virginia,Frederick,51069,13218,11783,1435,11582,45,11537,1636,40,1596,12105,10671,1434,7576,6307,1269,1351,315,136,5774
7/1/2013,VA,Virginia,Fredericksburg City,51630,3468,3211,257,2814,19,2795,654,27,627,3131,2874,257,1989,1752,237,705,82,42,1160
7/1/2013,VA,Virginia,Galax City,51640,1942,1825,117,1482,*,*,460,*,*,1860,1743,117,1433,1353,80,673,75,34,651
7/1/2013,VA,Virginia,Giles,51071,4363,3456,907,3360,16,3344,1003,16,987,4103,3197,906,2931,2071,860,773,123,35,2000
7/1/2013,VA,Virginia,Gloucester,51073,7163,6161,1002,6101,32,6069,1062,20,1042,6579,5577,1002,3702,2823,879,848,165,61,2628
7/1/2013,VA,Virginia,Goochland,51075,4534,3740,794,4055,21,4034,479,15,464,4070,3276,794,3042,2306,736,408,99,40,2495
7/1/2013,VA,Virginia,Grayson,51077,4386,3928,458,3521,12,3509,865,*,*,4227,3769,458,3038,2646,392,1030,162,79,1767
7/1/2013,VA,Virginia,Greene,51079,3151,2831,320,2712,16,2696,439,11,428,2904,2584,320,1942,1652,290,439,70,27,1406
7/1/2013,VA,Virginia,Greensville,51081,2269,1714,555,1791,19,1772,478,22,456,2113,1558,555,1726,1247,479,534,120,32,1040
7/1/2013,VA,Virginia,Halifax,51083,9070,7913,1157,7165,59,7106,1905,56,1849,8572,7416,1156,6752,5679,1073,2249,399,134,3970
7/1/2013,VA,Virginia,Hampton City,51650,22289,18503,3786,18030,178,17852,4259,210,4049,20425,16639,3786,10608,7169,3439,3306,735,189,6378
7/1/2013,VA,Virginia,Hanover,51085,16985,13787,3198,15166,70,15096,1819,49,1770,15510,12312,3198,11184,8319,2865,1286,326,101,9471
7/1/2013,VA,Virginia,Harrisonburg City,51660,4719,4218,501,3950,18,3932,769,21,748,4312,3811,501,3182,2913,269,837,117,43,2185
7/1/2013,VA,Virginia,Henrico,51087,47583,38108,9475,40828,264,40564,6755,317,6438,43176,33703,9473,31429,22624,8805,5547,1161,373,24348
7/1/2013,VA,Virginia,Henry,51089,14596,10546,4050,11300,56,11244,3296,66,3230,13962,9912,4050,11550,8471,3079,3099,640,227,7584
7/1/2013,VA,Virginia,Highland,51091,683,625,58,617,*,*,66,0,66,647,589,58,452,399,53,72,*,*,352
7/1/2013,VA,Virginia,Hopewell City,51670,4216,3723,493,3269,23,3246,947,36,911,3935,3442,493,2507,2028,479,870,127,41,1469
7/1/2013,VA,Virginia,Isle of Wight,51093,6866,5557,1309,5864,37,5827,1002,32,970,6367,5058,1309,4006,2777,1229,921,165,75,2845
7/1/2013,VA,Virginia,James City,51095,16695,15046,1649,15593,41,15552,1102,41,1061,15408,13762,1646,8261,6814,1447,790,178,48,7245
7/1/2013,VA,Virginia,King and Queen,51097,1526,1337,189,1264,*,*,262,*,*,1432,1243,189,1040,860,180,258,*,*,694
7/1/2013,VA,Virginia,King George,51099,3085,2880,205,2644,18,2626,441,23,418,2700,2495,205,1267,1078,189,390,76,23,778
7/1/2013,VA,Virginia,King William,51101,2762,2395,367,2348,18,2330,414,18,396,2550,2183,367,1901,1565,336,366,76,20,1439
7/1/2013,VA,Virginia,Lancaster,51103,4020,3611,409,3688,11,3677,332,15,317,3821,3412,409,2460,2155,305,478,84,32,1866
7/1/2013,VA,Virginia,Lee,51105,6178,4347,1831,3989,13,3976,2189,19,2170,5846,4018,1828,4553,2847,1706,1882,255,80,2336
7/1/2013,VA,Virginia,Lexington City,51678,1553,1416,137,1412,*,*,141,*,*,1451,1314,137,1063,953,110,195,34,11,823
7/1/2013,VA,Virginia,Loudoun,51107,26638,23118,3520,24602,81,24521,2036,90,1946,22169,18654,3515,12431,9191,3240,2280,471,113,9567
7/1/2013,VA,Virginia,Louisa,51109,6520,5628,892,5369,31,5338,1151,29,1122,5977,5085,892,4056,3219,837,1027,231,72,2726
7/1/2013,VA,Virginia,Lunenburg,51111,2789,2502,287,2240,11,2229,549,24,525,2592,2305,287,1868,1601,267,670,102,40,1056
7/1/2013,VA,Virginia,Lynchburg City,51680,13927,12321,1606,10878,80,10798,3049,104,2945,13001,11395,1606,10052,8599,1453,3225,422,149,6256
7/1/2013,VA,Virginia,Madison,51113,2646,2365,281,2314,11,2303,332,*,*,2483,2202,281,1680,1421,259,390,77,24,1189
7/1/2013,VA,Virginia,Manassas City,51683,3654,3207,447,3148,18,3130,506,29,477,3151,2704,447,1933,1546,387,514,99,20,1300
7/1/2013,VA,Virginia,Manassas Park City,51685,1014,856,158,862,11,851,152,*,*,858,700,158,554,412,142,144,*,*,366
7/1/2013,VA,Virginia,Martinsville City,51690,3878,3052,826,2861,19,2842,1017,31,986,3709,2883,826,3141,2512,629,1303,146,52,1640
7/1/2013,VA,Virginia,Mathews,51115,2564,2244,320,2322,*,*,242,*,*,2427,2107,320,1422,1128,294,261,41,18,1102
7/1/2013,VA,Virginia,Mecklenburg,51117,8585,7238,1347,6921,49,6872,1664,41,1623,8101,6756,1345,6131,5066,1065,1874,357,110,3790
7/1/2013,VA,Virginia,Middlesex,51119,3268,2859,409,2892,15,2877,376,11,365,3085,2676,409,2132,1808,324,421,85,23,1603
7/1/2013,VA,Virginia,Montgomery,51121,12207,10484,1723,9906,30,9876,2301,28,2273,11150,9427,1723,8578,6943,1635,1779,271,104,6424
7/1/2013,VA,Virginia,Nelson,51125,3919,3547,372,3376,*,*,543,16,527,3625,3253,372,2466,2133,333,604,108,39,1715
7/1/2013,VA,Virginia,New Kent,51127,3354,2835,519,2913,16,2897,441,11,430,3052,2533,519,1957,1514,443,277,73,24,1583
7/1/2013,VA,Virginia,Newport News City,51700,24927,20272,4655,20298,164,20134,4629,218,4411,22851,18197,4654,12949,8607,4342,4205,743,224,7777
7/1/2013,VA,Virginia,Norfolk City,51710,29470,24452,5018,23171,214,22957,6299,333,5966,26666,21648,5018,16338,11886,4452,6666,1095,299,8278
7/1/2013,VA,Virginia,Northampton,51131,3246,2898,348,2725,23,2702,521,32,489,3056,2708,348,2375,2062,313,909,98,34,1334
7/1/2013,VA,Virginia,Northumberland,51133,4366,3997,369,4007,11,3996,359,11,348,4113,3744,369,2417,2145,272,434,88,26,1869
7/1/2013,VA,Virginia,Norton City,51720,1159,916,243,713,*,*,446,*,*,1068,825,243,821,594,227,362,51,21,387
7/1/2013,VA,Virginia,Nottoway,51135,3489,3055,434,2825,22,2803,664,13,651,3227,2793,434,2411,2133,278,898,116,45,1352
7/1/2013,VA,Virginia,Orange,51137,7801,7108,693,6791,37,6754,1010,31,979,7188,6496,692,4199,3627,572,907,224,66,3002
7/1/2013,VA,Virginia,Page,51139,5591,4952,639,4516,17,4499,1075,16,1059,5223,4584,639,3569,2991,578,1084,200,86,2199
7/1/2013,VA,Virginia,Patrick,51141,4885,3855,1030,3934,15,3919,951,*,*,4675,3646,1029,3619,2773,846,1001,191,76,2351
7/1/2013,VA,Virginia,Petersburg City,51730,6944,6006,938,5010,68,4942,1934,81,1853,6357,5419,938,4405,3563,842,2102,291,78,1934
7/1/2013,VA,Virginia,Pittsylvania,51143,14738,11749,2989,11767,83,11684,2971,80,2891,14020,11031,2989,11141,9059,2082,3032,539,238,7332
7/1/2013,VA,Virginia,Poquoson City,51735,2311,2097,214,2130,*,*,181,*,*,2112,1898,214,831,636,195,113,*,*,689
7/1/2013,VA,Virginia,Portsmouth City,51740,16715,13706,3009,12857,160,12697,3858,205,3653,14989,11980,3009,8933,6228,2705,3586,669,143,4535
7/1/2013,VA,Virginia,Powhatan,51145,4798,3942,856,4197,19,4178,601,20,581,4361,3505,856,3154,2377,777,375,83,35,2661
7/1/2013,VA,Virginia,Prince Edward,51147,4229,3659,570,3289,17,3272,940,34,906,3945,3375,570,2946,2498,448,1018,182,47,1699
7/1/2013,VA,Virginia,Prince George,51149,4948,4426,522,4095,24,4071,853,25,828,4582,4061,521,2564,2074,490,526,107,24,1907
7/1/2013,VA,Virginia,Prince William,51153,36982,32245,4737,32457,177,32280,4525,269,4256,31614,26880,4734,16054,11781,4273,4165,781,179,10929
7/1/2013,VA,Virginia,Pulaski,51155,8422,7189,1233,6464,30,6434,1958,27,1931,7910,6677,1233,5852,4673,1179,1656,308,119,3769
7/1/2013,VA,Virginia,Radford City,51750,1966,1675,291,1562,*,*,404,*,*,1829,1538,291,1462,1178,284,326,47,33,1056
7/1/2013,VA,Virginia,Rappahannock,51157,1779,1667,112,1591,*,*,188,*,*,1621,1509,112,949,857,92,175,*,*,731
7/1/2013,VA,Virginia,Richmond,51159,1763,1504,259,1516,13,1503,247,*,*,1667,1408,259,1156,936,220,274,78,26,778
7/1/2013,VA,Virginia,Richmond City,51760,30328,23494,6834,23132,258,22874,7196,347,6849,27404,20572,6832,21500,14949,6551,8086,1271,306,11837
7/1/2013,VA,Virginia,Roanoke,51161,20704,17162,3542,18061,66,17995,2643,42,2601,19172,15630,3542,13592,10212,3380,1854,368,122,11248
7/1/2013,VA,Virginia,Roanoke City,51770,18909,15205,3704,13778,116,13662,5131,127,5004,17354,13651,3703,13183,9633,3550,4534,731,229,7689
7/1/2013,VA,Virginia,Rockbridge,51163,5404,4505,899,4467,21,4446,937,13,924,5078,4179,899,3645,2935,710,833,153,69,2590
7/1/2013,VA,Virginia,Rockingham,51165,14961,12603,2358,12956,55,12901,2005,44,1961,13927,11570,2357,9984,8935,1049,1697,414,152,7721
7/1/2013,VA,Virginia,Russell,51167,7540,5751,1789,4762,12,4750,2778,12,2766,7205,5416,1789,5366,3728,1638,1709,276,115,3266
7/1/2013,VA,Virginia,Salem City,51775,5606,4751,855,4678,27,4651,928,16,912,5149,4294,855,3772,2955,817,793,124,50,2805
7/1/2013,VA,Virginia,Scott,51169,6382,3437,2945,4644,13,4631,1738,*,*,6104,3159,2945,5100,2212,2888,1527,236,107,3230
7/1/2013,VA,Virginia,Shenandoah,51171,9361,8388,973,8160,18,8142,1201,26,1175,8779,7806,973,5626,4783,843,1213,202,99,4112
7/1/2013,VA,Virginia,Smyth,51173,8426,6924,1502,6044,19,6025,2382,24,2358,7972,6470,1502,6132,4759,1373,2105,358,147,3522
7/1/2013,VA,Virginia,Southampton,51175,3660,3253,407,3038,26,3012,622,23,599,3403,2996,407,2556,2203,353,691,123,39,1703
7/1/2013,VA,Virginia,Spotsylvania,51177,16343,14768,1575,13936,86,13850,2407,86,2321,14566,12991,1575,8045,6670,1375,1612,472,122,5839
7/1/2013,VA,Virginia,Stafford,51179,12992,12073,919,11302,61,11241,1690,90,1600,11425,10507,918,5250,4475,775,1102,288,84,3776
7/1/2013,VA,Virginia,Staunton City,51790,5633,5074,559,4536,24,4512,1097,24,1073,5298,4740,558,3939,3477,462,1023,141,53,2722
7/1/2013,VA,Virginia,Suffolk City,51800,13338,11142,2196,10670,69,10601,2668,77,2591,12177,9982,2195,7800,5926,1874,2524,375,115,4786
7/1/2013,VA,Virginia,Surry,51181,1390,1088,302,1148,*,*,242,12,230,1281,979,302,879,597,282,208,67,12,592
7/1/2013,VA,Virginia,Sussex,51183,2253,1898,355,1785,29,1756,468,*,*,2087,1732,355,1514,1177,337,501,141,30,842
7/1/2013,VA,Virginia,Tazewell,51185,11375,9176,2199,7986,39,7947,3389,35,3354,10803,8604,2199,7884,6138,1746,2190,426,164,5104
7/1/2013,VA,Virginia,Unknown,51999,*,*,*,*,*,*,*,*,*,*,*,*,*,*,*,*,*,*,*
7/1/2013,VA,Virginia,Virginia Beach City,51810,59057,51797,7260,51517,296,51221,7540,295,7245,53997,46742,7255,27549,21146,6403,5897,1122,337,20193
7/1/2013,VA,Virginia,Warren,51187,6373,5783,590,5376,25,5351,997,23,974,5845,5255,590,3558,3035,523,827,198,69,2464
7/1/2013,VA,Virginia,Washington,51191,13898,10020,3878,10693,43,10650,3205,14,3191,13090,9214,3876,9854,6202,3652,2477,478,186,6713
7/1/2013,VA,Virginia,Waynesboro City,51820,4545,4048,497,3696,21,3675,849,24,825,4277,3780,497,3213,2795,418,843,100,46,2224
7/1/2013,VA,Virginia,Westmoreland,51193,4408,4035,373,3853,26,3827,555,14,541,4073,3700,373,2391,2064,327,751,119,34,1487
7/1/2013,VA,Virginia,Williamsburg City,51830,2267,2002,265,2073,*,*,194,*,*,2045,1780,265,1285,1054,231,195,*,*,1049
7/1/2013,VA,Virginia,Winchester City,51840,4723,4276,447,3986,13,3973,737,20,717,4340,3893,447,2911,2506,405,798,117,45,1951
7/1/2013,VA,Virginia,Wise,51195,10149,7203,2946,6410,14,6396,3739,18,3721,9563,6618,2945,6944,4241,2703,2446,457,174,3867
7/1/2013,VA,Virginia,Wythe,51197,7135,5855,1280,5408,18,5390,1727,25,1702,6761,5481,1280,5055,3920,1135,1543,256,93,3163
7/1/2013,VA,Virginia,York,51199,9954,8937,1017,9084,32,9052,870,27,843,9074,8060,1014,3960,3022,938,584,139,43,3194
6/1/2013,VA,Virginia,Accomack,51001,8002,7085,917,6747,43,6704,1255,48,1207,7452,6536,916,5118,4313,805,1535,312,87,3184
6/1/2013,VA,Virginia,Albemarle,51003,16477,15134,1343,14969,48,14921,1508,56,1452,14810,13467,1343,10271,9062,1209,1464,242,88,8477
6/1/2013,VA,Virginia,Alexandria City,51510,14809,13506,1303,13427,80,13347,1382,90,1292,11926,10625,1301,6129,4905,1224,1839,325,67,3898
6/1/2013,VA,Virginia,Alleghany,51005,4346,3893,453,3457,21,3436,889,11,878,4114,3661,453,3138,2827,311,810,104,42,2182
6/1/2013,VA,Virginia,Amelia,51007,2627,2126,501,2168,*,*,459,*,*,2413,1912,501,1778,1311,467,450,77,28,1223
6/1/2013,VA,Virginia,Amherst,51009,7010,6032,978,5690,48,5642,1320,35,1285,6544,5566,978,5030,4125,905,1155,196,87,3592
6/1/2013,VA,Virginia,Appomattox,51011,3492,3010,482,2808,26,2782,684,15,669,3286,2804,482,2531,2084,447,677,92,52,1710
6/1/2013,VA,Virginia,Arlington,51013,20802,18922,1880,19158,56,19102,1644,82,1562,16612,14733,1879,8614,6849,1765,2701,321,110,5482
6/1/2013,VA,Virginia,Augusta,51015,15817,13823,1994,13377,55,13322,2440,45,2395,14827,12833,1994,10568,8981,1587,1819,343,127,8279
6/1/2013,VA,Virginia,Bath,51017,1237,1158,79,1073,*,*,164,*,*,1165,1086,79,891,832,59,198,36,23,634
6/1/2013,VA,Virginia,Bedford,51019,16768,14191,2577,14063,61,14002,2705,50,2655,15581,13007,2574,11360,9223,2137,1910,412,159,8879
6/1/2013,VA,Virginia,Bland,51021,1636,1360,276,1227,*,*,409,*,*,1559,1283,276,1108,878,230,231,56,21,800
6/1/2013,VA,Virginia,Botetourt,51023,7415,5899,1516,6295,26,6269,1120,13,1107,6846,5330,1516,4981,3594,1387,821,165,69,3926
6/1/2013,VA,Virginia,Bristol City,51520,4409,2790,1619,3363,*,*,1046,*,*,4138,2519,1619,3333,1759,1574,1037,143,58,2095
6/1/2013,VA,Virginia,Brunswick,51025,3682,3173,509,2933,26,2907,749,36,713,3464,2955,509,2657,2200,457,1047,114,40,1456
6/1/2013,VA,Virginia,Buchanan,51027,7429,5381,2048,4292,16,4276,3137,16,3121,7072,5025,2047,5471,3741,1730,1597,439,121,3314
6/1/2013,VA,Virginia,Buckingham,51029,3103,2730,373,2463,12,2451,640,14,626,2857,2485,372,2109,1797,312,700,136,51,1222
6/1/2013,VA,Virginia,Buena Vista City,51530,1373,1132,241,1091,*,*,282,*,*,1292,1051,241,985,777,208,310,60,20,595
6/1/2013,VA,Virginia,Campbell,51031,11566,9984,1582,9391,65,9326,2175,63,2112,10846,9264,1582,8304,6865,1439,1981,353,180,5790
6/1/2013,VA,Virginia,Caroline,51033,4938,4281,657,4062,29,4033,876,32,844,4488,3831,657,2912,2297,615,756,216,55,1885
6/1/2013,VA,Virginia,Carroll,51035,7448,6515,933,5850,20,5830,1598,14,1584,7084,6151,933,5390,4681,709,1713,267,130,3280
6/1/2013,VA,Virginia,Charles City,51036,1580,1218,362,1318,11,1307,262,17,245,1457,1095,362,1052,744,308,241,73,22,716
6/1/2013,VA,Virginia,Charlotte,51037,3178,2737,441,2562,21,2541,616,14,602,3005,2564,441,2276,1878,398,779,140,44,1313
6/1/2013,VA,Virginia,Charlottesville City,51540,5616,5213,403,4452,23,4429,1164,48,1116,5034,4632,402,3848,3466,382,1211,142,57,2438
6/1/2013,VA,Virginia,Chesapeake City,51550,31001,26329,4672,26245,197,26048,4756,229,4527,27870,23199,4671,15526,11404,4122,3565,744,236,10981
6/1/2013,VA,Virginia,Chesterfield,51041,46840,37890,8950,39967,179,39788,6873,208,6665,41951,33001,8950,29303,20937,8366,4491,859,279,23674
6/1/2013,VA,Virginia,Clarke,51043,2660,2378,282,2420,*,*,240,*,*,2396,2114,282,1477,1230,247,261,74,28,1114
6/1/2013,VA,Virginia,Colonial Heights City,51570,3966,3570,396,3443,*,*,523,17,506,3624,3228,396,2070,1699,371,402,83,16,1569
6/1/2013,VA,Virginia,Covington City,51580,1679,1530,149,1278,*,*,401,*,*,1558,1409,149,1176,1042,134,346,48,23,759
6/1/2013,VA,Virginia,Craig,51045,1204,987,217,906,*,*,298,*,*,1095,878,217,815,604,211,197,41,14,563
6/1/2013,VA,Virginia,Culpeper,51047,7702,6807,895,6536,49,6487,1166,38,1128,7024,6129,895,4418,3650,768,1063,227,71,3057
6/1/2013,VA,Virginia,Cumberland,51049,2051,1715,336,1674,*,*,377,*,*,1903,1568,335,1414,1100,314,419,71,29,895
6/1/2013,VA,Virginia,Danville City,51590,10879,9215,1664,8458,75,8383,2421,110,2311,10304,8640,1664,8261,7109,1152,3084,421,166,4590
6/1/2013,VA,Virginia,Dickenson,51051,4650,3370,1280,2706,*,*,1944,11,1933,4411,3131,1280,3085,1935,1150,1081,220,99,1685
6/1/2013,VA,Virginia,Dinwiddie,51053,5099,4288,811,4010,29,3981,1089,26,1063,4663,3852,811,3273,2494,779,864,160,50,2199
6/1/2013,VA,Virginia,Emporia City,51595,1182,952,230,894,12,882,288,12,276,1111,881,230,901,730,171,450,54,16,381
6/1/2013,VA,Virginia,Essex,51057,2569,2239,330,2170,14,2156,399,13,386,2382,2052,330,1684,1399,285,416,87,20,1161
6/1/2013,VA,Virginia,Fairfax,51059,124245,110754,13491,116110,429,115681,8135,440,7695,100414,86945,13469,48470,35973,12497,12237,2115,441,33677
6/1/2013,VA,Virginia,Fairfax City,51600,3199,2815,384,2969,13,2956,230,12,218,2700,2316,384,1295,936,359,303,*,*,933
6/1/2013,VA,Virginia,Falls Church City,51610,1596,1426,170,1497,*,*,99,*,*,1281,1113,168,662,507,155,142,*,*,496
6/1/2013,VA,Virginia,Fauquier,51061,10231,9290,941,9198,46,9152,1033,35,998,9020,8080,940,4911,4147,764,816,161,55,3879
6/1/2013,VA,Virginia,Floyd,51063,3540,2944,596,2988,12,2976,552,*,*,3295,2699,596,2457,1906,551,519,89,46,1803
6/1/2013,VA,Virginia,Fluvanna,51065,4933,4421,512,4382,21,4361,551,19,532,4552,4040,512,3006,2559,447,453,107,20,2426
6/1/2013,VA,Virginia,Franklin,51067,12986,9984,3002,10535,45,10490,2451,22,2429,12156,9154,3002,9230,6493,2737,1959,404,152,6715
6/1/2013,VA,Virginia,Franklin City,51620,1816,1646,170,1401,*,*,415,21,394,1695,1525,170,1313,1162,151,494,75,18,726
6/1/2013,VA,Virginia,Frederick,51069,13165,11743,1422,11547,45,11502,1618,40,1578,12031,10610,1421,7523,6266,1257,1338,314,136,5735
6/1/2013,VA,Virginia,Fredericksburg City,51630,3464,3205,259,2812,20,2792,652,27,625,3120,2861,259,1986,1748,238,705,79,42,1160
6/1/2013,VA,Virginia,Galax City,51640,1943,1826,117,1481,*,*,462,11,451,1859,1742,117,1430,1351,79,676,75,32,647
6/1/2013,VA,Virginia,Giles,51071,4339,3444,895,3345,16,3329,994,18,976,4076,3182,894,2908,2060,848,766,125,33,1984
6/1/2013,VA,Virginia,Gloucester,51073,7136,6134,1002,6079,32,6047,1057,20,1037,6535,5533,1002,3679,2800,879,841,164,59,2615
6/1/2013,VA,Virginia,Goochland,51075,4516,3730,786,4041,22,4019,475,15,460,4041,3255,786,3018,2290,728,410,99,40,2469
6/1/2013,VA,Virginia,Grayson,51077,4390,3930,460,3523,12,3511,867,*,*,4226,3766,460,3045,2651,394,1026,165,80,1774
6/1/2013,VA,Virginia,Greene,51079,3142,2823,319,2703,16,2687,439,12,427,2885,2566,319,1938,1649,289,440,68,29,1401
6/1/2013,VA,Virginia,Greensville,51081,2263,1714,549,1790,19,1771,473,22,451,2101,1552,549,1716,1244,472,531,120,32,1033
6/1/2013,VA,Virginia,Halifax,51083,9060,7904,1156,7159,59,7100,1901,56,1845,8555,7400,1155,6748,5676,1072,2248,401,134,3965
6/1/2013,VA,Virginia,Hampton City,51650,22226,18462,3764,17999,182,17817,4227,209,4018,20313,16549,3764,10580,7163,3417,3287,732,186,6375
6/1/2013,VA,Virginia,Hanover,51085,16929,13753,3176,15127,73,15054,1802,48,1754,15422,12246,3176,11134,8288,2846,1277,329,104,9424
6/1/2013,VA,Virginia,Harrisonburg City,51660,4694,4198,496,3932,19,3913,762,21,741,4280,3784,496,3162,2895,267,840,116,43,2163
6/1/2013,VA,Virginia,Henrico,51087,47412,37973,9439,40697,271,40426,6715,319,6396,42925,33489,9436,31275,22505,8770,5501,1150,369,24255
6/1/2013,VA,Virginia,Henry,51089,14584,10537,4047,11306,57,11249,3278,67,3211,13930,9883,4047,11537,8460,3077,3083,637,230,7587
6/1/2013,VA,Virginia,Highland,51091,683,625,58,617,*,*,66,0,66,644,586,58,452,399,53,73,*,*,351
6/1/2013,VA,Virginia,Hopewell City,51670,4208,3717,491,3262,23,3239,946,36,910,3913,3422,491,2503,2027,476,870,127,40,1466
6/1/2013,VA,Virginia,Isle of Wight,51093,6846,5541,1305,5850,37,5813,996,32,964,6331,5026,1305,3982,2758,1224,912,163,76,2831
6/1/2013,VA,Virginia,James City,51095,16648,15004,1644,15551,41,15510,1097,41,1056,15347,13706,1641,8224,6781,1443,785,177,46,7216
6/1/2013,VA,Virginia,King and Queen,51097,1519,1333,186,1258,*,*,261,*,*,1424,1238,186,1036,859,177,257,*,*,691
6/1/2013,VA,Virginia,King George,51099,3074,2869,205,2635,18,2617,439,23,416,2681,2476,205,1261,1072,189,390,77,23,771
6/1/2013,VA,Virginia,King William,51101,2756,2389,367,2341,18,2323,415,18,397,2530,2163,367,1894,1558,336,370,70,20,1434
6/1/2013,VA,Virginia,Lancaster,51103,4001,3595,406,3672,12,3660,329,15,314,3800,3394,406,2441,2139,302,473,86,32,1850
6/1/2013,VA,Virginia,Lee,51105,6164,4362,1802,3985,13,3972,2179,19,2160,5816,4017,1799,4528,2849,1679,1879,254,79,2316
6/1/2013,VA,Virginia,Lexington City,51678,1551,1413,138,1412,*,*,139,*,*,1446,1308,138,1058,948,110,191,37,11,819
6/1/2013,VA,Virginia,Loudoun,51107,26471,22965,3506,24463,82,24381,2008,89,1919,21901,18400,3501,12354,9129,3225,2252,469,111,9522
6/1/2013,VA,Virginia,Louisa,51109,6490,5601,889,5345,31,5314,1145,29,1116,5927,5038,889,4026,3192,834,1019,229,72,2706
6/1/2013,VA,Virginia,Lunenburg,51111,2776,2489,287,2228,11,2217,548,25,523,2575,2288,287,1862,1595,267,668,102,40,1052
6/1/2013,VA,Virginia,Lynchburg City,51680,13900,12297,1603,10871,81,10790,3029,102,2927,12950,11347,1603,10018,8566,1452,3220,420,150,6228
6/1/2013,VA,Virginia,Madison,51113,2637,2356,281,2306,11,2295,331,*,*,2475,2194,281,1680,1421,259,395,78,25,1182
6/1/2013,VA,Virginia,Manassas City,51683,3630,3181,449,3131,19,3112,499,29,470,3119,2670,449,1917,1529,388,509,96,21,1291
6/1/2013,VA,Virginia,Manassas Park City,51685,1010,852,158,860,11,849,150,*,*,852,694,158,553,411,142,141,*,*,368
6/1/2013,VA,Virginia,Martinsville City,51690,3871,3048,823,2859,19,2840,1012,31,981,3694,2871,823,3137,2506,631,1296,149,52,1640
6/1/2013,VA,Virginia,Mathews,51115,2563,2242,321,2321,*,*,242,*,*,2421,2100,321,1422,1126,296,255,42,19,1106
6/1/2013,VA,Virginia,Mecklenburg,51117,8574,7226,1348,6913,51,6862,1661,41,1620,8072,6726,1346,6111,5044,1067,1868,363,110,3770
6/1/2013,VA,Virginia,Middlesex,51119,3261,2852,409,2888,15,2873,373,11,362,3076,2667,409,2127,1802,325,419,85,23,1600
6/1/2013,VA,Virginia,Montgomery,51121,12171,10463,1708,9882,30,9852,2289,28,2261,11088,9380,1708,8518,6898,1620,1770,272,105,6371
6/1/2013,VA,Virginia,Nelson,51125,3904,3532,372,3365,*,*,539,16,523,3602,3230,372,2461,2129,332,603,107,40,1711
6/1/2013,VA,Virginia,New Kent,51127,3335,2822,513,2896,16,2880,439,11,428,3027,2514,513,1949,1512,437,276,72,24,1577
6/1/2013,VA,Virginia,Newport News City,51700,24838,20221,4617,20251,168,20083,4587,217,4370,22722,18106,4616,12892,8591,4301,4160,747,221,7764
6/1/2013,VA,Virginia,Norfolk City,51710,29369,24373,4996,23108,218,22890,6261,333,5928,26485,21489,4996,16252,11828,4424,6627,1095,293,8237
6/1/2013,VA,Virginia,Northampton,51131,3243,2900,343,2723,24,2699,520,32,488,3052,2709,343,2362,2054,308,903,99,34,1326
6/1/2013,VA,Virginia,Northumberland,51133,4360,3989,371,4002,11,3991,358,11,347,4092,3721,371,2415,2143,272,427,91,27,1870
6/1/2013,VA,Virginia,Norton City,51720,1154,913,241,714,*,*,440,*,*,1061,820,241,816,591,225,357,52,21,386
6/1/2013,VA,Virginia,Nottoway,51135,3478,3042,436,2823,22,2801,655,14,641,3206,2770,436,2412,2133,279,898,118,44,1352
6/1/2013,VA,Virginia,Orange,51137,7769,7079,690,6773,37,6736,996,30,966,7144,6455,689,4174,3603,571,902,225,66,2981
6/1/2013,VA,Virginia,Page,51139,5582,4946,636,4512,17,4495,1070,15,1055,5205,4569,636,3563,2988,575,1078,201,86,2198
6/1/2013,VA,Virginia,Patrick,51141,4880,3855,1025,3934,15,3919,946,*,*,4661,3637,1024,3616,2775,841,999,189,77,2351
6/1/2013,VA,Virginia,Petersburg City,51730,6925,5989,936,5001,68,4933,1924,81,1843,6320,5384,936,4398,3557,841,2089,297,78,1934
6/1/2013,VA,Virginia,Pittsylvania,51143,14706,11712,2994,11740,84,11656,2966,78,2888,13966,10972,2994,11094,9008,2086,3010,533,241,7310
6/1/2013,VA,Virginia,Poquoson City,51735,2302,2093,209,2124,*,*,178,*,*,2096,1887,209,826,635,191,110,*,*,685
6/1/2013,VA,Virginia,Portsmouth City,51740,16670,13674,2996,12827,165,12662,3843,207,3636,14899,11903,2996,8917,6226,2691,3570,677,144,4526
6/1/2013,VA,Virginia,Powhatan,51145,4787,3932,855,4189,19,4170,598,20,578,4336,3481,855,3138,2362,776,375,84,33,2646
6/1/2013,VA,Virginia,Prince Edward,51147,4226,3661,565,3288,17,3271,938,35,903,3933,3368,565,2939,2493,446,1014,178,47,1700
6/1/2013,VA,Virginia,Prince George,51149,4934,4414,520,4088,24,4064,846,26,820,4555,4036,519,2561,2072,489,523,108,24,1906
6/1/2013,VA,Virginia,Prince William,51153,36793,32094,4699,32293,180,32113,4500,268,4232,31283,26587,4696,15928,11696,4232,4134,778,180,10836
6/1/2013,VA,Virginia,Pulaski,51155,8391,7159,1232,6451,30,6421,1940,25,1915,7870,6638,1232,5830,4652,1178,1644,308,119,3759
6/1/2013,VA,Virginia,Radford City,51750,1962,1674,288,1557,*,*,405,*,*,1819,1531,288,1453,1172,281,322,46,33,1052
6/1/2013,VA,Virginia,Rappahannock,51157,1776,1664,112,1587,*,*,189,*,*,1613,1501,112,950,858,92,173,*,*,734
6/1/2013,VA,Virginia,Richmond,51159,1758,1497,261,1514,13,1501,244,*,*,1659,1398,261,1148,926,222,272,77,25,774
6/1/2013,VA,Virginia,Richmond City,51760,30225,23409,6816,23084,258,22826,7141,344,6797,27238,20424,6814,21400,14868,6532,8034,1258,302,11806
6/1/2013,VA,Virginia,Roanoke,51161,20636,17102,3534,18009,66,17943,2627,43,2584,19078,15544,3534,13552,10180,3372,1850,365,121,11216
6/1/2013,VA,Virginia,Roanoke City,51770,18868,15190,3678,13755,114,13641,5113,126,4987,17264,13587,3677,13134,9610,3524,4508,731,229,7666
6/1/2013,VA,Virginia,Rockbridge,51163,5387,4494,893,4454,21,4433,933,13,920,5040,4147,893,3612,2907,705,820,155,68,2569
6/1/2013,VA,Virginia,Rockingham,51165,14920,12563,2357,12937,58,12879,1983,40,1943,13858,11502,2356,9926,8880,1046,1683,417,151,7675
6/1/2013,VA,Virginia,Russell,51167,7529,5739,1790,4772,13,4759,2757,12,2745,7182,5392,1790,5367,3731,1636,1707,278,116,3266
6/1/2013,VA,Virginia,Salem City,51775,5600,4745,855,4679,27,4652,921,16,905,5131,4276,855,3766,2949,817,795,123,50,2798
6/1/2013,VA,Virginia,Scott,51169,6370,3438,2932,4639,13,4626,1731,*,*,6083,3151,2932,5087,2213,2874,1520,238,107,3222
6/1/2013,VA,Virginia,Shenandoah,51171,9347,8375,972,8150,18,8132,1197,26,1171,8745,7773,972,5598,4755,843,1207,203,101,4087
6/1/2013,VA,Virginia,Smyth,51173,8420,6925,1495,6041,20,6021,2379,24,2355,7949,6454,1495,6119,4750,1369,2101,361,148,3509
6/1/2013,VA,Virginia,Southampton,51175,3647,3241,406,3026,27,2999,621,23,598,3388,2982,406,2551,2197,354,689,124,39,1699
6/1/2013,VA,Virginia,Spotsylvania,51177,16270,14703,1567,13884,88,13796,2386,86,2300,14432,12865,1567,7994,6625,1369,1593,472,122,5807
6/1/2013,VA,Virginia,Stafford,51179,12942,12024,918,11263,62,11201,1679,92,1587,11335,10418,917,5235,4461,774,1099,287,84,3765
6/1/2013,VA,Virginia,Staunton City,51790,5628,5073,555,4541,27,4514,1087,21,1066,5266,4712,554,3925,3464,461,1012,145,54,2714
6/1/2013,VA,Virginia,Suffolk City,51800,13301,11115,2186,10655,70,10585,2646,79,2567,12112,9927,2185,7777,5915,1862,2519,373,113,4772
6/1/2013,VA,Virginia,Surry,51181,1385,1084,301,1143,*,*,242,13,229,1270,969,301,878,597,281,208,66,12,592
6/1/2013,VA,Virginia,Sussex,51183,2248,1893,355,1784,28,1756,464,*,*,2080,1725,355,1513,1176,337,500,140,30,843
6/1/2013,VA,Virginia,Tazewell,51185,11360,9182,2178,7981,39,7942,3379,35,3344,10765,8587,2178,7863,6141,1722,2175,428,163,5097
6/1/2013,VA,Virginia,Unknown,51999,*,*,*,*,*,*,*,*,*,*,*,*,*,*,*,*,*,*,*
6/1/2013,VA,Virginia,Virginia Beach City,51810,58818,51590,7228,51331,301,51030,7487,289,7198,53638,46416,7222,27439,21064,6375,5869,1120,340,20110
6/1/2013,VA,Virginia,Warren,51187,6359,5773,586,5365,25,5340,994,23,971,5815,5229,586,3545,3027,518,822,202,69,2452
6/1/2013,VA,Virginia,Washington,51191,13864,10008,3856,10675,43,10632,3189,15,3174,13023,9169,3854,9797,6165,3632,2451,474,191,6681
6/1/2013,VA,Virginia,Waynesboro City,51820,4533,4038,495,3688,21,3667,845,24,821,4250,3755,495,3203,2787,416,831,103,46,2223
6/1/2013,VA,Virginia,Westmoreland,51193,4395,4021,374,3841,27,3814,554,14,540,4046,3672,374,2386,2058,328,745,120,34,1487
6/1/2013,VA,Virginia,Williamsburg City,51830,2265,2002,263,2071,*,*,194,*,*,2030,1767,263,1276,1047,229,195,*,*,1039
6/1/2013,VA,Virginia,Winchester City,51840,4707,4261,446,3976,13,3963,731,20,711,4320,3874,446,2884,2480,404,792,118,46,1928
6/1/2013,VA,Virginia,Wise,51195,10125,7231,2894,6399,15,6384,3726,17,3709,9525,6632,2893,6901,4251,2650,2429,459,176,3837
6/1/2013,VA,Virginia,Wythe,51197,7118,5836,1282,5403,18,5385,1715,24,1691,6735,5453,1282,5048,3909,1139,1533,256,94,3165
6/1/2013,VA,Virginia,York,51199,9895,8884,1011,9034,33,9001,861,27,834,9014,8005,1009,3940,3008,932,584,137,43,3176
3/1/2013,VA,Virginia,Accomack,51001,7969,7046,923,6737,46,6691,1232,45,1187,7418,6496,922,5096,4290,806,1519,317,87,3173
3/1/2013,VA,Virginia,Albemarle,51003,16347,15005,1342,14878,50,14828,1469,53,1416,14722,13380,1342,10097,8895,1202,1444,244,89,8320
3/1/2013,VA,Virginia,Alexandria City,51510,14673,13381,1292,13319,83,13236,1354,88,1266,11885,10595,1290,6090,4878,1212,1808,331,65,3886
3/1/2013,VA,Virginia,Alleghany,51005,4314,3838,476,3443,22,3421,871,11,860,4082,3606,476,3125,2805,320,798,108,42,2177
3/1/2013,VA,Virginia,Amelia,51007,2606,2110,496,2151,*,*,455,*,*,2395,1899,496,1768,1307,461,442,79,27,1220
3/1/2013,VA,Virginia,Amherst,51009,6980,5998,982,5675,52,5623,1305,35,1270,6519,5537,982,5000,4092,908,1143,200,86,3571
3/1/2013,VA,Virginia,Appomattox,51011,3460,2977,483,2788,27,2761,672,14,658,3265,2782,483,2517,2068,449,659,98,54,1706
3/1/2013,VA,Virginia,Arlington,51013,20559,18711,1848,18939,58,18881,1620,80,1540,16475,14628,1847,8553,6821,1732,2660,334,114,5445
3/1/2013,VA,Virginia,Augusta,51015,15719,13632,2087,13321,60,13261,2398,46,2352,14745,12658,2087,10523,8857,1666,1797,358,134,8234
3/1/2013,VA,Virginia,Bath,51017,1229,1143,86,1069,*,*,160,*,*,1156,1070,86,884,818,66,200,40,25,619
3/1/2013,VA,Virginia,Bedford,51019,16656,14094,2562,13995,67,13928,2661,50,2611,15491,12932,2559,11297,9175,2122,1867,419,169,8842
3/1/2013,VA,Virginia,Bland,51021,1649,1371,278,1241,*,*,408,*,*,1566,1288,278,1122,890,232,234,60,23,805
3/1/2013,VA,Virginia,Botetourt,51023,7348,5844,1504,6247,29,6218,1101,13,1088,6805,5301,1504,4942,3569,1373,811,164,70,3897
3/1/2013,VA,Virginia,Bristol City,51520,4407,2805,1602,3361,11,3350,1046,11,1035,4130,2528,1602,3317,1759,1558,1029,146,59,2083
3/1/2013,VA,Virginia,Brunswick,51025,3659,3139,520,2929,28,2901,730,36,694,3441,2921,520,2626,2158,468,1032,111,43,1440
3/1/2013,VA,Virginia,Buchanan,51027,7416,5377,2039,4297,16,4281,3119,17,3102,7058,5019,2039,5461,3741,1720,1563,452,126,3320
3/1/2013,VA,Virginia,Buckingham,51029,3071,2698,373,2443,13,2430,628,14,614,2824,2451,373,2086,1774,312,689,137,52,1208
3/1/2013,VA,Virginia,Buena Vista City,51530,1362,1124,238,1085,*,*,277,*,*,1285,1047,238,980,775,205,311,59,19,591
3/1/2013,VA,Virginia,Campbell,51031,11506,9939,1567,9375,67,9308,2131,60,2071,10775,9208,1567,8238,6813,1425,1947,357,183,5751
3/1/2013,VA,Virginia,Caroline,51033,4887,4231,656,4034,30,4004,853,32,821,4454,3798,656,2899,2284,615,750,214,66,1869
3/1/2013,VA,Virginia,Carroll,51035,7424,6470,954,5845,21,5824,1579,15,1564,7062,6108,954,5364,4637,727,1705,273,133,3253
3/1/2013,VA,Virginia,Charles City,51036,1573,1214,359,1314,11,1303,259,17,242,1448,1089,359,1042,736,306,234,76,23,709
3/1/2013,VA,Virginia,Charlotte,51037,3178,2739,439,2568,22,2546,610,14,596,3008,2569,439,2286,1891,395,782,138,44,1322
3/1/2013,VA,Virginia,Charlottesville City,51540,5550,5150,400,4403,25,4378,1147,46,1101,4987,4588,399,3779,3401,378,1187,144,59,2389
3/1/2013,VA,Virginia,Chesapeake City,51550,30754,26096,4658,26098,210,25888,4656,228,4428,27706,23049,4657,15358,11251,4107,3485,763,243,10867
3/1/2013,VA,Virginia,Chesterfield,51041,46396,37516,8880,39638,187,39451,6758,213,6545,41635,32755,8880,28950,20658,8292,4392,872,291,23395
3/1/2013,VA,Virginia,Clarke,51043,2639,2358,281,2409,*,*,230,*,*,2381,2100,281,1467,1222,245,257,77,32,1101
3/1/2013,VA,Virginia,Colonial Heights City,51570,3963,3561,402,3449,*,*,514,18,496,3629,3227,402,2063,1686,377,401,87,17,1558
3/1/2013,VA,Virginia,Covington City,51580,1671,1510,161,1275,11,1264,396,*,*,1549,1388,161,1172,1035,137,348,48,25,751
3/1/2013,VA,Virginia,Craig,51045,1190,977,213,899,*,*,291,*,*,1081,868,213,803,596,207,196,40,14,553
3/1/2013,VA,Virginia,Culpeper,51047,7648,6749,899,6513,50,6463,1135,37,1098,6993,6094,899,4396,3622,774,1046,229,79,3042
3/1/2013,VA,Virginia,Cumberland,51049,2040,1699,341,1668,*,*,372,*,*,1895,1555,340,1399,1082,317,417,72,30,880
3/1/2013,VA,Virginia,Danville City,51590,10873,9145,1728,8473,78,8395,2400,113,2287,10307,8579,1728,8252,7041,1211,3045,430,167,4610
3/1/2013,VA,Virginia,Dickenson,51051,4633,3353,1280,2709,*,*,1924,*,*,4384,3104,1280,3071,1928,1143,1061,223,108,1679
3/1/2013,VA,Virginia,Dinwiddie,51053,5075,4266,809,4006,29,3977,1069,25,1044,4651,3842,809,3248,2471,777,853,157,52,2186
3/1/2013,VA,Virginia,Emporia City,51595,1190,944,246,900,13,887,290,12,278,1116,870,246,914,720,194,455,53,16,390
3/1/2013,VA,Virginia,Essex,51057,2569,2235,334,2171,15,2156,398,13,385,2386,2052,334,1685,1396,289,402,92,23,1168
3/1/2013,VA,Virginia,Fairfax,51059,122665,109336,13329,114707,450,114257,7958,428,7530,99480,86173,13307,47974,35625,12349,12039,2150,469,33316
3/1/2013,VA,Virginia,Fairfax City,51600,3180,2795,385,2948,15,2933,232,12,220,2686,2301,385,1295,937,358,299,53,11,932
3/1/2013,VA,Virginia,Falls Church City,51610,1582,1420,162,1486,*,*,96,*,*,1274,1114,160,644,495,149,134,*,*,487
3/1/2013,VA,Virginia,Fauquier,51061,10121,9160,961,9118,46,9072,1003,32,971,8940,7980,960,4888,4107,781,808,165,57,3858
3/1/2013,VA,Virginia,Floyd,51063,3495,2902,593,2956,12,2944,539,*,*,3269,2676,593,2437,1889,548,506,90,46,1795
3/1/2013,VA,Virginia,Fluvanna,51065,4895,4391,504,4354,22,4332,541,19,522,4513,4009,504,2957,2517,440,446,109,20,2382
3/1/2013,VA,Virginia,Franklin,51067,12876,9897,2979,10465,46,10419,2411,22,2389,12057,9078,2979,9153,6441,2712,1925,406,159,6663
3/1/2013,VA,Virginia,Franklin City,51620,1812,1639,173,1407,13,1394,405,21,384,1694,1521,173,1307,1154,153,488,79,20,720
3/1/2013,VA,Virginia,Frederick,51069,13048,11628,1420,11463,45,11418,1585,39,1546,11923,10504,1419,7460,6204,1256,1308,325,141,5686
3/1/2013,VA,Virginia,Fredericksburg City,51630,3450,3188,262,2808,22,2786,642,27,615,3115,2853,262,1978,1739,239,685,81,47,1165
3/1/2013,VA,Virginia,Galax City,51640,1948,1828,120,1486,*,*,462,*,*,1857,1737,120,1431,1347,84,671,78,34,648
3/1/2013,VA,Virginia,Giles,51071,4318,3424,894,3342,20,3322,976,18,958,4062,3169,893,2885,2038,847,752,127,31,1975
3/1/2013,VA,Virginia,Gloucester,51073,7090,6097,993,6048,33,6015,1042,22,1020,6491,5498,993,3637,2770,867,823,169,63,2582
3/1/2013,VA,Virginia,Goochland,51075,4475,3696,779,4010,22,3988,465,15,450,4001,3222,779,2982,2261,721,405,104,42,2431
3/1/2013,VA,Virginia,Grayson,51077,4378,3916,462,3517,12,3505,861,*,*,4216,3754,462,3036,2640,396,1026,168,84,1758
3/1/2013,VA,Virginia,Greene,51079,3113,2794,319,2684,16,2668,429,12,417,2866,2547,319,1925,1636,289,430,73,36,1386
3/1/2013,VA,Virginia,Greensville,51081,2256,1698,558,1794,21,1773,462,22,440,2094,1536,558,1698,1217,481,517,123,33,1025
3/1/2013,VA,Virginia,Halifax,51083,9055,7899,1156,7180,63,7117,1875,56,1819,8556,7401,1155,6753,5681,1072,2230,413,146,3964
3/1/2013,VA,Virginia,Hampton City,51650,22098,18350,3748,17945,188,17757,4153,203,3950,20230,16482,3748,10485,7086,3399,3202,734,200,6349
3/1/2013,VA,Virginia,Hanover,51085,16829,13673,3156,15048,75,14973,1781,50,1731,15376,12220,3156,11060,8235,2825,1263,334,111,9352
3/1/2013,VA,Virginia,Harrisonburg City,51660,4676,4164,512,3920,20,3900,756,21,735,4279,3767,512,3171,2883,288,835,114,44,2178
3/1/2013,VA,Virginia,Henrico,51087,47091,37697,9394,40467,291,40176,6624,314,6310,42686,33295,9391,31018,22298,8720,5411,1163,372,24072
3/1/2013,VA,Virginia,Henry,51089,14532,10385,4147,11296,58,11238,3236,67,3169,13882,9735,4147,11500,8309,3191,3018,650,242,7590
3/1/2013,VA,Virginia,Highland,51091,684,620,64,619,*,*,65,0,65,646,582,64,453,394,59,75,*,*,350
3/1/2013,VA,Virginia,Hopewell City,51670,4194,3707,487,3267,25,3242,927,36,891,3903,3416,487,2499,2027,472,854,133,41,1471
3/1/2013,VA,Virginia,Isle of Wight,51093,6787,5497,1290,5809,37,5772,978,33,945,6293,5003,1290,3954,2743,1211,900,172,75,2807
3/1/2013,VA,Virginia,James City,51095,16510,14875,1635,15437,45,15392,1073,40,1033,15246,13614,1632,8139,6708,1431,774,187,49,7129
3/1/2013,VA,Virginia,King and Queen,51097,1504,1316,188,1249,*,*,255,*,*,1408,1220,188,1032,853,179,252,82,11,687
3/1/2013,VA,Virginia,King George,51099,3044,2836,208,2613,22,2591,431,24,407,2663,2455,208,1267,1077,190,388,78,24,777
3/1/2013,VA,Virginia,King William,51101,2749,2380,369,2336,18,2318,413,18,395,2525,2156,369,1892,1554,338,363,79,23,1427
3/1/2013,VA,Virginia,Lancaster,51103,3990,3585,405,3669,14,3655,321,12,309,3799,3394,405,2442,2140,302,462,92,31,1857
3/1/2013,VA,Virginia,Lee,51105,6134,4353,1781,3986,12,3974,2148,18,2130,5788,4010,1778,4513,2862,1651,1853,263,81,2316
3/1/2013,VA,Virginia,Lexington City,51678,1552,1414,138,1415,*,*,137,*,*,1451,1313,138,1058,949,109,190,*,*,824
3/1/2013,VA,Virginia,Loudoun,51107,26124,22649,3475,24154,86,24068,1970,88,1882,21701,18230,3471,12233,9043,3190,2222,479,124,9408
3/1/2013,VA,Virginia,Louisa,51109,6414,5530,884,5294,33,5261,1120,29,1091,5858,4974,884,3977,3147,830,999,237,75,2666
3/1/2013,VA,Virginia,Lunenburg,51111,2753,2473,280,2213,13,2200,540,26,514,2561,2281,280,1852,1592,260,661,105,39,1047
3/1/2013,VA,Virginia,Lynchburg City,51680,13849,12253,1596,10854,86,10768,2995,100,2895,12904,11308,1596,9990,8548,1442,3187,425,158,6220
3/1/2013,VA,Virginia,Madison,51113,2621,2341,280,2296,12,2284,325,*,*,2463,2183,280,1669,1411,258,396,80,25,1168
3/1/2013,VA,Virginia,Manassas City,51683,3595,3158,437,3108,21,3087,487,28,459,3092,2655,437,1910,1536,374,508,104,24,1274
3/1/2013,VA,Virginia,Manassas Park City,51685,990,831,159,848,11,837,142,*,*,843,684,159,544,401,143,131,*,*,364
3/1/2013,VA,Virginia,Martinsville City,51690,3860,3014,846,2863,20,2843,997,31,966,3685,2839,846,3120,2474,646,1268,152,55,1645
3/1/2013,VA,Virginia,Mathews,51115,2559,2241,318,2320,*,*,239,*,*,2420,2102,318,1411,1121,290,250,43,20,1098
3/1/2013,VA,Virginia,Mecklenburg,51117,8555,7147,1408,6913,55,6858,1642,42,1600,8051,6645,1406,6097,4950,1147,1847,376,116,3758
3/1/2013,VA,Virginia,Middlesex,51119,3248,2839,409,2883,16,2867,365,11,354,3063,2654,409,2110,1785,325,408,88,22,1592
3/1/2013,VA,Virginia,Montgomery,51121,12096,10411,1685,9848,31,9817,2248,30,2218,11023,9338,1685,8452,6857,1595,1755,274,112,6311
3/1/2013,VA,Virginia,Nelson,51125,3876,3501,375,3340,*,*,536,16,520,3576,3201,375,2434,2099,335,601,107,39,1687
3/1/2013,VA,Virginia,New Kent,51127,3298,2783,515,2867,19,2848,431,11,420,2995,2480,515,1925,1489,436,269,73,23,1560
3/1/2013,VA,Virginia,Newport News City,51700,24665,20089,4576,20151,177,19974,4514,222,4292,22605,18030,4575,12805,8549,4256,4113,748,230,7714
3/1/2013,VA,Virginia,Norfolk City,51710,29209,24255,4954,23042,230,22812,6167,328,5839,26389,21435,4954,16158,11776,4382,6519,1109,317,8213
3/1/2013,VA,Virginia,Northampton,51131,3239,2894,345,2727,24,2703,512,32,480,3053,2708,345,2347,2038,309,899,97,38,1313
3/1/2013,VA,Virginia,Northumberland,51133,4350,3980,370,4001,12,3989,349,*,*,4087,3717,370,2418,2143,275,420,92,29,1877
3/1/2013,VA,Virginia,Norton City,51720,1142,902,240,713,*,*,429,*,*,1048,808,240,807,584,223,352,52,21,382
3/1/2013,VA,Virginia,Nottoway,51135,3460,3022,438,2816,22,2794,644,14,630,3205,2767,438,2405,2121,284,879,119,42,1365
3/1/2013,VA,Virginia,Orange,51137,7740,7046,694,6761,39,6722,979,29,950,7138,6445,693,4156,3584,572,910,234,68,2944
3/1/2013,VA,Virginia,Page,51139,5554,4920,634,4516,17,4499,1038,15,1023,5181,4547,634,3536,2963,573,1064,208,92,2172
3/1/2013,VA,Virginia,Patrick,51141,4868,3828,1040,3936,15,3921,932,11,921,4653,3614,1039,3615,2748,867,992,198,77,2348
3/1/2013,VA,Virginia,Petersburg City,51730,6903,5997,906,5001,72,4929,1902,76,1826,6311,5405,906,4395,3578,817,2059,311,78,1947
3/1/2013,VA,Virginia,Pittsylvania,51143,14619,11505,3114,11698,85,11613,2921,81,2840,13880,10766,3114,11024,8805,2219,2963,546,246,7269
3/1/2013,VA,Virginia,Poquoson City,51735,2284,2075,209,2112,*,*,172,*,*,2084,1875,209,825,634,191,107,*,*,686
3/1/2013,VA,Virginia,Portsmouth City,51740,16593,13608,2985,12809,171,12638,3784,199,3585,14848,11863,2985,8883,6202,2681,3514,698,155,4516
3/1/2013,VA,Virginia,Powhatan,51145,4714,3865,849,4127,20,4107,587,20,567,4287,3438,849,3093,2323,770,364,84,35,2610
3/1/2013,VA,Virginia,Prince Edward,51147,4215,3650,565,3289,18,3271,926,33,893,3920,3355,565,2923,2473,450,994,182,51,1696
3/1/2013,VA,Virginia,Prince George,51149,4872,4352,520,4045,27,4018,827,24,803,4496,3977,519,2527,2039,488,508,110,23,1886
3/1/2013,VA,Virginia,Prince William,51153,36214,31555,4659,31821,187,31634,4393,264,4129,30871,26215,4656,15740,11550,4190,4010,791,182,10757
3/1/2013,VA,Virginia,Pulaski,51155,8367,7110,1257,6450,32,6418,1917,24,1893,7843,6586,1257,5800,4605,1195,1625,314,133,3728
3/1/2013,VA,Virginia,Radford City,51750,1960,1669,291,1563,*,*,397,11,386,1814,1523,291,1451,1168,283,320,47,33,1051
3/1/2013,VA,Virginia,Rappahannock,51157,1757,1646,111,1574,*,*,183,*,*,1609,1498,111,948,857,91,171,*,*,736
3/1/2013,VA,Virginia,Richmond,51159,1752,1490,262,1510,13,1497,242,*,*,1659,1397,262,1145,920,225,270,78,26,771
3/1/2013,VA,Virginia,Richmond City,51760,29970,23165,6805,22954,272,22682,7016,338,6678,27087,20284,6803,21230,14707,6523,7870,1279,326,11755
3/1/2013,VA,Virginia,Roanoke,51161,20502,16999,3503,17937,73,17864,2565,42,2523,18979,15476,3503,13431,10091,3340,1825,361,131,11114
3/1/2013,VA,Virginia,Roanoke City,51770,18791,15128,3663,13748,120,13628,5043,125,4918,17193,13531,3662,13097,9587,3510,4437,744,238,7678
3/1/2013,VA,Virginia,Rockbridge,51163,5334,4409,925,4421,23,4398,913,13,900,4991,4066,925,3580,2855,725,793,157,71,2559
3/1/2013,VA,Virginia,Rockingham,51165,14850,12460,2390,12906,65,12841,1944,41,1903,13794,11405,2389,9873,8796,1077,1665,421,158,7629
3/1/2013,VA,Virginia,Russell,51167,7511,5718,1793,4784,14,4770,2727,12,2715,7162,5369,1793,5367,3730,1637,1690,281,122,3274
3/1/2013,VA,Virginia,Salem City,51775,5592,4741,851,4687,27,4660,905,16,889,5124,4273,851,3752,2939,813,807,123,53,2769
3/1/2013,VA,Virginia,Scott,51169,6339,3439,2900,4626,14,4612,1713,*,*,6066,3166,2900,5072,2230,2842,1500,242,111,3219
3/1/2013,VA,Virginia,Shenandoah,51171,9303,8333,970,8128,19,8109,1175,26,1149,8705,7735,970,5575,4732,843,1192,210,103,4070
3/1/2013,VA,Virginia,Smyth,51173,8395,6906,1489,6051,23,6028,2344,22,2322,7924,6435,1489,6110,4744,1366,2099,367,161,3483
3/1/2013,VA,Virginia,Southampton,51175,3624,3219,405,3014,28,2986,610,23,587,3381,2976,405,2541,2188,353,682,131,42,1686
3/1/2013,VA,Virginia,Spotsylvania,51177,16098,14513,1585,13771,92,13679,2327,88,2239,14286,12701,1585,7899,6516,1383,1557,478,127,5737
3/1/2013,VA,Virginia,Stafford,51179,12821,11897,924,11177,67,11110,1644,90,1554,11240,10317,923,5189,4409,780,1069,292,89,3739
3/1/2013,VA,Virginia,Staunton City,51790,5600,5018,582,4531,30,4501,1069,21,1048,5244,4663,581,3898,3416,482,986,152,59,2701
3/1/2013,VA,Virginia,Suffolk City,51800,13218,11051,2167,10615,72,10543,2603,77,2526,12060,9894,2166,7728,5884,1844,2483,383,117,4745
3/1/2013,VA,Virginia,Surry,51181,1366,1069,297,1126,*,*,240,12,228,1256,959,297,871,594,277,206,70,13,582
3/1/2013,VA,Virginia,Sussex,51183,2248,1893,355,1787,31,1756,461,*,*,2079,1724,355,1512,1177,335,497,139,30,846
3/1/2013,VA,Virginia,Tazewell,51185,11312,9137,2175,7973,41,7932,3339,36,3303,10723,8548,2175,7853,6142,1711,2156,429,173,5095
3/1/2013,VA,Virginia,Unknown,51999,*,*,*,*,*,*,*,*,*,*,*,*,*,*,*,*,*,*,*
3/1/2013,VA,Virginia,Virginia Beach City,51810,58364,51167,7197,51010,310,50700,7354,284,7070,53315,46124,7191,27176,20835,6341,5773,1151,356,19896
3/1/2013,VA,Virginia,Warren,51187,6308,5721,587,5343,28,5315,965,23,942,5764,5177,587,3515,2998,517,800,206,66,2443
3/1/2013,VA,Virginia,Washington,51191,13811,9965,3846,10657,46,10611,3154,15,3139,12962,9118,3844,9771,6153,3618,2451,479,195,6646
3/1/2013,VA,Virginia,Waynesboro City,51820,4510,3992,518,3677,21,3656,833,23,810,4222,3704,518,3171,2732,439,820,102,51,2198
3/1/2013,VA,Virginia,Westmoreland,51193,4376,3991,385,3829,28,3801,547,13,534,4023,3638,385,2366,2031,335,732,119,39,1476
3/1/2013,VA,Virginia,Williamsburg City,51830,2247,1982,265,2057,*,*,190,*,*,2016,1751,265,1265,1034,231,197,*,*,1025
3/1/2013,VA,Virginia,Winchester City,51840,4702,4256,446,3982,14,3968,720,19,701,4319,3873,446,2891,2486,405,790,122,48,1931
3/1/2013,VA,Virginia,Wise,51195,10098,7216,2882,6420,19,6401,3678,18,3660,9498,6617,2881,6883,4249,2634,2403,474,187,3819
3/1/2013,VA,Virginia,Wythe,51197,7089,5815,1274,5399,22,5377,1690,24,1666,6723,5449,1274,5030,3902,1128,1526,266,99,3139
3/1/2013,VA,Virginia,York,51199,9826,8828,998,8981,35,8946,845,27,818,8950,7954,996,3899,2981,918,571,136,43,3149
5/1/2013,VA,Virginia,Accomack,51001,7988,7071,917,6741,46,6695,1247,47,1200,7435,6519,916,5107,4304,803,1528,313,87,3179
5/1/2013,VA,Virginia,Albemarle,51003,16421,15079,1342,14929,49,14880,1492,56,1436,14757,13415,1342,10141,8935,1206,1451,243,87,8360
5/1/2013,VA,Virginia,Alexandria City,51510,14754,13461,1293,13382,81,13301,1372,89,1283,11917,10626,1291,6116,4903,1213,1831,326,65,3894
5/1/2013,VA,Virginia,Alleghany,51005,4325,3872,453,3444,22,3422,881,11,870,4096,3643,453,3127,2816,311,806,104,41,2176
5/1/2013,VA,Virginia,Amelia,51007,2625,2124,501,2166,*,*,459,*,*,2412,1911,501,1778,1311,467,446,76,28,1228
5/1/2013,VA,Virginia,Amherst,51009,6994,6016,978,5685,48,5637,1309,35,1274,6523,5545,978,5016,4111,905,1152,198,86,3580
5/1/2013,VA,Virginia,Appomattox,51011,3477,2994,483,2797,26,2771,680,15,665,3277,2794,483,2529,2082,447,673,93,53,1710
5/1/2013,VA,Virginia,Arlington,51013,20717,18852,1865,19082,56,19026,1635,82,1553,16569,14705,1864,8581,6831,1750,2685,321,109,5466
5/1/2013,VA,Virginia,Augusta,51015,15775,13788,1987,13357,56,13301,2418,45,2373,14790,12803,1987,10553,8969,1584,1808,348,128,8269
5/1/2013,VA,Virginia,Bath,51017,1233,1153,80,1071,*,*,162,*,*,1159,1079,80,882,822,60,196,36,22,628
5/1/2013,VA,Virginia,Bedford,51019,16733,14153,2580,14036,61,13975,2697,50,2647,15552,12975,2577,11342,9203,2139,1887,415,161,8879
5/1/2013,VA,Virginia,Bland,51021,1642,1366,276,1233,*,*,409,*,*,1563,1287,276,1108,878,230,229,56,21,802
5/1/2013,VA,Virginia,Botetourt,51023,7386,5878,1508,6274,28,6246,1112,14,1098,6828,5320,1508,4961,3582,1379,817,165,68,3911
5/1/2013,VA,Virginia,Bristol City,51520,4406,2794,1612,3359,*,*,1047,*,*,4129,2517,1612,3322,1755,1567,1035,143,58,2086
5/1/2013,VA,Virginia,Brunswick,51025,3673,3172,501,2936,27,2909,737,36,701,3456,2955,501,2642,2190,452,1040,112,41,1449
5/1/2013,VA,Virginia,Buchanan,51027,7422,5378,2044,4289,16,4273,3133,16,3117,7072,5029,2043,5462,3735,1727,1587,441,121,3313
5/1/2013,VA,Virginia,Buckingham,51029,3096,2725,371,2462,13,2449,634,14,620,2849,2479,370,2102,1791,311,696,133,51,1222
5/1/2013,VA,Virginia,Buena Vista City,51530,1371,1131,240,1091,*,*,280,*,*,1293,1053,240,986,779,207,310,60,19,597
5/1/2013,VA,Virginia,Campbell,51031,11525,9957,1568,9368,65,9303,2157,61,2096,10800,9232,1568,8261,6835,1426,1965,353,176,5767
5/1/2013,VA,Virginia,Caroline,51033,4922,4266,656,4054,29,4025,868,32,836,4477,3821,656,2906,2291,615,753,213,56,1884
5/1/2013,VA,Virginia,Carroll,51035,7449,6516,933,5858,22,5836,1591,15,1576,7082,6149,933,5389,4681,708,1704,269,132,3284
5/1/2013,VA,Virginia,Charles City,51036,1583,1221,362,1322,11,1311,261,17,244,1459,1097,362,1055,746,309,238,75,22,720
5/1/2013,VA,Virginia,Charlotte,51037,3174,2735,439,2562,22,2540,612,14,598,3002,2563,439,2277,1881,396,783,138,44,1312
5/1/2013,VA,Virginia,Charlottesville City,51540,5596,5194,402,4439,23,4416,1157,48,1109,5019,4618,401,3801,3420,381,1200,142,55,2404
5/1/2013,VA,Virginia,Chesapeake City,51550,30900,26232,4668,26186,203,25983,4714,231,4483,27784,23117,4667,15449,11337,4112,3523,742,236,10948
5/1/2013,VA,Virginia,Chesterfield,51041,46707,37789,8918,39877,180,39697,6830,207,6623,41851,32933,8918,29191,20856,8335,4461,856,278,23596
5/1/2013,VA,Virginia,Clarke,51043,2660,2377,283,2423,*,*,237,*,*,2396,2113,283,1477,1229,248,262,74,29,1112
5/1/2013,VA,Virginia,Colonial Heights City,51570,3969,3573,396,3448,*,*,521,18,503,3625,3229,396,2068,1697,371,401,85,16,1566
5/1/2013,VA,Virginia,Covington City,51580,1674,1525,149,1277,*,*,397,*,*,1550,1401,149,1173,1039,134,346,48,24,755
5/1/2013,VA,Virginia,Craig,51045,1196,980,216,902,*,*,294,*,*,1087,871,216,811,601,210,195,41,14,561
5/1/2013,VA,Virginia,Culpeper,51047,7684,6789,895,6525,49,6476,1159,38,1121,7012,6117,895,4403,3634,769,1053,226,70,3054
5/1/2013,VA,Virginia,Cumberland,51049,2050,1711,339,1676,*,*,374,*,*,1905,1567,338,1409,1092,317,417,70,29,893
5/1/2013,VA,Virginia,Danville City,51590,10861,9198,1663,8456,75,8381,2405,110,2295,10288,8625,1663,8255,7107,1148,3066,423,162,4604
5/1/2013,VA,Virginia,Dickenson,51051,4655,3376,1279,2711,*,*,1944,*,*,4410,3131,1279,3081,1935,1146,1075,221,99,1686
5/1/2013,VA,Virginia,Dinwiddie,51053,5095,4284,811,4015,29,3986,1080,26,1054,4659,3848,811,3268,2490,778,863,159,49,2197
5/1/2013,VA,Virginia,Emporia City,51595,1180,952,228,891,12,879,289,12,277,1110,882,228,905,733,172,451,55,16,383
5/1/2013,VA,Virginia,Essex,51057,2566,2236,330,2167,14,2153,399,13,386,2381,2051,330,1682,1397,285,414,88,19,1161
5/1/2013,VA,Virginia,Fairfax,51059,123678,110265,13413,115608,441,115167,8070,440,7630,100077,86686,13391,48266,35846,12420,12188,2106,441,33531
5/1/2013,VA,Virginia,Fairfax City,51600,3198,2813,385,2967,14,2953,231,12,219,2699,2314,385,1295,936,359,301,*,*,935
5/1/2013,VA,Virginia,Falls Church City,51610,1594,1426,168,1496,*,*,98,*,*,1276,1110,166,651,498,153,135,*,*,492
5/1/2013,VA,Virginia,Fauquier,51061,10202,9253,949,9182,46,9136,1020,33,987,8997,8049,948,4909,4137,772,811,164,53,3881
5/1/2013,VA,Virginia,Floyd,51063,3529,2934,595,2982,12,2970,547,*,*,3287,2692,595,2448,1898,550,512,89,46,1801
5/1/2013,VA,Virginia,Fluvanna,51065,4922,4413,509,4376,22,4354,546,19,527,4537,4028,509,2975,2531,444,446,106,20,2403
5/1/2013,VA,Virginia,Franklin,51067,12946,9952,2994,10509,46,10463,2437,22,2415,12122,9128,2994,9201,6472,2729,1954,404,150,6693
5/1/2013,VA,Virginia,Franklin City,51620,1812,1642,170,1400,12,1388,412,21,391,1693,1523,170,1306,1154,152,492,77,17,720
5/1/2013,VA,Virginia,Frederick,51069,13134,11713,1421,11527,45,11482,1607,39,1568,12008,10588,1420,7497,6241,1256,1330,315,138,5714
5/1/2013,VA,Virginia,Fredericksburg City,51630,3458,3197,261,2811,20,2791,647,27,620,3115,2854,261,1981,1742,239,700,79,43,1159
5/1/2013,VA,Virginia,Galax City,51640,1938,1821,117,1476,*,*,462,11,451,1851,1734,117,1426,1347,79,672,76,34,644
5/1/2013,VA,Virginia,Giles,51071,4321,3429,892,3337,16,3321,984,18,966,4062,3171,891,2890,2045,845,756,124,31,1979
5/1/2013,VA,Virginia,Gloucester,51073,7118,6120,998,6066,32,6034,1052,21,1031,6521,5523,998,3658,2788,870,833,163,58,2604
5/1/2013,VA,Virginia,Goochland,51075,4506,3724,782,4032,22,4010,474,15,459,4027,3245,782,3006,2282,724,411,95,40,2460
5/1/2013,VA,Virginia,Grayson,51077,4390,3928,462,3524,12,3512,866,*,*,4226,3764,462,3039,2643,396,1026,164,80,1769
5/1/2013,VA,Virginia,Greene,51079,3133,2815,318,2696,16,2680,437,12,425,2879,2561,318,1931,1643,288,438,71,30,1392
5/1/2013,VA,Virginia,Greensville,51081,2266,1720,546,1796,19,1777,470,23,447,2106,1560,546,1711,1242,469,531,123,32,1025
5/1/2013,VA,Virginia,Halifax,51083,9053,7901,1152,7165,60,7105,1888,56,1832,8553,7402,1151,6746,5678,1068,2245,402,132,3967
5/1/2013,VA,Virginia,Hampton City,51650,22181,18434,3747,17976,183,17793,4205,207,3998,20279,16532,3747,10544,7142,3402,3258,733,187,6366
5/1/2013,VA,Virginia,Hanover,51085,16880,13712,3168,15091,74,15017,1789,48,1741,15395,12227,3168,11110,8271,2839,1272,331,105,9402
5/1/2013,VA,Virginia,Harrisonburg City,51660,4683,4182,501,3929,20,3909,754,21,733,4268,3767,501,3155,2884,271,833,114,44,2164
5/1/2013,VA,Virginia,Henrico,51087,47321,37937,9384,40641,280,40361,6680,319,6361,42848,33467,9381,31180,22462,8718,5488,1146,368,24178
5/1/2013,VA,Virginia,Henry,51089,14567,10524,4043,11308,57,11251,3259,67,3192,13922,9879,4043,11533,8453,3080,3061,639,231,7602
5/1/2013,VA,Virginia,Highland,51091,684,627,57,619,*,*,65,0,65,646,589,57,452,400,52,73,*,*,351
5/1/2013,VA,Virginia,Hopewell City,51670,4207,3721,486,3267,24,3243,940,35,905,3912,3426,486,2500,2029,471,859,130,40,1471
5/1/2013,VA,Virginia,Isle of Wight,51093,6827,5524,1303,5837,37,5800,990,32,958,6309,5006,1303,3972,2748,1224,903,169,75,2825
5/1/2013,VA,Virginia,James City,51095,16601,14971,1630,15511,41,15470,1090,41,1049,15302,13675,1627,8192,6765,1427,781,179,49,7183
5/1/2013,VA,Virginia,King and Queen,51097,1515,1330,185,1256,*,*,259,*,*,1420,1235,185,1034,858,176,257,*,*,689
5/1/2013,VA,Virginia,King George,51099,3064,2860,204,2627,19,2608,437,23,414,2677,2473,204,1268,1081,187,392,77,24,775
5/1/2013,VA,Virginia,King William,51101,2759,2389,370,2343,18,2325,416,17,399,2531,2161,370,1891,1552,339,366,73,20,1432
5/1/2013,VA,Virginia,Lancaster,51103,4000,3597,403,3676,13,3663,324,13,311,3800,3397,403,2444,2144,300,466,88,33,1857
5/1/2013,VA,Virginia,Lee,51105,6144,4353,1791,3980,12,3968,2164,18,2146,5796,4008,1788,4518,2853,1665,1871,254,79,2314
5/1/2013,VA,Virginia,Lexington City,51678,1550,1414,136,1411,*,*,139,*,*,1447,1311,136,1057,949,108,191,*,*,822
5/1/2013,VA,Virginia,Loudoun,51107,26338,22844,3494,24350,85,24265,1988,88,1900,21832,18343,3489,12306,9094,3212,2240,465,112,9489
5/1/2013,VA,Virginia,Louisa,51109,6466,5579,887,5332,31,5301,1134,29,1105,5903,5016,887,4013,3182,831,1017,228,73,2695
5/1/2013,VA,Virginia,Lunenburg,51111,2764,2479,285,2220,11,2209,544,25,519,2568,2283,285,1855,1590,265,667,101,40,1047
5/1/2013,VA,Virginia,Lynchburg City,51680,13878,12275,1603,10860,83,10777,3018,102,2916,12943,11340,1603,10012,8563,1449,3209,420,151,6232
5/1/2013,VA,Virginia,Madison,51113,2634,2356,278,2305,11,2294,329,*,*,2473,2195,278,1669,1413,256,397,77,25,1170
5/1/2013,VA,Virginia,Manassas City,51683,3622,3181,441,3126,20,3106,496,29,467,3107,2666,441,1912,1532,380,507,96,21,1288
5/1/2013,VA,Virginia,Manassas Park City,51685,999,840,159,855,11,844,144,*,*,848,689,159,552,409,143,139,*,*,369
5/1/2013,VA,Virginia,Martinsville City,51690,3858,3037,821,2851,19,2832,1007,31,976,3681,2860,821,3127,2498,629,1287,151,52,1637
5/1/2013,VA,Virginia,Mathews,51115,2569,2249,320,2328,*,*,241,*,*,2429,2109,320,1428,1134,294,256,41,20,1111
5/1/2013,VA,Virginia,Mecklenburg,51117,8571,7226,1345,6920,53,6867,1651,41,1610,8062,6719,1343,6110,5045,1065,1857,367,108,3778
5/1/2013,VA,Virginia,Middlesex,51119,3259,2847,412,2888,16,2872,371,11,360,3073,2661,412,2126,1798,328,417,85,23,1601
5/1/2013,VA,Virginia,Montgomery,51121,12155,10454,1701,9881,30,9851,2274,29,2245,11071,9370,1701,8492,6880,1612,1761,268,105,6358
5/1/2013,VA,Virginia,Nelson,51125,3889,3515,374,3352,*,*,537,16,521,3591,3217,374,2442,2108,334,600,105,39,1698
5/1/2013,VA,Virginia,New Kent,51127,3332,2819,513,2898,18,2880,434,11,423,3024,2511,513,1950,1513,437,275,71,24,1580
5/1/2013,VA,Virginia,Newport News City,51700,24768,20160,4608,20211,170,20041,4557,217,4340,22680,18073,4607,12864,8575,4289,4148,742,219,7755
5/1/2013,VA,Virginia,Norfolk City,51710,29291,24301,4990,23063,221,22842,6228,332,5896,26423,21433,4990,16211,11795,4416,6595,1095,292,8229
5/1/2013,VA,Virginia,Northampton,51131,3240,2896,344,2720,24,2696,520,32,488,3051,2707,344,2357,2048,309,901,96,34,1326
5/1/2013,VA,Virginia,Northumberland,51133,4357,3985,372,4001,12,3989,356,12,344,4088,3716,372,2417,2142,275,428,90,27,1872
5/1/2013,VA,Virginia,Norton City,51720,1152,907,245,715,*,*,437,*,*,1061,816,245,814,586,228,358,52,20,384
5/1/2013,VA,Virginia,Nottoway,51135,3467,3031,436,2816,22,2794,651,14,637,3205,2769,436,2402,2123,279,888,116,44,1354
5/1/2013,VA,Virginia,Orange,51137,7769,7076,693,6781,37,6744,988,30,958,7153,6461,692,4180,3607,573,907,226,67,2980
5/1/2013,VA,Virginia,Page,51139,5560,4926,634,4504,17,4487,1056,15,1041,5187,4553,634,3551,2979,572,1078,201,88,2184
5/1/2013,VA,Virginia,Patrick,51141,4878,3857,1021,3938,15,3923,940,11,929,4661,3641,1020,3616,2779,837,994,193,77,2352
5/1/2013,VA,Virginia,Petersburg City,51730,6923,5994,929,5008,69,4939,1915,79,1836,6319,5390,929,4394,3557,837,2078,306,75,1935
5/1/2013,VA,Virginia,Pittsylvania,51143,14671,11677,2994,11727,84,11643,2944,77,2867,13930,10936,2994,11065,8979,2086,2992,533,241,7299
5/1/2013,VA,Virginia,Poquoson City,51735,2295,2087,208,2119,*,*,176,*,*,2092,1884,208,823,633,190,108,*,*,683
5/1/2013,VA,Virginia,Portsmouth City,51740,16637,13643,2994,12820,166,12654,3817,203,3614,14868,11874,2994,8904,6216,2688,3555,684,142,4523
5/1/2013,VA,Virginia,Powhatan,51145,4767,3914,853,4170,19,4151,597,20,577,4325,3472,853,3128,2354,774,369,84,34,2641
5/1/2013,VA,Virginia,Prince Edward,51147,4220,3660,560,3292,17,3275,928,34,894,3925,3365,560,2931,2485,446,1007,179,48,1697
5/1/2013,VA,Virginia,Prince George,51149,4899,4380,519,4066,24,4042,833,24,809,4523,4005,518,2550,2062,488,514,108,24,1904
5/1/2013,VA,Virginia,Prince William,51153,36560,31886,4674,32107,182,31925,4453,266,4187,31113,26442,4671,15833,11626,4207,4074,778,180,10801
5/1/2013,VA,Virginia,Pulaski,51155,8384,7162,1222,6448,30,6418,1936,26,1910,7865,6643,1222,5811,4643,1168,1633,312,120,3746
5/1/2013,VA,Virginia,Radford City,51750,1960,1669,291,1560,*,*,400,*,*,1815,1524,291,1452,1168,284,321,46,33,1052
5/1/2013,VA,Virginia,Rappahannock,51157,1764,1653,111,1577,*,*,187,*,*,1610,1499,111,951,860,91,172,*,*,736
5/1/2013,VA,Virginia,Richmond,51159,1752,1492,260,1509,13,1496,243,*,*,1655,1395,260,1140,919,221,272,76,25,767
5/1/2013,VA,Virginia,Richmond City,51760,30148,23356,6792,23055,260,22795,7093,344,6749,27188,20398,6790,21352,14843,6509,7990,1262,305,11795
5/1/2013,VA,Virginia,Roanoke,51161,20599,17070,3529,17994,68,17926,2605,43,2562,19054,15525,3529,13528,10160,3368,1838,363,124,11203
5/1/2013,VA,Virginia,Roanoke City,51770,18809,15128,3681,13736,116,13620,5073,126,4947,17210,13530,3680,13109,9583,3526,4475,734,230,7670
5/1/2013,VA,Virginia,Rockbridge,51163,5372,4487,885,4446,22,4424,926,13,913,5024,4139,885,3596,2899,697,809,156,68,2563
5/1/2013,VA,Virginia,Rockingham,51165,14907,12548,2359,12937,58,12879,1970,40,1930,13847,11489,2358,9910,8861,1049,1675,412,153,7670
5/1/2013,VA,Virginia,Russell,51167,7518,5727,1791,4775,13,4762,2743,12,2731,7168,5377,1791,5364,3727,1637,1700,275,118,3271
5/1/2013,VA,Virginia,Salem City,51775,5597,4742,855,4685,27,4658,912,16,896,5123,4268,855,3759,2942,817,794,122,51,2792
5/1/2013,VA,Virginia,Scott,51169,6348,3437,2911,4631,13,4618,1717,*,*,6063,3152,2911,5072,2218,2854,1509,238,108,3217
5/1/2013,VA,Virginia,Shenandoah,51171,9334,8366,968,8145,18,8127,1189,26,1163,8730,7762,968,5582,4740,842,1203,202,100,4077
5/1/2013,VA,Virginia,Smyth,51173,8417,6931,1486,6047,22,6025,2370,23,2347,7944,6458,1486,6121,4759,1362,2108,362,152,3499
5/1/2013,VA,Virginia,Southampton,51175,3629,3225,404,3014,27,2987,615,23,592,3379,2975,404,2546,2195,351,684,124,38,1700
5/1/2013,VA,Virginia,Spotsylvania,51177,16222,14658,1564,13864,91,13773,2358,86,2272,14387,12823,1564,7963,6597,1366,1586,474,120,5783
5/1/2013,VA,Virginia,Stafford,51179,12912,12001,911,11246,64,11182,1666,92,1574,11311,10401,910,5223,4455,768,1087,292,85,3759
5/1/2013,VA,Virginia,Staunton City,51790,5609,5055,554,4532,28,4504,1077,21,1056,5248,4695,553,3906,3446,460,996,147,54,2709
5/1/2013,VA,Virginia,Suffolk City,51800,13259,11077,2182,10637,70,10567,2622,77,2545,12095,9914,2181,7759,5904,1855,2500,375,109,4775
5/1/2013,VA,Virginia,Surry,51181,1378,1077,301,1136,*,*,242,12,230,1263,962,301,872,591,281,208,67,13,584
5/1/2013,VA,Virginia,Sussex,51183,2242,1886,356,1783,31,1752,459,*,*,2079,1723,356,1513,1175,338,497,138,30,848
5/1/2013,VA,Virginia,Tazewell,51185,11326,9146,2180,7966,39,7927,3360,35,3325,10734,8554,2180,7846,6124,1722,2161,431,164,5090
5/1/2013,VA,Virginia,Unknown,51999,*,*,*,*,*,*,*,*,*,*,*,*,*,*,*,*,*,*,*
5/1/2013,VA,Virginia,Virginia Beach City,51810,58691,51466,7225,51245,305,50940,7446,288,7158,53540,46321,7219,27375,21004,6371,5855,1128,338,20054
5/1/2013,VA,Virginia,Warren,51187,6339,5754,585,5351,26,5325,988,23,965,5791,5206,585,3537,3021,516,819,203,68,2447
5/1/2013,VA,Virginia,Washington,51191,13841,9995,3846,10666,45,10621,3175,15,3160,12989,9145,3844,9763,6141,3622,2453,470,188,6652
5/1/2013,VA,Virginia,Waynesboro City,51820,4517,4024,493,3676,21,3655,841,24,817,4237,3744,493,3183,2767,416,824,103,45,2211
5/1/2013,VA,Virginia,Westmoreland,51193,4397,4021,376,3844,28,3816,553,14,539,4051,3675,376,2382,2053,329,746,122,34,1480
5/1/2013,VA,Virginia,Williamsburg City,51830,2269,2005,264,2077,*,*,192,*,*,2034,1770,264,1275,1045,230,197,*,*,1037
5/1/2013,VA,Virginia,Winchester City,51840,4707,4260,447,3981,14,3967,726,19,707,4323,3876,447,2885,2481,404,790,119,48,1928
5/1/2013,VA,Virginia,Wise,51195,10109,7217,2892,6403,18,6385,3706,18,3688,9512,6621,2891,6893,4245,2648,2422,461,176,3834
5/1/2013,VA,Virginia,Wythe,51197,7103,5825,1278,5401,19,5382,1702,24,1678,6726,5448,1278,5027,3892,1135,1527,256,92,3152
5/1/2013,VA,Virginia,York,51199,9873,8868,1005,9018,33,8985,855,27,828,8995,7992,1003,3918,2992,926,580,134,42,3162
11/1/2013,VA,Virginia,Accomack,51001,8097,7151,946,6804,41,6763,1293,43,1250,7560,6615,945,5191,4361,830,1564,334,86,3207
11/1/2013,VA,Virginia,Albemarle,51003,16708,15355,1353,15152,45,15107,1556,60,1496,15039,13686,1353,10492,9268,1224,1495,244,88,8665
11/1/2013,VA,Virginia,Alexandria City,51510,15192,13843,1349,13771,77,13694,1421,92,1329,12231,10885,1346,6307,5040,1267,1868,330,63,4046
11/1/2013,VA,Virginia,Alleghany,51005,4403,3950,453,3483,20,3463,920,11,909,4173,3720,453,3174,2862,312,825,99,41,2209
11/1/2013,VA,Virginia,Amelia,51007,2689,2181,508,2207,*,*,482,11,471,2476,1968,508,1819,1344,475,462,75,29,1253
11/1/2013,VA,Virginia,Amherst,51009,7105,6113,992,5756,44,5712,1349,34,1315,6633,5641,992,5101,4181,920,1167,202,87,3645
11/1/2013,VA,Virginia,Appomattox,51011,3545,3059,486,2835,24,2811,710,14,696,3327,2841,486,2558,2108,450,696,96,52,1714
11/1/2013,VA,Virginia,Arlington,51013,21270,19346,1924,19578,52,19526,1692,84,1608,17000,15077,1923,8887,7083,1804,2790,315,115,5667
11/1/2013,VA,Virginia,Augusta,51015,15999,13992,2007,13502,48,13454,2497,47,2450,15017,13010,2007,10706,9108,1598,1861,330,137,8378
11/1/2013,VA,Virginia,Bath,51017,1237,1158,79,1071,*,*,166,*,*,1168,1089,79,886,828,58,201,32,23,630
11/1/2013,VA,Virginia,Bedford,51019,17086,14487,2599,14285,56,14229,2801,51,2750,15884,13288,2596,11571,9407,2164,1953,424,159,9035
11/1/2013,VA,Virginia,Bland,51021,1655,1381,274,1240,*,*,415,*,*,1570,1296,274,1114,885,229,240,57,20,797
11/1/2013,VA,Virginia,Botetourt,51023,7545,6019,1526,6390,24,6366,1155,12,1143,6968,5442,1526,5052,3650,1402,855,157,66,3974
11/1/2013,VA,Virginia,Bristol City,51520,4429,2801,1628,3367,*,*,1062,*,*,4161,2533,1628,3338,1755,1583,1049,137,58,2094
11/1/2013,VA,Virginia,Brunswick,51025,3702,3200,502,2938,21,2917,764,34,730,3487,2985,502,2666,2220,446,1060,114,39,1453
11/1/2013,VA,Virginia,Buchanan,51027,7459,5397,2062,4299,15,4284,3160,14,3146,7121,5060,2061,5509,3751,1758,1625,436,120,3328
11/1/2013,VA,Virginia,Buckingham,51029,3128,2746,382,2464,*,*,664,13,651,2899,2517,382,2132,1812,320,709,135,49,1239
11/1/2013,VA,Virginia,Buena Vista City,51530,1388,1149,239,1094,*,*,294,*,*,1306,1067,239,999,792,207,321,58,19,601
11/1/2013,VA,Virginia,Campbell,51031,11700,10108,1592,9474,65,9409,2226,60,2166,10964,9372,1592,8403,6947,1456,2029,347,177,5850
11/1/2013,VA,Virginia,Caroline,51033,5023,4364,659,4123,27,4096,900,31,869,4556,3897,659,2949,2330,619,772,211,51,1915
11/1/2013,VA,Virginia,Carroll,51035,7520,6569,951,5875,17,5858,1645,15,1630,7154,6203,951,5428,4709,719,1737,265,125,3301
11/1/2013,VA,Virginia,Charles City,51036,1619,1256,363,1344,11,1333,275,17,258,1507,1144,363,1076,766,310,245,72,22,737
11/1/2013,VA,Virginia,Charlotte,51037,3204,2759,445,2574,20,2554,630,13,617,3030,2585,445,2298,1896,402,782,139,46,1331
11/1/2013,VA,Virginia,Charlottesville City,51540,5713,5308,405,4513,18,4495,1200,50,1150,5127,4723,404,3912,3528,384,1227,140,58,2487
11/1/2013,VA,Virginia,Chesapeake City,51550,31540,26776,4764,26610,182,26428,4930,231,4699,28402,23639,4763,15876,11638,4238,3687,750,236,11203
11/1/2013,VA,Virginia,Chesterfield,51041,47849,38680,9169,40764,166,40598,7085,201,6884,42909,33740,9169,29990,21409,8581,4622,843,279,24246
11/1/2013,VA,Virginia,Clarke,51043,2709,2424,285,2462,*,*,247,*,*,2445,2160,285,1516,1264,252,266,72,28,1150
11/1/2013,VA,Virginia,Colonial Heights City,51570,3995,3594,401,3456,*,*,539,17,522,3661,3260,401,2113,1734,379,423,85,16,1589
11/1/2013,VA,Virginia,Covington City,51580,1673,1522,151,1265,*,*,408,*,*,1557,1406,151,1178,1041,137,351,48,23,756
11/1/2013,VA,Virginia,Craig,51045,1226,1003,223,918,*,*,308,*,*,1117,894,223,837,620,217,203,43,15,576
11/1/2013,VA,Virginia,Culpeper,51047,7851,6945,906,6635,42,6593,1216,39,1177,7157,6251,906,4542,3766,776,1080,218,75,3169
11/1/2013,VA,Virginia,Cumberland,51049,2083,1738,345,1693,*,*,390,*,*,1947,1603,344,1438,1114,324,430,69,27,912
11/1/2013,VA,Virginia,Danville City,51590,10933,9293,1640,8439,69,8370,2494,112,2382,10364,8724,1640,8318,7178,1140,3151,413,168,4586
11/1/2013,VA,Virginia,Dickenson,51051,4675,3391,1284,2705,*,*,1970,*,*,4452,3168,1284,3112,1950,1162,1097,217,101,1697
11/1/2013,VA,Virginia,Dinwiddie,51053,5169,4359,810,4057,29,4028,1112,28,1084,4734,3924,810,3316,2539,777,882,162,49,2223
11/1/2013,VA,Virginia,Emporia City,51595,1185,953,232,887,*,*,298,12,286,1105,873,232,895,723,172,446,56,16,377
11/1/2013,VA,Virginia,Essex,51057,2604,2259,345,2196,12,2184,408,14,394,2431,2086,345,1724,1429,295,426,83,20,1195
11/1/2013,VA,Virginia,Fairfax,51059,127496,113479,14017,119069,402,118667,8427,442,7985,103115,89119,13996,51584,38584,13000,12499,2177,459,36449
11/1/2013,VA,Virginia,Fairfax City,51600,3280,2881,399,3040,11,3029,240,13,227,2766,2367,399,1419,1045,374,316,49,11,1043
11/1/2013,VA,Virginia,Falls Church City,51610,1638,1466,172,1536,*,*,102,*,*,1304,1133,171,691,536,155,142,*,*,528
11/1/2013,VA,Virginia,Fauquier,51061,10481,9527,954,9408,42,9366,1073,34,1039,9236,8283,953,5125,4349,776,845,162,55,4063
11/1/2013,VA,Virginia,Floyd,51063,3568,2955,613,3004,*,*,564,*,*,3317,2704,613,2479,1911,568,519,93,44,1823
11/1/2013,VA,Virginia,Fluvanna,51065,5027,4517,510,4454,19,4435,573,21,552,4641,4131,510,3070,2624,446,468,103,20,2479
11/1/2013,VA,Virginia,Franklin,51067,13116,10097,3019,10608,38,10570,2508,22,2486,12276,9257,3019,9340,6580,2760,1998,397,148,6797
11/1/2013,VA,Virginia,Franklin City,51620,1823,1652,171,1400,*,*,423,19,404,1704,1533,171,1320,1170,150,496,73,19,732
11/1/2013,VA,Virginia,Frederick,51069,13396,11956,1440,11700,41,11659,1696,43,1653,12204,10765,1439,7697,6419,1278,1378,317,134,5868
11/1/2013,VA,Virginia,Fredericksburg City,51630,3516,3256,260,2845,17,2828,671,26,645,3171,2911,260,2024,1783,241,730,76,41,1177
11/1/2013,VA,Virginia,Galax City,51640,1941,1825,116,1476,*,*,465,*,*,1854,1738,116,1432,1353,79,672,72,35,653
11/1/2013,VA,Virginia,Giles,51071,4398,3483,915,3380,15,3365,1018,15,1003,4132,3218,914,2962,2093,869,790,125,34,2013
11/1/2013,VA,Virginia,Gloucester,51073,7274,6258,1016,6182,28,6154,1092,20,1072,6677,5661,1016,3744,2854,890,859,166,63,2656
11/1/2013,VA,Virginia,Goochland,51075,4625,3818,807,4140,20,4120,485,15,470,4156,3349,807,3101,2354,747,415,101,40,2545
11/1/2013,VA,Virginia,Grayson,51077,4405,3949,456,3528,12,3516,877,*,*,4246,3790,456,3031,2641,390,1025,163,78,1765
11/1/2013,VA,Virginia,Greene,51079,3193,2868,325,2744,15,2729,449,11,438,2934,2609,325,1975,1678,297,445,71,26,1433
11/1/2013,VA,Virginia,Greensville,51081,2284,1738,546,1795,18,1777,489,23,466,2129,1583,546,1728,1256,472,547,122,32,1027
11/1/2013,VA,Virginia,Halifax,51083,9125,7973,1152,7189,55,7134,1936,58,1878,8603,7452,1151,6765,5696,1069,2257,405,137,3966
11/1/2013,VA,Virginia,Hampton City,51650,22522,18654,3868,18169,168,18001,4353,206,4147,20615,16747,3868,10742,7209,3533,3381,721,191,6449
11/1/2013,VA,Virginia,Hanover,51085,17168,13934,3234,15308,64,15244,1860,47,1813,15636,12402,3234,11299,8398,2901,1310,316,106,9567
11/1/2013,VA,Virginia,Harrisonburg City,51660,4779,4277,502,3991,16,3975,788,20,768,4364,3862,502,3239,2969,270,875,115,43,2206
11/1/2013,VA,Virginia,Henrico,51087,48090,38496,9594,41202,253,40949,6888,310,6578,43526,33934,9592,31776,22849,8927,5631,1152,378,24615
11/1/2013,VA,Virginia,Henry,51089,14663,10630,4033,11304,52,11252,3359,66,3293,14007,9974,4033,11564,8498,3066,3172,626,227,7539
11/1/2013,VA,Virginia,Highland,51091,694,636,58,625,*,*,69,0,69,653,595,58,458,405,53,73,*,*,358
11/1/2013,VA,Virginia,Hopewell City,51670,4261,3762,499,3283,22,3261,978,38,940,3968,3469,499,2546,2061,485,888,130,43,1485
11/1/2013,VA,Virginia,Isle of Wight,51093,6949,5621,1328,5919,33,5886,1030,32,998,6446,5118,1328,4048,2800,1248,923,165,81,2879
11/1/2013,VA,Virginia,James City,51095,16884,15229,1655,15756,41,15715,1128,42,1086,15569,13917,1652,8393,6938,1455,822,180,50,7341
11/1/2013,VA,Virginia,King and Queen,51097,1545,1355,190,1276,*,*,269,*,*,1441,1251,190,1050,870,180,265,*,*,701
11/1/2013,VA,Virginia,King George,51099,3137,2932,205,2683,18,2665,454,21,433,2739,2534,205,1280,1091,189,399,77,21,783
11/1/2013,VA,Virginia,King William,51101,2817,2460,357,2384,18,2366,433,19,414,2585,2228,357,1931,1603,328,371,81,21,1458
11/1/2013,VA,Virginia,Lancaster,51103,4064,3652,412,3721,*,*,343,15,328,3870,3458,412,2503,2194,309,490,78,30,1905
11/1/2013,VA,Virginia,Lee,51105,6218,4377,1841,3982,11,3971,2236,18,2218,5891,4053,1838,4573,2857,1716,1902,247,80,2344
11/1/2013,VA,Virginia,Lexington City,51678,1554,1418,136,1412,*,*,142,*,*,1447,1311,136,1056,947,109,196,35,11,814
11/1/2013,VA,Virginia,Loudoun,51107,27199,23586,3613,25075,75,25000,2124,93,2031,22507,18899,3608,12885,9556,3329,2316,489,123,9957
11/1/2013,VA,Virginia,Louisa,51109,6619,5710,909,5443,28,5415,1176,28,1148,6066,5157,909,4150,3295,855,1042,231,75,2802
11/1/2013,VA,Virginia,Lunenburg,51111,2800,2513,287,2243,*,*,557,23,534,2596,2309,287,1878,1610,268,673,108,41,1056
11/1/2013,VA,Virginia,Lynchburg City,51680,13991,12351,1640,10918,73,10845,3073,103,2970,13035,11395,1640,10093,8603,1490,3265,421,146,6261
11/1/2013,VA,Virginia,Madison,51113,2676,2393,283,2329,*,*,347,*,*,2505,2222,283,1724,1462,262,405,69,24,1226
11/1/2013,VA,Virginia,Manassas City,51683,3706,3251,455,3183,16,3167,523,30,493,3192,2737,455,1987,1593,394,517,99,21,1350
11/1/2013,VA,Virginia,Manassas Park City,51685,1031,877,154,874,*,*,157,11,146,870,716,154,560,421,139,145,*,*,372
11/1/2013,VA,Virginia,Martinsville City,51690,3887,3061,826,2847,17,2830,1040,33,1007,3710,2884,826,3149,2524,625,1319,151,51,1628
11/1/2013,VA,Virginia,Mathews,51115,2589,2270,319,2337,*,*,252,*,*,2444,2125,319,1439,1145,294,263,42,20,1114
11/1/2013,VA,Virginia,Mecklenburg,51117,8658,7307,1351,6955,44,6911,1703,45,1658,8166,6817,1349,6174,5105,1069,1904,359,117,3794
11/1/2013,VA,Virginia,Middlesex,51119,3290,2875,415,2913,13,2900,377,11,366,3096,2682,414,2145,1819,326,425,82,24,1614
11/1/2013,VA,Virginia,Montgomery,51121,12336,10598,1738,9974,23,9951,2362,28,2334,11256,9518,1738,8661,7010,1651,1809,266,110,6476
11/1/2013,VA,Virginia,Nelson,51125,3989,3611,378,3432,*,*,557,16,541,3696,3318,378,2521,2182,339,621,101,39,1760
11/1/2013,VA,Virginia,New Kent,51127,3425,2901,524,2968,16,2952,457,12,445,3109,2585,524,1998,1549,449,286,72,25,1615
11/1/2013,VA,Virginia,Newport News City,51700,25181,20415,4766,20460,154,20306,4721,215,4506,23068,18303,4765,13108,8648,4460,4285,736,232,7855
11/1/2013,VA,Virginia,Norfolk City,51710,29754,24607,5147,23325,202,23123,6429,336,6093,26875,21728,5147,16562,11961,4601,6791,1088,299,8384
11/1/2013,VA,Virginia,Northampton,51131,3253,2901,352,2727,23,2704,526,31,495,3059,2707,352,2372,2054,318,910,98,32,1332
11/1/2013,VA,Virginia,Northumberland,51133,4427,4054,373,4057,*,*,370,11,359,4172,3799,373,2470,2193,277,436,91,29,1914
11/1/2013,VA,Virginia,Norton City,51720,1162,914,248,711,*,*,451,*,*,1066,818,248,820,586,234,364,48,21,387
11/1/2013,VA,Virginia,Nottoway,51135,3507,3070,437,2816,21,2795,691,13,678,3239,2802,437,2417,2137,280,910,119,47,1341
11/1/2013,VA,Virginia,Orange,51137,7884,7169,715,6858,33,6825,1026,31,995,7273,6559,714,4305,3727,578,924,230,66,3085
11/1/2013,VA,Virginia,Page,51139,5653,5018,635,4547,17,4530,1106,14,1092,5280,4645,635,3623,3050,573,1091,196,88,2248
11/1/2013,VA,Virginia,Patrick,51141,4907,3869,1038,3944,14,3930,963,*,*,4689,3652,1037,3622,2773,849,1006,188,73,2355
11/1/2013,VA,Virginia,Petersburg City,51730,6985,6033,952,5016,63,4953,1969,78,1891,6373,5421,952,4414,3553,861,2098,293,80,1943
11/1/2013,VA,Virginia,Pittsylvania,51143,14851,11876,2975,11832,83,11749,3019,82,2937,14097,11122,2975,11220,9143,2077,3108,540,225,7347
11/1/2013,VA,Virginia,Poquoson City,51735,2344,2124,220,2154,*,*,190,*,*,2146,1926,220,850,649,201,114,*,*,702
11/1/2013,VA,Virginia,Portsmouth City,51740,16871,13797,3074,12941,152,12789,3930,210,3720,15090,12016,3074,9029,6257,2772,3648,669,153,4559
11/1/2013,VA,Virginia,Powhatan,51145,4901,4029,872,4285,17,4268,616,20,596,4434,3562,872,3205,2411,794,379,86,34,2706
11/1/2013,VA,Virginia,Prince Edward,51147,4270,3696,574,3311,16,3295,959,32,927,3986,3412,574,2981,2536,445,1044,180,45,1712
11/1/2013,VA,Virginia,Prince George,51149,5028,4500,528,4154,22,4132,874,25,849,4646,4118,528,2583,2087,496,541,106,23,1913
11/1/2013,VA,Virginia,Prince William,51153,37899,33068,4831,33210,167,33043,4689,272,4417,32293,27465,4828,16626,12278,4348,4246,776,180,11424
11/1/2013,VA,Virginia,Pulaski,51155,8495,7256,1239,6501,24,6477,1994,26,1968,7965,6726,1239,5887,4704,1183,1693,305,119,3770
11/1/2013,VA,Virginia,Radford City,51750,1977,1678,299,1561,*,*,416,*,*,1825,1526,299,1463,1172,291,333,45,33,1052
11/1/2013,VA,Virginia,Rappahannock,51157,1802,1687,115,1607,*,*,195,*,*,1637,1522,115,983,889,94,175,*,*,764
11/1/2013,VA,Virginia,Richmond,51159,1769,1504,265,1519,13,1506,250,*,*,1670,1405,265,1163,941,222,279,78,26,780
11/1/2013,VA,Virginia,Richmond City,51760,30621,23690,6931,23238,247,22991,7383,353,7030,27626,20697,6929,21677,15017,6660,8194,1284,311,11888
11/1/2013,VA,Virginia,Roanoke,51161,20969,17382,3587,18254,62,18192,2715,42,2673,19390,15803,3587,13737,10311,3426,1897,373,124,11343
11/1/2013,VA,Virginia,Roanoke City,51770,19065,15311,3754,13845,107,13738,5220,130,5090,17440,13687,3753,13282,9678,3604,4600,734,227,7721
11/1/2013,VA,Virginia,Rockbridge,51163,5470,4582,888,4511,21,4490,959,12,947,5142,4254,888,3694,2994,700,859,159,69,2607
11/1/2013,VA,Virginia,Rockingham,51165,15134,12804,2330,13065,47,13018,2069,44,2025,14062,11733,2329,10095,9061,1034,1726,416,146,7807
11/1/2013,VA,Virginia,Russell,51167,7583,5771,1812,4768,11,4757,2815,11,2804,7232,5420,1812,5400,3742,1658,1730,281,116,3273
11/1/2013,VA,Virginia,Salem City,51775,5645,4785,860,4690,25,4665,955,17,938,5168,4308,860,3801,2982,819,799,124,51,2827
11/1/2013,VA,Virginia,Scott,51169,6407,3448,2959,4637,12,4625,1770,11,1759,6134,3175,2959,5138,2237,2901,1560,227,108,3243
11/1/2013,VA,Virginia,Shenandoah,51171,9469,8489,980,8232,18,8214,1237,27,1210,8882,7902,980,5727,4872,855,1229,208,100,4190
11/1/2013,VA,Virginia,Smyth,51173,8508,6988,1520,6083,17,6066,2425,22,2403,8039,6519,1520,6202,4812,1390,2142,363,152,3545
11/1/2013,VA,Virginia,Southampton,51175,3706,3288,418,3065,25,3040,641,21,620,3437,3019,418,2569,2209,360,696,126,37,1710
11/1/2013,VA,Virginia,Spotsylvania,51177,16649,15070,1579,14173,83,14090,2476,87,2389,14817,13239,1578,8236,6862,1374,1656,475,124,5981
11/1/2013,VA,Virginia,Stafford,51179,13283,12361,922,11539,59,11480,1744,90,1654,11631,10710,921,5398,4624,774,1145,293,80,3880
11/1/2013,VA,Virginia,Staunton City,51790,5679,5124,555,4564,23,4541,1115,25,1090,5346,4791,555,3986,3527,459,1050,133,52,2751
11/1/2013,VA,Virginia,Suffolk City,51800,13474,11247,2227,10747,67,10680,2727,79,2648,12293,10067,2226,7864,5951,1913,2569,376,117,4802
11/1/2013,VA,Virginia,Surry,51181,1408,1103,305,1156,*,*,252,12,240,1298,993,305,892,606,286,217,66,12,597
11/1/2013,VA,Virginia,Sussex,51183,2278,1921,357,1796,29,1767,482,*,*,2113,1756,357,1537,1198,339,517,142,26,852
11/1/2013,VA,Virginia,Tazewell,51185,11447,9237,2210,7995,32,7963,3452,35,3417,10868,8658,2210,7935,6173,1762,2238,420,164,5113
11/1/2013,VA,Virginia,Unknown,51999,*,*,*,*,*,*,*,*,*,*,*,*,*,*,*,*,*,*,*
11/1/2013,VA,Virginia,Virginia Beach City,51810,60006,52643,7363,52268,274,51994,7738,296,7442,54755,47397,7358,28077,21557,6520,5987,1133,346,20611
11/1/2013,VA,Virginia,Warren,51187,6476,5878,598,5445,24,5421,1031,25,1006,5944,5346,598,3645,3116,529,846,199,70,2530
11/1/2013,VA,Virginia,Washington,51191,14041,10111,3930,10778,41,10737,3263,13,3250,13202,9274,3928,9978,6271,3707,2536,484,181,6777
11/1/2013,VA,Virginia,Waynesboro City,51820,4579,4087,492,3700,21,3679,879,23,856,4298,3806,492,3236,2822,414,883,98,45,2210
11/1/2013,VA,Virginia,Westmoreland,51193,4440,4067,373,3868,24,3844,572,13,559,4101,3728,373,2417,2090,327,762,112,38,1505
11/1/2013,VA,Virginia,Williamsburg City,51830,2285,2019,266,2087,*,*,198,*,*,2068,1802,266,1308,1077,231,204,*,*,1064
11/1/2013,VA,Virginia,Winchester City,51840,4768,4321,447,4008,13,3995,760,19,741,4364,3917,447,2937,2530,407,810,119,48,1960
11/1/2013,VA,Virginia,Wise,51195,10206,7244,2962,6419,14,6405,3787,16,3771,9604,6643,2961,6998,4269,2729,2470,457,172,3899
11/1/2013,VA,Virginia,Wythe,51197,7194,5904,1290,5428,16,5412,1766,24,1742,6804,5514,1290,5088,3940,1148,1569,254,96,3169
11/1/2013,VA,Virginia,York,51199,10106,9093,1013,9208,31,9177,898,28,870,9186,8176,1010,4006,3068,938,597,144,44,3221
10/1/2013,VA,Virginia,Accomack,51001,8091,7151,940,6804,41,6763,1287,43,1244,7553,6614,939,5186,4363,823,1562,328,86,3210
10/1/2013,VA,Virginia,Albemarle,51003,16678,15322,1356,15136,45,15091,1542,58,1484,15027,13671,1356,10485,9258,1227,1498,241,88,8658
10/1/2013,VA,Virginia,Alexandria City,51510,15119,13788,1331,13711,77,13634,1408,90,1318,12195,10866,1329,6285,5035,1250,1862,329,62,4032
10/1/2013,VA,Virginia,Alleghany,51005,4401,3947,454,3489,20,3469,912,11,901,4175,3721,454,3172,2862,310,817,100,41,2214
10/1/2013,VA,Virginia,Amelia,51007,2669,2167,502,2191,*,*,478,11,467,2460,1958,502,1811,1341,470,464,75,29,1243
10/1/2013,VA,Virginia,Amherst,51009,7089,6099,990,5747,44,5703,1342,33,1309,6623,5633,990,5089,4172,917,1164,198,86,3641
10/1/2013,VA,Virginia,Appomattox,51011,3530,3045,485,2828,24,2804,702,14,688,3317,2832,485,2550,2101,449,690,96,52,1712
10/1/2013,VA,Virginia,Arlington,51013,21189,19269,1920,19508,53,19455,1681,83,1598,16947,15028,1919,8869,7069,1800,2773,321,113,5662
10/1/2013,VA,Virginia,Augusta,51015,15956,13944,2012,13478,49,13429,2478,46,2432,14984,12972,2012,10685,9083,1602,1852,328,133,8372
10/1/2013,VA,Virginia,Bath,51017,1239,1160,79,1075,*,*,164,*,*,1170,1091,79,889,830,59,200,33,24,632
10/1/2013,VA,Virginia,Bedford,51019,17011,14417,2594,14237,58,14179,2774,51,2723,15824,13233,2591,11546,9388,2158,1952,415,159,9020
10/1/2013,VA,Virginia,Bland,51021,1649,1376,273,1236,*,*,413,*,*,1566,1293,273,1111,883,228,234,58,20,799
10/1/2013,VA,Virginia,Botetourt,51023,7522,5998,1524,6377,24,6353,1145,13,1132,6946,5422,1524,5056,3658,1398,850,161,67,3978
10/1/2013,VA,Virginia,Bristol City,51520,4425,2797,1628,3362,*,*,1063,*,*,4156,2528,1628,3334,1752,1582,1048,137,59,2090
10/1/2013,VA,Virginia,Brunswick,51025,3701,3203,498,2938,21,2917,763,35,728,3491,2993,498,2664,2221,443,1055,114,40,1455
10/1/2013,VA,Virginia,Buchanan,51027,7457,5394,2063,4302,15,4287,3155,14,3141,7120,5058,2062,5505,3750,1755,1620,436,119,3330
10/1/2013,VA,Virginia,Buckingham,51029,3126,2742,384,2472,*,*,654,13,641,2898,2514,384,2138,1817,321,708,134,51,1245
10/1/2013,VA,Virginia,Buena Vista City,51530,1386,1145,241,1092,*,*,294,*,*,1303,1062,241,996,787,209,319,57,19,601
10/1/2013,VA,Virginia,Campbell,51031,11677,10085,1592,9462,65,9397,2215,60,2155,10963,9371,1592,8407,6953,1454,2020,348,177,5862
10/1/2013,VA,Virginia,Caroline,51033,5006,4341,665,4112,28,4084,894,31,863,4549,3884,665,2952,2330,622,770,210,52,1920
10/1/2013,VA,Virginia,Carroll,51035,7498,6553,945,5864,18,5846,1634,15,1619,7136,6191,945,5419,4706,713,1731,266,123,3299
10/1/2013,VA,Virginia,Charles City,51036,1611,1247,364,1339,11,1328,272,17,255,1497,1133,364,1074,763,311,243,72,22,737
10/1/2013,VA,Virginia,Charlotte,51037,3202,2760,442,2574,20,2554,628,13,615,3028,2586,442,2291,1891,400,780,139,44,1328
10/1/2013,VA,Virginia,Charlottesville City,51540,5696,5291,405,4504,20,4484,1192,50,1142,5118,4714,404,3905,3521,384,1229,140,57,2479
10/1/2013,VA,Virginia,Chesapeake City,51550,31466,26722,4744,26566,184,26382,4900,228,4672,28361,23618,4743,15849,11635,4214,3678,745,237,11189
10/1/2013,VA,Virginia,Chesterfield,51041,47689,38540,9149,40643,167,40476,7046,205,6841,42771,33622,9149,29890,21327,8563,4602,848,278,24162
10/1/2013,VA,Virginia,Clarke,51043,2691,2406,285,2444,*,*,247,*,*,2434,2149,285,1508,1257,251,264,72,28,1144
10/1/2013,VA,Virginia,Colonial Heights City,51570,3989,3590,399,3453,*,*,536,17,519,3655,3256,399,2109,1732,377,423,86,16,1584
10/1/2013,VA,Virginia,Covington City,51580,1678,1528,150,1271,*,*,407,*,*,1561,1411,150,1183,1047,136,351,48,24,760
10/1/2013,VA,Virginia,Craig,51045,1222,1000,222,914,*,*,308,*,*,1113,891,222,833,617,216,202,43,15,573
10/1/2013,VA,Virginia,Culpeper,51047,7834,6930,904,6622,42,6580,1212,40,1172,7152,6248,904,4541,3765,776,1080,221,74,3166
10/1/2013,VA,Virginia,Cumberland,51049,2079,1736,343,1691,*,*,388,*,*,1942,1600,342,1432,1111,321,425,69,27,911
10/1/2013,VA,Virginia,Danville City,51590,10935,9277,1658,8455,70,8385,2480,112,2368,10366,8708,1658,8319,7165,1154,3137,413,166,4603
10/1/2013,VA,Virginia,Dickenson,51051,4664,3383,1281,2705,*,*,1959,*,*,4442,3161,1281,3110,1951,1159,1092,219,101,1698
10/1/2013,VA,Virginia,Dinwiddie,51053,5155,4347,808,4052,29,4023,1103,28,1075,4720,3912,808,3300,2525,775,878,163,49,2210
10/1/2013,VA,Virginia,Emporia City,51595,1184,955,229,890,*,*,294,12,282,1106,877,229,894,725,169,447,55,16,376
10/1/2013,VA,Virginia,Essex,51057,2599,2261,338,2191,12,2179,408,14,394,2426,2088,338,1719,1428,291,426,84,20,1189
10/1/2013,VA,Virginia,Fairfax,51059,126893,112976,13917,118525,409,118116,8368,441,7927,102755,88859,13896,51399,38490,12909,12475,2143,452,36329
10/1/2013,VA,Virginia,Fairfax City,51600,3264,2868,396,3028,11,3017,236,13,223,2759,2364,395,1412,1041,371,313,*,*,1039
10/1/2013,VA,Virginia,Falls Church City,51610,1626,1454,172,1527,*,*,99,*,*,1296,1125,171,692,537,155,142,*,*,529
10/1/2013,VA,Virginia,Fauquier,51061,10419,9469,950,9357,43,9314,1062,33,1029,9189,8240,949,5103,4333,770,841,161,54,4047
10/1/2013,VA,Virginia,Floyd,51063,3581,2971,610,3018,*,*,563,*,*,3330,2720,610,2483,1919,564,523,91,43,1826
10/1/2013,VA,Virginia,Fluvanna,51065,5017,4505,512,4446,19,4427,571,21,550,4639,4127,512,3070,2623,447,463,101,20,2486
10/1/2013,VA,Virginia,Franklin,51067,13084,10066,3018,10596,39,10557,2488,22,2466,12247,9229,3018,9335,6578,2757,1996,396,149,6794
10/1/2013,VA,Virginia,Franklin City,51620,1818,1647,171,1399,*,*,419,20,399,1699,1528,171,1316,1166,150,491,75,20,730
10/1/2013,VA,Virginia,Frederick,51069,13365,11927,1438,11688,42,11646,1677,42,1635,12186,10749,1437,7682,6405,1277,1369,312,137,5864
10/1/2013,VA,Virginia,Fredericksburg City,51630,3506,3249,257,2836,18,2818,670,26,644,3165,2908,257,2021,1783,238,725,76,42,1178
10/1/2013,VA,Virginia,Galax City,51640,1935,1818,117,1473,*,*,462,*,*,1851,1734,117,1434,1354,80,672,72,35,655
10/1/2013,VA,Virginia,Giles,51071,4395,3479,916,3377,16,3361,1018,15,1003,4131,3216,915,2959,2089,870,788,125,34,2012
10/1/2013,VA,Virginia,Gloucester,51073,7251,6236,1015,6170,28,6142,1081,21,1060,6656,5641,1015,3735,2846,889,857,168,62,2648
10/1/2013,VA,Virginia,Goochland,51075,4609,3805,804,4125,20,4105,484,15,469,4143,3339,804,3090,2346,744,416,101,40,2533
10/1/2013,VA,Virginia,Grayson,51077,4405,3947,458,3531,12,3519,874,*,*,4247,3789,458,3027,2636,391,1027,163,78,1759
10/1/2013,VA,Virginia,Greene,51079,3184,2858,326,2736,16,2720,448,11,437,2931,2605,326,1974,1677,297,445,71,26,1432
10/1/2013,VA,Virginia,Greensville,51081,2282,1737,545,1795,18,1777,487,23,464,2124,1579,545,1725,1254,471,547,118,32,1028
10/1/2013,VA,Virginia,Halifax,51083,9119,7958,1161,7187,56,7131,1932,57,1875,8599,7439,1160,6766,5690,1076,2251,400,131,3984
10/1/2013,VA,Virginia,Hampton City,51650,22447,18595,3852,18121,172,17949,4326,204,4122,20551,16699,3852,10716,7199,3517,3364,721,190,6441
10/1/2013,VA,Virginia,Hanover,51085,17135,13907,3228,15278,66,15212,1857,48,1809,15616,12388,3228,11284,8389,2895,1308,316,106,9554
10/1/2013,VA,Virginia,Harrisonburg City,51660,4768,4266,502,3982,17,3965,786,20,766,4363,3861,502,3239,2969,270,868,112,44,2215
10/1/2013,VA,Virginia,Henrico,51087,47988,38409,9579,41131,255,40876,6857,312,6545,43450,33873,9577,31736,22825,8911,5627,1156,377,24576
10/1/2013,VA,Virginia,Henry,51089,14638,10597,4041,11295,52,11243,3343,66,3277,13990,9949,4041,11558,8490,3068,3152,630,225,7551
10/1/2013,VA,Virginia,Highland,51091,696,637,59,628,*,*,68,0,68,654,595,59,461,407,54,75,*,*,359
10/1/2013,VA,Virginia,Hopewell City,51670,4253,3758,495,3284,23,3261,969,37,932,3966,3471,495,2536,2055,481,881,129,44,1482
10/1/2013,VA,Virginia,Isle of Wight,51093,6937,5615,1322,5917,34,5883,1020,32,988,6436,5114,1322,4039,2797,1242,921,168,81,2869
10/1/2013,VA,Virginia,James City,51095,16841,15189,1652,15721,40,15681,1120,42,1078,15529,13880,1649,8362,6911,1451,808,181,50,7323
10/1/2013,VA,Virginia,King and Queen,51097,1545,1354,191,1278,*,*,267,*,*,1446,1255,191,1050,869,181,264,*,*,701
10/1/2013,VA,Virginia,King George,51099,3126,2922,204,2673,18,2655,453,21,432,2731,2527,204,1276,1088,188,396,75,22,783
10/1/2013,VA,Virginia,King William,51101,2802,2440,362,2371,18,2353,431,19,412,2576,2214,362,1922,1591,331,371,81,20,1450
10/1/2013,VA,Virginia,Lancaster,51103,4050,3636,414,3709,*,*,341,15,326,3857,3443,414,2503,2193,310,486,80,30,1907
10/1/2013,VA,Virginia,Lee,51105,6203,4366,1837,3981,11,3970,2222,18,2204,5874,4040,1834,4565,2853,1712,1899,248,80,2338
10/1/2013,VA,Virginia,Lexington City,51678,1553,1417,136,1411,*,*,142,*,*,1448,1312,136,1057,948,109,197,35,11,814
10/1/2013,VA,Virginia,Loudoun,51107,27087,23484,3603,24976,76,24900,2111,94,2017,22459,18861,3598,12862,9542,3320,2317,485,125,9935
10/1/2013,VA,Virginia,Louisa,51109,6609,5699,910,5438,29,5409,1171,29,1142,6054,5144,910,4143,3287,856,1043,228,76,2796
10/1/2013,VA,Virginia,Lunenburg,51111,2793,2506,287,2239,*,*,554,23,531,2590,2303,287,1872,1604,268,672,108,38,1054
10/1/2013,VA,Virginia,Lynchburg City,51680,13990,12356,1634,10916,75,10841,3074,103,2971,13037,11403,1634,10098,8617,1481,3260,420,146,6272
10/1/2013,VA,Virginia,Madison,51113,2665,2382,283,2327,*,*,338,*,*,2495,2212,283,1718,1457,261,401,69,24,1224
10/1/2013,VA,Virginia,Manassas City,51683,3700,3247,453,3181,16,3165,519,29,490,3186,2733,453,1985,1592,393,517,100,21,1347
10/1/2013,VA,Virginia,Manassas Park City,51685,1026,869,157,869,*,*,157,11,146,866,709,157,559,418,141,144,*,*,372
10/1/2013,VA,Virginia,Martinsville City,51690,3887,3062,825,2854,18,2836,1033,33,1000,3712,2887,825,3147,2522,625,1314,148,51,1634
10/1/2013,VA,Virginia,Mathews,51115,2584,2266,318,2336,*,*,248,*,*,2442,2124,318,1436,1144,292,263,42,19,1112
10/1/2013,VA,Virginia,Mecklenburg,51117,8651,7295,1356,6952,45,6907,1699,44,1655,8154,6800,1354,6164,5092,1072,1897,358,116,3793
10/1/2013,VA,Virginia,Middlesex,51119,3288,2874,414,2913,13,2900,375,11,364,3096,2683,413,2143,1818,325,425,81,24,1613
10/1/2013,VA,Virginia,Montgomery,51121,12283,10557,1726,9942,24,9918,2341,28,2313,11219,9493,1726,8640,7002,1638,1804,268,106,6462
10/1/2013,VA,Virginia,Nelson,51125,3974,3598,376,3417,*,*,557,17,540,3688,3312,376,2514,2177,337,619,106,38,1751
10/1/2013,VA,Virginia,New Kent,51127,3408,2883,525,2953,16,2937,455,11,444,3099,2574,525,1999,1550,449,286,71,25,1617
10/1/2013,VA,Virginia,Newport News City,51700,25119,20382,4737,20418,154,20264,4701,216,4485,23016,18280,4736,13072,8643,4429,4260,738,230,7844
10/1/2013,VA,Virginia,Norfolk City,51710,29681,24579,5102,23285,206,23079,6396,334,6062,26827,21725,5102,16512,11964,4548,6765,1087,299,8361
10/1/2013,VA,Virginia,Northampton,51131,3252,2902,350,2728,23,2705,524,31,493,3059,2709,350,2370,2055,315,910,99,32,1329
10/1/2013,VA,Virginia,Northumberland,51133,4416,4042,374,4049,*,*,367,11,356,4158,3784,374,2467,2189,278,437,89,28,1913
10/1/2013,VA,Virginia,Norton City,51720,1163,913,250,710,*,*,453,*,*,1069,819,250,821,586,235,365,48,20,388
10/1/2013,VA,Virginia,Nottoway,51135,3505,3069,436,2822,22,2800,683,13,670,3240,2804,436,2421,2142,279,903,118,46,1354
10/1/2013,VA,Virginia,Orange,51137,7861,7152,709,6838,34,6804,1023,31,992,7246,6538,708,4288,3715,573,923,224,67,3074
10/1/2013,VA,Virginia,Page,51139,5654,5018,636,4553,17,4536,1101,16,1085,5279,4643,636,3622,3049,573,1087,200,88,2247
10/1/2013,VA,Virginia,Patrick,51141,4910,3877,1033,3945,14,3931,965,*,*,4692,3660,1032,3624,2777,847,998,192,73,2361
10/1/2013,VA,Virginia,Petersburg City,51730,6973,6025,948,5016,64,4952,1957,78,1879,6371,5423,948,4417,3562,855,2101,290,78,1948
10/1/2013,VA,Virginia,Pittsylvania,51143,14827,11841,2986,11819,83,11736,3008,81,2927,14080,11094,2986,11215,9131,2084,3092,542,224,7357
10/1/2013,VA,Virginia,Poquoson City,51735,2330,2112,218,2140,*,*,190,*,*,2135,1917,218,845,646,199,115,*,*,698
10/1/2013,VA,Virginia,Portsmouth City,51740,16846,13790,3056,12934,154,12780,3912,210,3702,15074,12018,3056,9010,6256,2754,3637,667,152,4554
10/1/2013,VA,Virginia,Powhatan,51145,4876,4005,871,4262,19,4243,614,20,594,4418,3547,871,3201,2408,793,376,86,34,2705
10/1/2013,VA,Virginia,Prince Edward,51147,4261,3688,573,3302,16,3286,959,34,925,3980,3407,573,2983,2539,444,1044,180,45,1714
10/1/2013,VA,Virginia,Prince George,51149,5003,4475,528,4135,23,4112,868,25,843,4626,4098,528,2580,2084,496,536,106,23,1915
10/1/2013,VA,Virginia,Prince William,51153,37674,32877,4797,33026,168,32858,4648,272,4376,32126,27332,4794,16547,12222,4325,4230,775,181,11361
10/1/2013,VA,Virginia,Pulaski,51155,8474,7238,1236,6491,25,6466,1983,26,1957,7949,6713,1236,5876,4696,1180,1682,305,118,3771
10/1/2013,VA,Virginia,Radford City,51750,1979,1680,299,1566,*,*,413,*,*,1829,1530,299,1468,1177,291,331,47,31,1059
10/1/2013,VA,Virginia,Rappahannock,51157,1800,1687,113,1607,*,*,193,*,*,1635,1522,113,982,890,92,175,*,*,763
10/1/2013,VA,Virginia,Richmond,51159,1768,1503,265,1518,13,1505,250,*,*,1669,1404,265,1165,941,224,280,77,27,781
10/1/2013,VA,Virginia,Richmond City,51760,30546,23646,6900,23212,250,22962,7334,347,6987,27569,20671,6898,21643,15017,6626,8174,1284,309,11876
10/1/2013,VA,Virginia,Roanoke,51161,20902,17320,3582,18203,63,18140,2699,41,2658,19341,15759,3582,13716,10294,3422,1888,370,122,11336
10/1/2013,VA,Virginia,Roanoke City,51770,19011,15279,3732,13824,107,13717,5187,131,5056,17398,13667,3731,13243,9663,3580,4574,732,225,7712
10/1/2013,VA,Virginia,Rockbridge,51163,5463,4569,894,4509,21,4488,954,12,942,5132,4238,894,3687,2981,706,856,158,69,2604
10/1/2013,VA,Virginia,Rockingham,51165,15095,12764,2331,13052,48,13004,2043,44,1999,14034,11704,2330,10067,9033,1034,1717,412,147,7791
10/1/2013,VA,Virginia,Russell,51167,7570,5769,1801,4764,11,4753,2806,11,2795,7219,5418,1801,5394,3745,1649,1732,274,117,3271
10/1/2013,VA,Virginia,Salem City,51775,5627,4768,859,4682,25,4657,945,17,928,5152,4293,859,3792,2975,817,792,124,52,2824
10/1/2013,VA,Virginia,Scott,51169,6407,3453,2954,4639,12,4627,1768,11,1757,6132,3178,2954,5128,2232,2896,1547,229,108,3244
10/1/2013,VA,Virginia,Shenandoah,51171,9434,8461,973,8213,18,8195,1221,27,1194,8853,7880,973,5709,4863,846,1220,208,99,4182
10/1/2013,VA,Virginia,Smyth,51173,8490,6978,1512,6079,17,6062,2411,24,2387,8030,6518,1512,6193,4811,1382,2135,361,150,3547
10/1/2013,VA,Virginia,Southampton,51175,3690,3278,412,3053,26,3027,637,21,616,3423,3011,412,2561,2206,355,697,124,37,1703
10/1/2013,VA,Virginia,Spotsylvania,51177,16584,15005,1579,14133,84,14049,2451,85,2366,14767,13189,1578,8205,6831,1374,1653,468,122,5962
10/1/2013,VA,Virginia,Stafford,51179,13224,12310,914,11493,59,11434,1731,92,1639,11581,10668,913,5379,4610,769,1138,290,79,3872
10/1/2013,VA,Virginia,Staunton City,51790,5668,5110,558,4557,23,4534,1111,25,1086,5334,4776,558,3984,3523,461,1042,137,54,2751
10/1/2013,VA,Virginia,Suffolk City,51800,13447,11216,2231,10734,68,10666,2713,79,2634,12277,10047,2230,7855,5941,1914,2562,376,115,4802
10/1/2013,VA,Virginia,Surry,51181,1403,1098,305,1154,*,*,249,12,237,1291,986,305,895,609,286,216,67,12,600
10/1/2013,VA,Virginia,Sussex,51183,2272,1916,356,1797,29,1768,475,*,*,2107,1751,356,1532,1194,338,513,140,26,853
10/1/2013,VA,Virginia,Tazewell,51185,11428,9226,2202,7985,33,7952,3443,36,3407,10848,8646,2202,7922,6170,1752,2234,414,166,5108
10/1/2013,VA,Virginia,Unknown,51999,*,*,*,*,*,*,*,*,*,*,*,*,*,*,*,*,*,*,*
10/1/2013,VA,Virginia,Virginia Beach City,51810,59801,52476,7325,52108,282,51826,7693,302,7391,54596,47276,7320,27969,21495,6474,5963,1131,338,20537
10/1/2013,VA,Virginia,Warren,51187,6457,5863,594,5427,24,5403,1030,26,1004,5926,5332,594,3646,3119,527,845,197,70,2534
10/1/2013,VA,Virginia,Washington,51191,14017,10094,3923,10767,41,10726,3250,13,3237,13181,9260,3921,9961,6263,3698,2523,480,183,6775
10/1/2013,VA,Virginia,Waynesboro City,51820,4564,4070,494,3700,21,3679,864,23,841,4291,3797,494,3231,2815,416,874,96,45,2216
10/1/2013,VA,Virginia,Westmoreland,51193,4427,4056,371,3865,25,3840,562,13,549,4087,3716,371,2407,2082,325,763,112,35,1497
10/1/2013,VA,Virginia,Williamsburg City,51830,2284,2019,265,2089,*,*,195,*,*,2065,1800,265,1310,1081,229,202,*,*,1067
10/1/2013,VA,Virginia,Winchester City,51840,4743,4294,449,3994,13,3981,749,19,730,4342,3893,449,2924,2515,409,807,112,48,1957
10/1/2013,VA,Virginia,Wise,51195,10198,7240,2958,6422,14,6408,3776,16,3760,9603,6646,2957,6986,4263,2723,2464,456,173,3893
10/1/2013,VA,Virginia,Wythe,51197,7186,5903,1283,5427,16,5411,1759,24,1735,6797,5514,1283,5081,3942,1139,1558,255,99,3169
10/1/2013,VA,Virginia,York,51199,10071,9050,1021,9180,31,9149,891,28,863,9161,8143,1018,4012,3066,946,603,144,44,3221
9/1/2013,VA,Virginia,Accomack,51001,8078,7144,934,6799,41,6758,1279,44,1235,7545,6612,933,5170,4352,818,1551,320,88,3211
9/1/2013,VA,Virginia,Albemarle,51003,16634,15282,1352,15098,46,15052,1536,56,1480,14987,13635,1352,10433,9213,1220,1488,239,89,8617
9/1/2013,VA,Virginia,Alexandria City,51510,15038,13714,1324,13635,78,13557,1403,91,1312,12164,10842,1322,6286,5043,1243,1857,323,63,4043
9/1/2013,VA,Virginia,Alleghany,51005,4388,3936,452,3483,21,3462,905,11,894,4161,3709,452,3161,2851,310,815,98,42,2206
9/1/2013,VA,Virginia,Amelia,51007,2658,2154,504,2187,*,*,471,11,460,2456,1952,504,1803,1331,472,458,75,30,1240
9/1/2013,VA,Virginia,Amherst,51009,7065,6077,988,5727,45,5682,1338,33,1305,6609,5621,988,5072,4157,915,1163,196,86,3627
9/1/2013,VA,Virginia,Appomattox,51011,3517,3033,484,2820,25,2795,697,14,683,3307,2823,484,2542,2095,447,685,97,52,1708
9/1/2013,VA,Virginia,Arlington,51013,21083,19167,1916,19415,54,19361,1668,82,1586,16900,14985,1915,8842,7045,1797,2762,317,113,5650
9/1/2013,VA,Virginia,Augusta,51015,15917,13919,1998,13454,51,13403,2463,45,2418,14939,12941,1998,10654,9062,1592,1850,328,131,8345
9/1/2013,VA,Virginia,Bath,51017,1242,1164,78,1078,*,*,164,*,*,1172,1094,78,890,832,58,200,35,25,630
9/1/2013,VA,Virginia,Bedford,51019,16968,14382,2586,14204,59,14145,2764,51,2713,15785,13202,2583,11522,9371,2151,1946,415,158,9003
9/1/2013,VA,Virginia,Bland,51021,1641,1369,272,1229,*,*,412,*,*,1560,1288,272,1104,877,227,232,55,20,797
9/1/2013,VA,Virginia,Botetourt,51023,7494,5967,1527,6353,24,6329,1141,13,1128,6933,5406,1527,5050,3651,1399,845,163,67,3975
9/1/2013,VA,Virginia,Bristol City,51520,4427,2795,1632,3368,*,*,1059,*,*,4155,2523,1632,3334,1748,1586,1049,136,60,2089
9/1/2013,VA,Virginia,Brunswick,51025,3697,3193,504,2937,21,2916,760,35,725,3486,2982,504,2665,2214,451,1052,115,41,1457
9/1/2013,VA,Virginia,Buchanan,51027,7456,5397,2059,4295,15,4280,3161,16,3145,7111,5053,2058,5487,3740,1747,1612,432,119,3324
9/1/2013,VA,Virginia,Buckingham,51029,3125,2744,381,2474,*,*,651,14,637,2896,2515,381,2133,1816,317,708,134,51,1240
9/1/2013,VA,Virginia,Buena Vista City,51530,1378,1135,243,1087,*,*,291,*,*,1300,1057,243,994,783,211,321,57,19,597
9/1/2013,VA,Virginia,Campbell,51031,11653,10061,1592,9443,65,9378,2210,63,2147,10946,9354,1592,8391,6938,1453,2018,348,179,5846
9/1/2013,VA,Virginia,Caroline,51033,4993,4332,661,4104,28,4076,889,31,858,4542,3881,661,2936,2317,619,763,210,52,1911
9/1/2013,VA,Virginia,Carroll,51035,7484,6537,947,5855,18,5837,1629,15,1614,7126,6179,947,5416,4700,716,1726,267,126,3297
9/1/2013,VA,Virginia,Charles City,51036,1604,1241,363,1333,11,1322,271,17,254,1486,1123,363,1073,764,309,244,74,22,733
9/1/2013,VA,Virginia,Charlotte,51037,3194,2754,440,2571,20,2551,623,13,610,3018,2578,440,2285,1887,398,780,140,42,1323
9/1/2013,VA,Virginia,Charlottesville City,51540,5678,5276,402,4493,21,4472,1185,50,1135,5111,4710,401,3896,3515,381,1226,141,57,2472
9/1/2013,VA,Virginia,Chesapeake City,51550,31351,26632,4719,26480,186,26294,4871,231,4640,28264,23546,4718,15777,11593,4184,3655,742,236,11144
9/1/2013,VA,Virginia,Chesterfield,51041,47525,38420,9105,40514,170,40344,7011,204,6807,42650,33545,9105,29790,21269,8521,4577,853,276,24084
9/1/2013,VA,Virginia,Clarke,51043,2683,2397,286,2438,*,*,245,*,*,2422,2136,286,1502,1250,252,264,73,28,1137
9/1/2013,VA,Virginia,Colonial Heights City,51570,3984,3585,399,3451,*,*,533,18,515,3648,3249,399,2096,1719,377,415,85,15,1581
9/1/2013,VA,Virginia,Covington City,51580,1675,1526,149,1272,*,*,403,*,*,1561,1412,149,1180,1045,135,349,48,24,759
9/1/2013,VA,Virginia,Craig,51045,1215,996,219,911,*,*,304,*,*,1106,887,219,826,613,213,200,43,14,569
9/1/2013,VA,Virginia,Culpeper,51047,7808,6908,900,6607,44,6563,1201,39,1162,7134,6234,900,4532,3761,771,1078,227,71,3156
9/1/2013,VA,Virginia,Cumberland,51049,2078,1737,341,1689,*,*,389,*,*,1938,1598,340,1432,1113,319,428,69,27,908
9/1/2013,VA,Virginia,Danville City,51590,10920,9258,1662,8458,71,8387,2462,112,2350,10352,8690,1662,8307,7151,1156,3124,419,166,4598
9/1/2013,VA,Virginia,Dickenson,51051,4662,3383,1279,2707,*,*,1955,*,*,4437,3158,1279,3101,1947,1154,1083,220,100,1698
9/1/2013,VA,Virginia,Dinwiddie,51053,5147,4338,809,4046,29,4017,1101,27,1074,4709,3900,809,3302,2526,776,875,161,48,2218
9/1/2013,VA,Virginia,Emporia City,51595,1185,955,230,892,*,*,293,12,281,1110,880,230,896,725,171,448,56,16,376
9/1/2013,VA,Virginia,Essex,51057,2586,2254,332,2178,13,2165,408,14,394,2413,2081,332,1700,1413,287,423,84,20,1173
9/1/2013,VA,Virginia,Fairfax,51059,126283,112444,13839,117979,418,117561,8304,442,7862,102383,88566,13817,51204,38372,12832,12419,2133,453,36199
9/1/2013,VA,Virginia,Fairfax City,51600,3247,2854,393,3011,12,2999,236,13,223,2745,2353,392,1406,1038,368,313,*,*,1034
9/1/2013,VA,Virginia,Falls Church City,51610,1615,1444,171,1517,*,*,98,*,*,1295,1125,170,693,539,154,143,*,*,528
9/1/2013,VA,Virginia,Fauquier,51061,10389,9441,948,9333,44,9289,1056,34,1022,9171,8224,947,5090,4323,767,838,162,54,4036
9/1/2013,VA,Virginia,Floyd,51063,3571,2968,603,3006,11,2995,565,*,*,3322,2719,603,2474,1916,558,525,86,43,1820
9/1/2013,VA,Virginia,Fluvanna,51065,4998,4490,508,4429,19,4410,569,20,549,4616,4108,508,3046,2603,443,462,101,20,2463
9/1/2013,VA,Virginia,Franklin,51067,13052,10039,3013,10574,39,10535,2478,22,2456,12223,9210,3013,9311,6558,2753,1980,395,150,6786
9/1/2013,VA,Virginia,Franklin City,51620,1820,1649,171,1401,*,*,419,20,399,1701,1530,171,1321,1170,151,497,74,20,730
9/1/2013,VA,Virginia,Frederick,51069,13310,11871,1439,11647,43,11604,1663,42,1621,12156,10718,1438,7670,6394,1276,1363,310,137,5860
9/1/2013,VA,Virginia,Fredericksburg City,51630,3489,3234,255,2819,19,2800,670,27,643,3154,2899,255,2010,1774,236,719,77,42,1172
9/1/2013,VA,Virginia,Galax City,51640,1935,1818,117,1472,*,*,463,*,*,1852,1735,117,1432,1352,80,670,74,34,654
9/1/2013,VA,Virginia,Giles,51071,4385,3472,913,3370,16,3354,1015,16,999,4120,3208,912,2946,2080,866,782,121,34,2009
9/1/2013,VA,Virginia,Gloucester,51073,7224,6214,1010,6150,29,6121,1074,20,1054,6636,5626,1010,3725,2840,885,856,166,62,2641
9/1/2013,VA,Virginia,Goochland,51075,4589,3793,796,4104,20,4084,485,16,469,4123,3327,796,3071,2334,737,411,100,40,2520
9/1/2013,VA,Virginia,Grayson,51077,4403,3945,458,3528,12,3516,875,*,*,4244,3786,458,3034,2643,391,1029,160,79,1766
9/1/2013,VA,Virginia,Greene,51079,3177,2854,323,2731,16,2715,446,11,435,2924,2601,323,1963,1669,294,442,71,25,1425
9/1/2013,VA,Virginia,Greensville,51081,2278,1729,549,1795,19,1776,483,22,461,2120,1571,549,1726,1253,473,542,120,31,1033
9/1/2013,VA,Virginia,Halifax,51083,9104,7942,1162,7183,57,7126,1921,57,1864,8588,7427,1161,6765,5688,1077,2252,399,132,3982
9/1/2013,VA,Virginia,Hampton City,51650,22399,18569,3830,18094,173,17921,4305,208,4097,20519,16689,3830,10682,7192,3490,3353,724,193,6412
9/1/2013,VA,Virginia,Hanover,51085,17100,13882,3218,15251,67,15184,1849,49,1800,15584,12366,3218,11256,8372,2884,1303,321,106,9526
9/1/2013,VA,Virginia,Harrisonburg City,51660,4751,4250,501,3967,17,3950,784,21,763,4350,3849,501,3230,2963,267,863,114,44,2209
9/1/2013,VA,Virginia,Henrico,51087,47838,38280,9558,41019,256,40763,6819,315,6504,43356,33800,9556,31644,22758,8886,5598,1158,375,24513
9/1/2013,VA,Virginia,Henry,51089,14627,10580,4047,11302,54,11248,3325,66,3259,13982,9935,4047,11555,8485,3070,3135,636,230,7554
9/1/2013,VA,Virginia,Highland,51091,695,638,57,627,*,*,68,0,68,653,596,57,459,406,53,74,*,*,358
9/1/2013,VA,Virginia,Hopewell City,51670,4245,3752,493,3281,22,3259,964,37,927,3960,3467,493,2524,2045,479,878,125,43,1478
9/1/2013,VA,Virginia,Isle of Wight,51093,6912,5594,1318,5903,37,5866,1009,32,977,6410,5092,1318,4037,2800,1237,926,166,77,2868
9/1/2013,VA,Virginia,James City,51095,16791,15139,1652,15684,41,15643,1107,41,1066,15484,13835,1649,8341,6891,1450,804,180,49,7308
9/1/2013,VA,Virginia,King and Queen,51097,1540,1351,189,1274,*,*,266,*,*,1442,1253,189,1047,867,180,263,*,*,698
9/1/2013,VA,Virginia,King George,51099,3112,2908,204,2661,18,2643,451,21,430,2722,2518,204,1272,1084,188,396,74,22,780
9/1/2013,VA,Virginia,King William,51101,2793,2432,361,2365,18,2347,428,19,409,2570,2209,361,1919,1589,330,373,81,19,1446
9/1/2013,VA,Virginia,Lancaster,51103,4041,3632,409,3706,*,*,335,15,320,3844,3435,409,2490,2183,307,481,85,30,1894
9/1/2013,VA,Virginia,Lee,51105,6192,4353,1839,3978,13,3965,2214,18,2196,5864,4028,1836,4552,2836,1716,1887,251,81,2333
9/1/2013,VA,Virginia,Lexington City,51678,1549,1413,136,1408,*,*,141,*,*,1446,1310,136,1057,948,109,197,35,11,814
9/1/2013,VA,Virginia,Loudoun,51107,26932,23359,3573,24844,77,24767,2088,93,1995,22374,18806,3568,12811,9519,3292,2309,476,121,9905
9/1/2013,VA,Virginia,Louisa,51109,6579,5675,904,5414,30,5384,1165,29,1136,6022,5118,904,4121,3271,850,1041,229,76,2775
9/1/2013,VA,Virginia,Lunenburg,51111,2790,2502,288,2239,*,*,551,23,528,2587,2299,288,1874,1605,269,670,107,40,1057
9/1/2013,VA,Virginia,Lynchburg City,51680,13974,12348,1626,10914,76,10838,3060,104,2956,13019,11393,1626,10075,8602,1473,3242,422,148,6263
9/1/2013,VA,Virginia,Madison,51113,2662,2380,282,2327,11,2316,335,*,*,2496,2214,282,1718,1458,260,401,69,24,1224
9/1/2013,VA,Virginia,Manassas City,51683,3683,3235,448,3171,16,3155,512,29,483,3171,2723,448,1976,1587,389,515,98,20,1343
9/1/2013,VA,Virginia,Manassas Park City,51685,1021,864,157,867,*,*,154,11,143,863,706,157,561,420,141,144,*,*,373
9/1/2013,VA,Virginia,Martinsville City,51690,3879,3055,824,2852,18,2834,1027,31,996,3705,2881,824,3138,2513,625,1309,147,50,1632
9/1/2013,VA,Virginia,Mathews,51115,2583,2264,319,2336,*,*,247,*,*,2442,2123,319,1434,1141,293,262,43,19,1110
9/1/2013,VA,Virginia,Mecklenburg,51117,8638,7281,1357,6947,49,6898,1691,44,1647,8147,6792,1355,6157,5084,1073,1893,358,112,3794
9/1/2013,VA,Virginia,Middlesex,51119,3277,2863,414,2902,13,2889,375,11,364,3090,2677,413,2139,1814,325,421,84,22,1612
9/1/2013,VA,Virginia,Montgomery,51121,12258,10526,1732,9930,28,9902,2328,27,2301,11204,9472,1732,8641,6997,1644,1798,269,105,6469
9/1/2013,VA,Virginia,Nelson,51125,3951,3575,376,3402,*,*,549,16,533,3667,3291,376,2492,2155,337,614,108,39,1731
9/1/2013,VA,Virginia,New Kent,51127,3394,2873,521,2940,16,2924,454,11,443,3085,2564,521,1988,1542,446,281,71,26,1610
9/1/2013,VA,Virginia,Newport News City,51700,25067,20366,4701,20382,158,20224,4685,218,4467,22962,18262,4700,13015,8629,4386,4245,737,229,7804
9/1/2013,VA,Virginia,Norfolk City,51710,29600,24547,5053,23233,209,23024,6367,333,6034,26767,21714,5053,16435,11941,4494,6756,1085,300,8294
9/1/2013,VA,Virginia,Northampton,51131,3252,2902,350,2727,23,2704,525,31,494,3060,2710,350,2373,2058,315,907,100,31,1335
9/1/2013,VA,Virginia,Northumberland,51133,4405,4032,373,4042,*,*,363,*,*,4151,3778,373,2462,2185,277,437,89,28,1908
9/1/2013,VA,Virginia,Norton City,51720,1161,910,251,710,*,*,451,*,*,1069,818,251,823,587,236,365,50,20,388
9/1/2013,VA,Virginia,Nottoway,51135,3502,3067,435,2822,22,2800,680,13,667,3238,2803,435,2419,2141,278,904,119,45,1351
9/1/2013,VA,Virginia,Orange,51137,7842,7133,709,6824,35,6789,1018,31,987,7231,6523,708,4274,3701,573,922,224,66,3062
9/1/2013,VA,Virginia,Page,51139,5630,4993,637,4537,17,4520,1093,16,1077,5255,4618,637,3612,3037,575,1088,199,88,2237
9/1/2013,VA,Virginia,Patrick,51141,4906,3875,1031,3946,15,3931,960,*,*,4687,3657,1030,3631,2784,847,1005,190,75,2361
9/1/2013,VA,Virginia,Petersburg City,51730,6963,6018,945,5008,64,4944,1955,79,1876,6370,5425,945,4422,3571,851,2110,289,79,1944
9/1/2013,VA,Virginia,Pittsylvania,51143,14802,11812,2990,11802,83,11719,3000,82,2918,14069,11079,2990,11199,9113,2086,3073,538,229,7359
9/1/2013,VA,Virginia,Poquoson City,51735,2325,2108,217,2138,*,*,187,*,*,2130,1913,217,843,645,198,113,*,*,699
9/1/2013,VA,Virginia,Portsmouth City,51740,16788,13756,3032,12894,156,12738,3894,207,3687,15035,12003,3032,8969,6245,2724,3619,664,149,4537
9/1/2013,VA,Virginia,Powhatan,51145,4844,3978,866,4232,19,4213,612,20,592,4400,3534,866,3188,2400,788,379,86,34,2689
9/1/2013,VA,Virginia,Prince Edward,51147,4254,3679,575,3301,16,3285,953,34,919,3971,3396,575,2972,2523,449,1035,180,45,1712
9/1/2013,VA,Virginia,Prince George,51149,4978,4452,526,4117,23,4094,861,25,836,4609,4084,525,2576,2083,493,532,106,23,1915
9/1/2013,VA,Virginia,Prince William,51153,37443,32669,4774,32825,170,32655,4618,272,4346,31960,27189,4771,16490,12185,4305,4209,776,181,11324
9/1/2013,VA,Virginia,Pulaski,51155,8456,7226,1230,6476,26,6450,1980,27,1953,7931,6701,1230,5865,4690,1175,1670,309,118,3768
9/1/2013,VA,Virginia,Radford City,51750,1977,1680,297,1566,*,*,411,*,*,1830,1533,297,1465,1177,288,328,47,32,1058
9/1/2013,VA,Virginia,Rappahannock,51157,1796,1683,113,1605,*,*,191,*,*,1629,1516,113,975,883,92,175,34,11,755
9/1/2013,VA,Virginia,Richmond,51159,1762,1498,264,1514,13,1501,248,*,*,1665,1401,264,1165,941,224,280,77,27,781
9/1/2013,VA,Virginia,Richmond City,51760,30492,23609,6883,23194,250,22944,7298,349,6949,27531,20650,6881,21593,14988,6605,8154,1278,307,11854
9/1/2013,VA,Virginia,Roanoke,51161,20834,17256,3578,18151,64,18087,2683,41,2642,19276,15698,3578,13683,10266,3417,1878,367,123,11315
9/1/2013,VA,Virginia,Roanoke City,51770,18995,15273,3722,13814,110,13704,5181,130,5051,17402,13681,3721,13234,9665,3569,4560,733,226,7715
9/1/2013,VA,Virginia,Rockbridge,51163,5438,4541,897,4491,21,4470,947,12,935,5107,4210,897,3677,2968,709,849,154,69,2605
9/1/2013,VA,Virginia,Rockingham,51165,15057,12717,2340,13029,50,12979,2028,43,1985,13996,11657,2339,10040,8999,1041,1713,411,148,7768
9/1/2013,VA,Virginia,Russell,51167,7563,5765,1798,4768,11,4757,2795,11,2784,7219,5421,1798,5396,3751,1645,1725,275,119,3277
9/1/2013,VA,Virginia,Salem City,51775,5619,4759,860,4677,26,4651,942,17,925,5147,4287,860,3793,2974,819,795,125,51,2822
9/1/2013,VA,Virginia,Scott,51169,6401,3448,2953,4640,12,4628,1761,11,1750,6125,3172,2953,5123,2229,2894,1542,231,109,3241
9/1/2013,VA,Virginia,Shenandoah,51171,9410,8435,975,8194,18,8176,1216,26,1190,8828,7853,975,5695,4848,847,1225,201,99,4170
9/1/2013,VA,Virginia,Smyth,51173,8466,6957,1509,6061,17,6044,2405,24,2381,8005,6496,1509,6173,4794,1379,2127,365,148,3533
9/1/2013,VA,Virginia,Southampton,51175,3672,3262,410,3042,26,3016,630,21,609,3403,2993,410,2554,2199,355,690,122,39,1703
9/1/2013,VA,Virginia,Spotsylvania,51177,16485,14905,1580,14043,85,13958,2442,86,2356,14692,13113,1579,8166,6790,1376,1645,465,122,5934
9/1/2013,VA,Virginia,Stafford,51179,13165,12249,916,11445,60,11385,1720,93,1627,11535,10620,915,5353,4584,769,1128,290,80,3855
9/1/2013,VA,Virginia,Staunton City,51790,5646,5091,555,4542,24,4518,1104,25,1079,5319,4764,555,3964,3505,459,1030,140,53,2741
9/1/2013,VA,Virginia,Suffolk City,51800,13401,11183,2218,10708,69,10639,2693,79,2614,12240,10023,2217,7839,5940,1899,2553,372,114,4800
9/1/2013,VA,Virginia,Surry,51181,1399,1093,306,1153,*,*,246,12,234,1286,980,306,890,603,287,214,67,12,597
9/1/2013,VA,Virginia,Sussex,51183,2269,1914,355,1796,29,1767,473,*,*,2104,1749,355,1527,1190,337,511,140,28,848
9/1/2013,VA,Virginia,Tazewell,51185,11409,9216,2193,7986,37,7949,3423,35,3388,10836,8643,2193,7911,6165,1746,2219,421,164,5107
9/1/2013,VA,Virginia,Unknown,51999,*,*,*,*,*,*,*,*,*,*,*,*,*,*,*,*,*,*,*
9/1/2013,VA,Virginia,Virginia Beach City,51810,59542,52245,7297,51892,288,51604,7650,298,7352,54407,47115,7292,27844,21404,6440,5935,1129,339,20441
9/1/2013,VA,Virginia,Warren,51187,6419,5829,590,5401,24,5377,1018,24,994,5899,5309,590,3620,3097,523,839,198,69,2514
9/1/2013,VA,Virginia,Washington,51191,13992,10072,3920,10753,43,10710,3239,13,3226,13164,9246,3918,9931,6236,3695,2518,475,185,6753
9/1/2013,VA,Virginia,Waynesboro City,51820,4556,4062,494,3697,21,3676,859,23,836,4282,3788,494,3217,2801,416,862,98,45,2212
9/1/2013,VA,Virginia,Westmoreland,51193,4411,4039,372,3854,25,3829,557,14,543,4075,3703,372,2395,2069,326,750,117,36,1492
9/1/2013,VA,Virginia,Williamsburg City,51830,2274,2007,267,2080,*,*,194,*,*,2054,1787,267,1303,1072,231,200,*,*,1062
9/1/2013,VA,Virginia,Winchester City,51840,4725,4276,449,3981,13,3968,744,19,725,4329,3880,449,2922,2513,409,804,114,46,1958
9/1/2013,VA,Virginia,Wise,51195,10184,7222,2962,6414,14,6400,3770,18,3752,9600,6639,2961,6970,4248,2722,2458,454,176,3882
9/1/2013,VA,Virginia,Wythe,51197,7165,5885,1280,5415,17,5398,1750,25,1725,6784,5504,1280,5070,3933,1137,1550,256,98,3166
9/1/2013,VA,Virginia,York,51199,10018,9003,1015,9133,31,9102,885,27,858,9125,8113,1012,3979,3041,938,597,143,44,3195
4/1/2014,VA,Virginia,Accomack,51001,8127,7065,1062,6863,48,6815,1264,44,1220,7580,6519,1061,5371,4453,918,1522,347,84,3418
4/1/2014,VA,Virginia,Albemarle,51003,17140,15604,1536,15612,62,15550,1528,55,1473,15432,13896,1536,11141,9778,1363,1468,256,79,9338
4/1/2014,VA,Virginia,Alexandria City,51510,15309,13836,1473,13937,87,13850,1372,87,1285,12332,10862,1470,6619,5242,1377,1845,355,59,4360
4/1/2014,VA,Virginia,Alleghany,51005,4404,3939,465,3517,20,3497,887,11,876,4172,3707,465,3210,2881,329,820,95,44,2251
4/1/2014,VA,Virginia,Amelia,51007,2762,2239,523,2281,*,*,481,12,469,2544,2021,523,1897,1415,482,462,78,32,1325
4/1/2014,VA,Virginia,Amherst,51009,7161,6091,1070,5871,50,5821,1290,36,1254,6673,5603,1070,5232,4244,988,1157,213,74,3788
4/1/2014,VA,Virginia,Appomattox,51011,3584,3070,514,2894,23,2871,690,13,677,3361,2847,514,2639,2166,473,682,97,52,1808
4/1/2014,VA,Virginia,Arlington,51013,21295,19231,2064,19661,71,19590,1634,78,1556,17026,14962,2064,9237,7326,1911,2766,310,114,6047
4/1/2014,VA,Virginia,Augusta,51015,16184,14118,2066,13773,58,13715,2411,41,2370,15139,13073,2066,11036,9367,1669,1814,359,138,8725
4/1/2014,VA,Virginia,Bath,51017,1240,1163,77,1077,*,*,163,*,*,1164,1087,77,898,835,63,194,34,23,647
4/1/2014,VA,Virginia,Bedford,51019,17392,14652,2740,14677,69,14608,2715,51,2664,16220,13483,2737,12105,9861,2244,1966,441,151,9547
4/1/2014,VA,Virginia,Bland,51021,1690,1357,333,1296,*,*,394,*,*,1607,1275,332,1169,915,254,239,59,17,854
4/1/2014,VA,Virginia,Botetourt,51023,7632,6120,1512,6515,31,6484,1117,13,1104,7037,5525,1512,5165,3821,1344,812,153,61,4139
4/1/2014,VA,Virginia,Bristol City,51520,4445,2753,1692,3412,12,3400,1033,*,*,4182,2490,1692,3404,1761,1643,1013,151,50,2190
4/1/2014,VA,Virginia,Brunswick,51025,3746,3207,539,3016,20,2996,730,31,699,3526,2987,539,2721,2246,475,1054,113,38,1516
4/1/2014,VA,Virginia,Buchanan,51027,7412,4758,2654,4412,18,4394,3000,14,2986,7073,4420,2653,5713,3884,1829,1574,446,116,3577
4/1/2014,VA,Virginia,Buckingham,51029,3179,2760,419,2533,14,2519,646,14,632,2955,2536,419,2222,1870,352,695,147,50,1330
4/1/2014,VA,Virginia,Buena Vista City,51530,1399,1171,228,1113,*,*,286,*,*,1302,1074,228,1007,828,179,325,55,19,608
4/1/2014,VA,Virginia,Campbell,51031,11747,9987,1760,9590,72,9518,2157,64,2093,11022,9262,1760,8593,6981,1612,1971,367,178,6077
4/1/2014,VA,Virginia,Caroline,51033,5091,4356,735,4214,35,4179,877,36,841,4600,3865,735,3007,2331,676,733,227,52,1995
4/1/2014,VA,Virginia,Carroll,51035,7578,6552,1026,5988,18,5970,1590,16,1574,7191,6165,1026,5510,4718,792,1666,287,114,3443
4/1/2014,VA,Virginia,Charles City,51036,1652,1300,352,1381,15,1366,271,15,256,1530,1178,352,1116,851,265,245,70,17,784
4/1/2014,VA,Virginia,Charlotte,51037,3187,2738,449,2574,19,2555,613,11,602,3010,2561,449,2304,1907,397,775,129,48,1352
4/1/2014,VA,Virginia,Charlottesville City,51540,5759,5311,448,4606,21,4585,1153,48,1105,5151,4704,447,4036,3612,424,1223,149,56,2608
4/1/2014,VA,Virginia,Chesapeake City,51550,32111,26928,5183,27230,227,27003,4881,233,4648,28899,23717,5182,16603,12016,4587,3700,815,214,11874
4/1/2014,VA,Virginia,Chesterfield,51041,48930,39146,9784,42016,189,41827,6914,208,6706,43893,34110,9783,31395,22402,8993,4527,877,274,25717
4/1/2014,VA,Virginia,Clarke,51043,2735,2430,305,2485,11,2474,250,*,*,2464,2159,305,1577,1311,266,253,72,30,1222
4/1/2014,VA,Virginia,Colonial Heights City,51570,4009,3549,460,3477,12,3465,532,14,518,3664,3204,460,2177,1753,424,418,91,16,1652
4/1/2014,VA,Virginia,Covington City,51580,1676,1524,152,1284,*,*,392,*,*,1563,1411,152,1198,1058,140,345,56,18,779
4/1/2014,VA,Virginia,Craig,51045,1237,1014,223,936,*,*,301,*,*,1131,908,223,852,634,218,197,40,17,598
4/1/2014,VA,Virginia,Culpeper,51047,8031,7064,967,6832,46,6786,1199,43,1156,7304,6337,967,4783,3949,834,1076,231,73,3403
4/1/2014,VA,Virginia,Cumberland,51049,2065,1694,371,1702,12,1690,363,11,352,1921,1551,370,1443,1104,339,404,75,28,936
4/1/2014,VA,Virginia,Danville City,51590,10967,9241,1726,8564,81,8483,2403,113,2290,10392,8666,1726,8435,7214,1221,3092,432,166,4745
4/1/2014,VA,Virginia,Dickenson,51051,4688,3251,1437,2813,*,*,1875,11,1864,4471,3034,1437,3533,2288,1245,1102,220,97,2114
4/1/2014,VA,Virginia,Dinwiddie,51053,5259,4431,828,4158,39,4119,1101,32,1069,4810,3982,828,3385,2592,793,880,172,51,2282
4/1/2014,VA,Virginia,Emporia City,51595,1184,972,212,886,14,872,298,12,286,1116,904,212,895,731,164,434,63,14,384
4/1/2014,VA,Virginia,Essex,51057,2611,2243,368,2213,13,2200,398,12,386,2433,2065,368,1778,1457,321,420,84,22,1252
4/1/2014,VA,Virginia,Fairfax,51059,128062,112966,15096,120056,486,119570,8006,403,7603,103523,88450,15073,53594,39580,14014,12134,2331,414,38715
4/1/2014,VA,Virginia,Fairfax City,51600,3405,2970,435,3128,13,3115,277,*,*,2869,2434,435,1550,1143,407,363,51,14,1122
4/1/2014,VA,Virginia,Falls Church City,51610,1635,1458,177,1540,*,*,95,*,*,1295,1119,176,710,550,160,138,*,*,547
4/1/2014,VA,Virginia,Fauquier,51061,10629,9609,1020,9567,52,9515,1062,38,1024,9352,8333,1019,5443,4582,861,822,181,56,4384
4/1/2014,VA,Virginia,Floyd,51063,3627,3004,623,3070,11,3059,557,*,*,3379,2756,623,2560,1991,569,523,89,42,1906
4/1/2014,VA,Virginia,Fluvanna,51065,5105,4549,556,4552,22,4530,553,22,531,4690,4134,556,3248,2770,478,447,114,19,2668
4/1/2014,VA,Virginia,Franklin,51067,13237,10145,3092,10794,45,10749,2443,25,2418,12403,9311,3092,9657,6830,2827,1924,419,150,7164
4/1/2014,VA,Virginia,Franklin City,51620,1836,1640,196,1403,*,*,433,20,413,1718,1522,196,1360,1192,168,501,77,15,767
4/1/2014,VA,Virginia,Frederick,51069,13678,12079,1599,11983,43,11940,1695,42,1653,12455,10858,1597,8058,6660,1398,1338,335,130,6255
4/1/2014,VA,Virginia,Fredericksburg City,51630,3617,3305,312,2927,16,2911,690,29,661,3265,2953,312,2119,1827,292,728,81,36,1274
4/1/2014,VA,Virginia,Galax City,51640,1953,1833,120,1496,*,*,457,11,446,1865,1745,120,1455,1360,95,676,66,32,681
4/1/2014,VA,Virginia,Giles,51071,4345,3433,912,3379,19,3360,966,12,954,4073,3162,911,3225,2387,838,760,127,33,2305
4/1/2014,VA,Virginia,Gloucester,51073,7447,6439,1008,6370,36,6334,1077,17,1060,6837,5829,1008,4151,3277,874,878,174,64,3035
4/1/2014,VA,Virginia,Goochland,51075,4721,3893,828,4244,20,4224,477,16,461,4252,3424,828,3236,2500,736,401,100,33,2702
4/1/2014,VA,Virginia,Grayson,51077,4391,3915,476,3556,16,3540,835,*,*,4225,3749,476,3079,2668,411,990,172,81,1836
4/1/2014,VA,Virginia,Greene,51079,3232,2876,356,2797,13,2784,435,11,424,2972,2616,356,2055,1724,331,416,77,22,1540
4/1/2014,VA,Virginia,Greensville,51081,2292,1746,546,1821,20,1801,471,19,452,2130,1584,546,1750,1269,481,536,126,27,1061
4/1/2014,VA,Virginia,Halifax,51083,9148,7937,1211,7300,58,7242,1848,59,1789,8591,7381,1210,6832,5718,1114,2183,419,127,4103
4/1/2014,VA,Virginia,Hampton City,51650,22656,18528,4128,18436,202,18234,4220,203,4017,20705,16577,4128,11768,7972,3796,3317,745,187,7519
4/1/2014,VA,Virginia,Hanover,51085,17620,14155,3465,15793,66,15727,1827,46,1781,16063,12598,3465,11894,8860,3034,1332,330,95,10137
4/1/2014,VA,Virginia,Harrisonburg City,51660,4872,4387,485,4076,18,4058,796,20,776,4464,3979,485,3383,3025,358,870,125,47,2341
4/1/2014,VA,Virginia,Henrico,51087,48763,38349,10414,42107,312,41795,6656,295,6361,44192,33780,10412,32983,23590,9393,5441,1221,351,25970
4/1/2014,VA,Virginia,Henry,51089,14658,10610,4048,11434,70,11364,3224,67,3157,13992,9944,4048,11695,8599,3096,3070,660,224,7741
4/1/2014,VA,Virginia,Highland,51091,688,626,62,624,*,*,64,0,64,644,582,62,464,407,57,68,*,*,367
4/1/2014,VA,Virginia,Hopewell City,51670,4288,3707,581,3328,24,3304,960,33,927,3978,3397,581,2609,2045,564,880,140,37,1552
4/1/2014,VA,Virginia,Isle of Wight,51093,7007,5623,1384,6066,39,6027,941,30,911,6507,5123,1384,4471,3168,1303,845,182,78,3366
4/1/2014,VA,Virginia,James City,51095,17308,15496,1812,16201,52,16149,1107,41,1066,15983,14174,1809,9200,7632,1568,817,180,42,8161
4/1/2014,VA,Virginia,King and Queen,51097,1573,1381,192,1305,*,*,268,*,*,1474,1282,192,1086,913,173,259,78,11,738
4/1/2014,VA,Virginia,King George,51099,3230,2996,234,2752,18,2734,478,20,458,2810,2576,234,1380,1163,217,411,83,22,864
4/1/2014,VA,Virginia,King William,51101,2836,2490,346,2423,17,2406,413,19,394,2607,2261,346,2011,1716,295,361,81,20,1549
4/1/2014,VA,Virginia,Lancaster,51103,4095,3638,457,3754,16,3738,341,15,326,3897,3440,457,2589,2254,335,469,76,29,2015
4/1/2014,VA,Virginia,Lee,51105,6247,4316,1931,4103,15,4088,2144,17,2127,5913,3985,1928,4648,2855,1793,1910,249,78,2411
4/1/2014,VA,Virginia,Lexington City,51678,1585,1465,120,1440,12,1428,145,*,*,1481,1361,120,1097,1007,90,213,34,12,838
4/1/2014,VA,Virginia,Loudoun,51107,28264,24228,4036,26158,89,26069,2106,99,2007,23423,19391,4032,13873,10150,3723,2397,510,119,10847
4/1/2014,VA,Virginia,Louisa,51109,6745,5777,968,5599,36,5563,1146,30,1116,6178,5210,968,4339,3447,892,1013,253,67,3006
4/1/2014,VA,Virginia,Lunenburg,51111,2831,2505,326,2281,15,2266,550,22,528,2616,2290,326,1918,1616,302,667,118,34,1099
4/1/2014,VA,Virginia,Lynchburg City,51680,14128,12258,1870,11071,83,10988,3057,104,2953,13159,11289,1870,10397,8690,1707,3281,441,139,6536
4/1/2014,VA,Virginia,Madison,51113,2695,2406,289,2352,*,*,343,*,*,2511,2222,289,1767,1501,266,396,72,24,1275
4/1/2014,VA,Virginia,Manassas City,51683,3766,3257,509,3253,21,3232,513,32,481,3223,2715,508,2163,1680,483,501,97,27,1538
4/1/2014,VA,Virginia,Manassas Park City,51685,1040,875,165,886,*,*,154,11,143,878,713,165,577,427,150,144,*,*,390
4/1/2014,VA,Virginia,Martinsville City,51690,3909,3075,834,2906,22,2884,1003,36,967,3729,2895,834,3179,2540,639,1290,165,58,1666
4/1/2014,VA,Virginia,Mathews,51115,2631,2314,317,2392,*,*,239,*,*,2492,2175,317,1561,1282,279,243,50,19,1249
4/1/2014,VA,Virginia,Mecklenburg,51117,8705,7277,1428,7089,52,7037,1616,56,1560,8206,6780,1426,6307,5156,1151,1866,373,103,3965
4/1/2014,VA,Virginia,Middlesex,51119,3321,2874,447,2962,17,2945,359,*,*,3116,2670,446,2239,1889,350,396,91,22,1730
4/1/2014,VA,Virginia,Montgomery,51121,12396,10593,1803,10094,28,10066,2302,28,2274,11303,9500,1803,8852,7157,1695,1768,289,109,6686
4/1/2014,VA,Virginia,Nelson,51125,4034,3609,425,3495,14,3481,539,15,524,3722,3297,425,2623,2238,385,595,103,36,1889
4/1/2014,VA,Virginia,New Kent,51127,3525,2950,575,3082,16,3066,443,11,432,3208,2633,575,2130,1665,465,268,72,23,1767
4/1/2014,VA,Virginia,Newport News City,51700,25389,20259,5130,20755,169,20586,4634,221,4413,23265,18136,5129,14530,9708,4822,4247,768,210,9305
4/1/2014,VA,Virginia,Norfolk City,51710,29810,24155,5655,23535,240,23295,6275,329,5946,26901,21246,5655,17035,11894,5141,6625,1178,271,8961
4/1/2014,VA,Virginia,Northampton,51131,3301,2912,389,2795,32,2763,506,30,476,3105,2716,389,2425,2077,348,902,100,34,1389
4/1/2014,VA,Virginia,Northumberland,51133,4454,4023,431,4103,11,4092,351,*,*,4178,3747,431,2588,2286,302,422,88,29,2049
4/1/2014,VA,Virginia,Norton City,51720,1169,889,280,734,*,*,435,*,*,1078,798,280,836,572,264,354,51,20,411
4/1/2014,VA,Virginia,Nottoway,51135,3496,3027,469,2837,26,2811,659,14,645,3221,2752,469,2424,2111,313,895,120,48,1361
4/1/2014,VA,Virginia,Orange,51137,7924,7137,787,6918,40,6878,1006,31,975,7293,6507,786,4493,3838,655,907,236,62,3288
4/1/2014,VA,Virginia,Page,51139,5674,5026,648,4590,21,4569,1084,13,1071,5315,4667,648,3747,3168,579,1082,200,89,2376
4/1/2014,VA,Virginia,Patrick,51141,4934,3816,1118,3999,15,3984,935,13,922,4708,3591,1117,3736,2811,925,997,181,78,2480
4/1/2014,VA,Virginia,Petersburg City,51730,6981,5906,1075,5066,80,4986,1915,83,1832,6361,5286,1075,4467,3474,993,2006,327,82,2052
4/1/2014,VA,Virginia,Pittsylvania,51143,14997,12453,2544,12033,95,11938,2964,82,2882,14215,11671,2544,11454,9196,2258,3079,556,212,7607
4/1/2014,VA,Virginia,Poquoson City,51735,2337,2097,240,2156,*,*,181,*,*,2129,1889,240,985,774,211,104,*,*,849
4/1/2014,VA,Virginia,Portsmouth City,51740,16965,13694,3271,13098,180,12918,3867,208,3659,15145,11874,3271,9218,6220,2998,3552,668,148,4850
4/1/2014,VA,Virginia,Powhatan,51145,5011,4085,926,4399,21,4378,612,19,593,4553,3627,926,3385,2550,835,374,91,31,2889
4/1/2014,VA,Virginia,Prince Edward,51147,4334,3724,610,3400,26,3374,934,31,903,4035,3425,610,3039,2565,474,1036,173,44,1786
4/1/2014,VA,Virginia,Prince George,51149,5102,4548,554,4257,25,4232,845,27,818,4717,4163,554,2675,2160,515,526,109,26,2014
4/1/2014,VA,Virginia,Prince William,51153,38662,33429,5233,34061,198,33863,4601,293,4308,32933,27705,5228,17720,12879,4841,4166,838,196,12520
4/1/2014,VA,Virginia,Pulaski,51155,8544,7264,1280,6607,31,6576,1937,26,1911,7992,6712,1280,6046,4838,1208,1634,319,116,3977
4/1/2014,VA,Virginia,Radford City,51750,1975,1654,321,1586,*,*,389,*,*,1815,1494,321,1473,1166,307,323,43,28,1079
4/1/2014,VA,Virginia,Rappahannock,51157,1803,1666,137,1648,*,*,155,*,*,1628,1491,137,1005,891,114,147,36,11,811
4/1/2014,VA,Virginia,Richmond,51159,1791,1515,276,1546,17,1529,245,*,*,1685,1409,276,1192,960,232,278,84,23,807
4/1/2014,VA,Virginia,Richmond City,51760,30900,23542,7358,23603,296,23307,7297,355,6942,27824,20467,7357,22076,15065,7011,8007,1381,297,12391
4/1/2014,VA,Virginia,Roanoke,51161,21216,17625,3591,18566,90,18476,2650,48,2602,19676,16085,3591,14251,10897,3354,1907,387,121,11836
4/1/2014,VA,Virginia,Roanoke City,51770,19132,15357,3775,14079,122,13957,5053,137,4916,17544,13770,3774,13478,9875,3603,4494,751,228,8005
4/1/2014,VA,Virginia,Rockbridge,51163,5487,4651,836,4589,21,4568,898,12,886,5135,4299,836,3702,3192,510,834,166,59,2643
4/1/2014,VA,Virginia,Rockingham,51165,15386,13231,2155,13356,53,13303,2030,51,1979,14267,12113,2154,10476,8990,1486,1717,438,138,8183
4/1/2014,VA,Virginia,Russell,51167,7589,5406,2183,4922,13,4909,2667,12,2655,7235,5052,2183,5983,4216,1767,1684,289,117,3893
4/1/2014,VA,Virginia,Salem City,51775,5708,4860,848,4785,26,4759,923,20,903,5236,4388,848,3928,3133,795,788,129,43,2968
4/1/2014,VA,Virginia,Scott,51169,6407,3367,3040,4705,12,4693,1702,12,1690,6134,3094,3040,5219,2240,2979,1531,241,106,3341
4/1/2014,VA,Virginia,Shenandoah,51171,9533,8455,1078,8312,18,8294,1221,25,1196,8929,7851,1078,5885,4972,913,1214,225,98,4348
4/1/2014,VA,Virginia,Smyth,51173,8549,6908,1641,6208,21,6187,2341,24,2317,8078,6437,1641,6342,4849,1493,2097,378,147,3720
4/1/2014,VA,Virginia,Southampton,51175,3744,3298,446,3099,25,3074,645,22,623,3485,3039,446,2647,2265,382,690,133,38,1786
4/1/2014,VA,Virginia,Spotsylvania,51177,17118,15366,1752,14665,94,14571,2453,92,2361,15211,13460,1751,8718,7185,1533,1683,479,110,6446
4/1/2014,VA,Virginia,Stafford,51179,13722,12623,1099,11930,71,11859,1792,90,1702,12005,10908,1097,5802,4851,951,1172,313,72,4245
4/1/2014,VA,Virginia,Staunton City,51790,5734,5140,594,4658,26,4632,1076,28,1048,5406,4812,594,4132,3645,487,1045,147,52,2888
4/1/2014,VA,Virginia,Suffolk City,51800,13705,11438,2267,11031,80,10951,2674,79,2595,12486,10221,2265,8222,6284,1938,2550,387,102,5183
4/1/2014,VA,Virginia,Surry,51181,1405,1112,293,1170,*,*,235,11,224,1298,1005,293,920,646,274,201,68,12,639
4/1/2014,VA,Virginia,Sussex,51183,2281,1893,388,1826,35,1791,455,*,*,2113,1725,388,1581,1213,368,490,138,26,927
4/1/2014,VA,Virginia,Tazewell,51185,11409,8410,2999,8151,35,8116,3258,38,3220,10826,7829,2997,8240,6341,1899,2186,415,156,5483
4/1/2014,VA,Virginia,Unknown,51999,*,*,*,*,*,*,*,*,*,*,*,*,*,*,*,*,*,*,*
4/1/2014,VA,Virginia,Virginia Beach City,51810,60993,52772,8221,53361,315,53046,7632,320,7312,55614,47398,8216,29396,22081,7315,5984,1210,322,21880
4/1/2014,VA,Virginia,Warren,51187,6502,5894,608,5498,22,5476,1004,27,977,5947,5339,608,3728,3201,527,803,214,66,2645
4/1/2014,VA,Virginia,Washington,51191,14115,9927,4188,10975,52,10923,3140,15,3125,13285,9099,4186,10328,6469,3859,2474,500,171,7183
4/1/2014,VA,Virginia,Waynesboro City,51820,4636,4127,509,3766,20,3746,870,21,849,4348,3839,509,3336,2906,430,872,96,41,2327
4/1/2014,VA,Virginia,Westmoreland,51193,4511,4090,421,3945,22,3923,566,15,551,4157,3736,421,2497,2130,367,746,120,40,1591
4/1/2014,VA,Virginia,Williamsburg City,51830,2279,1998,281,2093,*,*,186,*,*,2067,1786,281,1362,1124,238,185,*,*,1139
4/1/2014,VA,Virginia,Winchester City,51840,4793,4293,500,4068,16,4052,725,19,706,4380,3880,500,3016,2573,443,787,124,42,2063
4/1/2014,VA,Virginia,Wise,51195,10184,7089,3095,6562,14,6548,3622,18,3604,9586,6492,3094,7310,4443,2867,2372,486,148,4304
4/1/2014,VA,Virginia,Wythe,51197,7181,5827,1354,5483,21,5462,1698,23,1675,6793,5439,1354,5171,3995,1176,1513,266,94,3298
4/1/2014,VA,Virginia,York,51199,10258,9169,1089,9370,36,9334,888,30,858,9321,8235,1086,4639,3628,1011,585,157,48,3849
8/1/2014,VA,Virginia,Accomack,51001,8203,7092,1111,6897,46,6851,1306,44,1262,7664,6553,1111,5424,4460,964,1544,349,90,3441
8/1/2014,VA,Virginia,Albemarle,51003,17350,15803,1547,15777,61,15716,1573,55,1518,15673,14126,1547,11296,9922,1374,1491,255,81,9469
8/1/2014,VA,Virginia,Alexandria City,51510,15608,14098,1510,14215,85,14130,1393,88,1305,12613,11106,1507,6741,5324,1417,1890,349,61,4441
8/1/2014,VA,Virginia,Alleghany,51005,4410,3924,486,3503,20,3483,907,*,*,4184,3698,486,3237,2885,352,838,93,44,2262
8/1/2014,VA,Virginia,Amelia,51007,2788,2262,526,2302,*,*,486,11,475,2576,2050,526,1913,1431,482,475,71,36,1331
8/1/2014,VA,Virginia,Amherst,51009,7234,6166,1068,5910,44,5866,1324,35,1289,6750,5682,1068,5279,4288,991,1190,217,75,3797
8/1/2014,VA,Virginia,Appomattox,51011,3611,3094,517,2900,22,2878,711,14,697,3393,2876,517,2661,2184,477,692,100,52,1817
8/1/2014,VA,Virginia,Arlington,51013,21610,19458,2152,19945,69,19876,1665,79,1586,17334,15183,2151,9374,7375,1999,2814,316,114,6130
8/1/2014,VA,Virginia,Augusta,51015,16335,14261,2074,13872,51,13821,2463,43,2420,15321,13247,2074,11153,9472,1681,1844,362,135,8812
8/1/2014,VA,Virginia,Bath,51017,1258,1179,79,1090,*,*,168,*,*,1183,1104,79,906,841,65,203,33,23,647
8/1/2014,VA,Virginia,Bedford,51019,17587,14808,2779,14810,62,14748,2777,49,2728,16424,13648,2776,12317,10023,2294,2003,432,149,9733
8/1/2014,VA,Virginia,Bland,51021,1708,1374,334,1312,*,*,396,*,*,1620,1286,334,1177,922,255,240,58,19,860
8/1/2014,VA,Virginia,Botetourt,51023,7699,6144,1555,6565,28,6537,1134,13,1121,7107,5552,1555,5395,4008,1387,817,156,62,4360
8/1/2014,VA,Virginia,Bristol City,51520,4449,2752,1697,3397,11,3386,1052,*,*,4189,2492,1697,3412,1763,1649,1032,149,55,2176
8/1/2014,VA,Virginia,Brunswick,51025,3774,3237,537,3027,20,3007,747,32,715,3560,3023,537,2751,2276,475,1084,113,36,1518
8/1/2014,VA,Virginia,Buchanan,51027,7389,4722,2667,4377,16,4361,3012,15,2997,7087,4421,2666,5707,3860,1847,1612,441,115,3539
8/1/2014,VA,Virginia,Buckingham,51029,3227,2798,429,2563,13,2550,664,14,650,3004,2575,429,2241,1877,364,708,143,48,1342
8/1/2014,VA,Virginia,Buena Vista City,51530,1405,1177,228,1112,*,*,293,*,*,1314,1086,228,1009,830,179,333,54,18,604
8/1/2014,VA,Virginia,Campbell,51031,11827,10061,1766,9620,67,9553,2207,66,2141,11096,9330,1766,8656,7036,1620,2011,363,168,6114
8/1/2014,VA,Virginia,Caroline,51033,5147,4411,736,4243,35,4208,904,38,866,4676,3940,736,3022,2343,679,753,227,50,1992
8/1/2014,VA,Virginia,Carroll,51035,7628,6600,1028,6000,18,5982,1628,17,1611,7243,6215,1028,5514,4723,791,1687,284,112,3431
8/1/2014,VA,Virginia,Charles City,51036,1676,1316,360,1398,14,1384,278,14,264,1558,1198,360,1139,868,271,252,74,17,796
8/1/2014,VA,Virginia,Charlotte,51037,3200,2752,448,2576,19,2557,624,11,613,3025,2577,448,2313,1914,399,779,127,52,1355
8/1/2014,VA,Virginia,Charlottesville City,51540,5804,5342,462,4638,20,4618,1166,49,1117,5205,4744,461,4070,3632,438,1236,148,61,2625
8/1/2014,VA,Virginia,Chesapeake City,51550,32516,26584,5932,27510,215,27295,5006,234,4772,29325,23394,5931,16906,11540,5366,3780,815,217,12094
8/1/2014,VA,Virginia,Chesterfield,51041,49660,39689,9971,42596,169,42427,7064,211,6853,44603,34633,9970,31937,22743,9194,4632,890,268,26147
8/1/2014,VA,Virginia,Clarke,51043,2777,2512,265,2522,11,2511,255,*,*,2506,2241,265,1589,1363,226,260,68,28,1233
8/1/2014,VA,Virginia,Colonial Heights City,51570,4027,3564,463,3480,*,*,547,15,532,3691,3228,463,2176,1748,428,422,93,16,1645
8/1/2014,VA,Virginia,Covington City,51580,1694,1537,157,1293,*,*,401,*,*,1581,1424,157,1208,1063,145,360,54,15,779
8/1/2014,VA,Virginia,Craig,51045,1249,1021,228,941,*,*,308,*,*,1140,912,228,874,649,225,204,40,16,614
8/1/2014,VA,Virginia,Culpeper,51047,8118,7152,966,6892,44,6848,1226,40,1186,7405,6439,966,4828,3995,833,1106,224,75,3423
8/1/2014,VA,Virginia,Cumberland,51049,2095,1727,368,1720,11,1709,375,*,*,1947,1581,366,1461,1126,335,415,74,27,945
8/1/2014,VA,Virginia,Danville City,51590,10984,9277,1707,8548,72,8476,2436,111,2325,10424,8717,1707,8435,7225,1210,3126,421,170,4718
8/1/2014,VA,Virginia,Dickenson,51051,4702,3261,1441,2797,*,*,1905,*,*,4482,3041,1441,3536,2285,1251,1118,216,96,2106
8/1/2014,VA,Virginia,Dinwiddie,51053,5328,4484,844,4194,36,4158,1134,30,1104,4889,4045,844,3435,2626,809,900,169,53,2313
8/1/2014,VA,Virginia,Emporia City,51595,1193,978,215,886,12,874,307,12,295,1124,909,215,903,736,167,448,61,16,378
8/1/2014,VA,Virginia,Essex,51057,2628,2253,375,2223,12,2211,405,11,394,2456,2081,375,1799,1470,329,427,89,25,1258
8/1/2014,VA,Virginia,Fairfax,51059,130667,115256,15411,122466,460,122006,8201,407,7794,105834,90448,15386,54815,40503,14312,12405,2376,430,39604
8/1/2014,VA,Virginia,Fairfax City,51600,3474,3035,439,3189,13,3176,285,*,*,2933,2494,439,1580,1167,413,372,52,15,1141
8/1/2014,VA,Virginia,Falls Church City,51610,1661,1477,184,1566,*,*,95,*,*,1315,1132,183,713,547,166,138,*,*,551
8/1/2014,VA,Virginia,Fauquier,51061,10771,9769,1002,9669,47,9622,1102,38,1064,9524,8523,1001,5520,4677,843,842,181,57,4440
8/1/2014,VA,Virginia,Floyd,51063,3671,3040,631,3105,*,*,566,*,*,3420,2789,631,2596,2020,576,530,90,44,1932
8/1/2014,VA,Virginia,Fluvanna,51065,5167,4599,568,4600,22,4578,567,25,542,4757,4189,568,3306,2814,492,459,114,21,2712
8/1/2014,VA,Virginia,Franklin,51067,13354,10219,3135,10860,43,10817,2494,24,2470,12540,9405,3135,9823,6949,2874,1963,427,149,7284
8/1/2014,VA,Virginia,Franklin City,51620,1858,1655,203,1413,*,*,445,20,425,1745,1542,203,1376,1199,177,517,78,16,765
8/1/2014,VA,Virginia,Frederick,51069,13811,12293,1518,12080,39,12041,1731,43,1688,12594,11078,1516,8125,6803,1322,1376,329,132,6288
8/1/2014,VA,Virginia,Fredericksburg City,51630,3640,3332,308,2942,15,2927,698,28,670,3297,2989,308,2124,1837,287,738,84,40,1262
8/1/2014,VA,Virginia,Galax City,51640,1946,1827,119,1486,*,*,460,11,449,1854,1735,119,1440,1345,95,664,68,32,676
8/1/2014,VA,Virginia,Giles,51071,4384,3449,935,3396,18,3378,988,12,976,4115,3181,934,3278,2418,860,782,130,35,2331
8/1/2014,VA,Virginia,Gloucester,51073,7531,6370,1161,6416,29,6387,1115,17,1098,6934,5773,1161,4186,3155,1031,891,169,60,3066
8/1/2014,VA,Virginia,Goochland,51075,4772,3932,840,4290,20,4270,482,17,465,4319,3479,840,3280,2530,750,402,98,31,2749
8/1/2014,VA,Virginia,Grayson,51077,4418,3935,483,3560,15,3545,858,*,*,4253,3770,483,3084,2666,418,998,176,80,1830
8/1/2014,VA,Virginia,Greene,51079,3258,2900,358,2815,13,2802,443,12,431,3002,2644,358,2074,1744,330,428,76,20,1550
8/1/2014,VA,Virginia,Greensville,51081,2319,1774,545,1833,18,1815,486,18,468,2159,1614,545,1758,1280,478,544,130,23,1061
8/1/2014,VA,Virginia,Halifax,51083,9201,8001,1200,7319,54,7265,1882,60,1822,8650,7451,1199,6846,5743,1103,2218,421,132,4075
8/1/2014,VA,Virginia,Hampton City,51650,22899,18065,4834,18575,195,18380,4324,209,4115,20967,16134,4833,11894,7380,4514,3402,742,190,7560
8/1/2014,VA,Virginia,Hanover,51085,17828,14320,3508,15959,62,15897,1869,43,1826,16251,12743,3508,12037,8957,3080,1361,323,99,10254
8/1/2014,VA,Virginia,Harrisonburg City,51660,4937,4453,484,4121,17,4104,816,20,796,4516,4032,484,3423,3068,355,907,118,46,2352
8/1/2014,VA,Virginia,Henrico,51087,49256,38648,10608,42447,299,42148,6809,293,6516,44707,34101,10606,33370,23767,9603,5594,1211,364,26201
8/1/2014,VA,Virginia,Henry,51089,14766,10724,4042,11465,62,11403,3301,66,3235,14096,10054,4042,11744,8647,3097,3136,650,227,7731
8/1/2014,VA,Virginia,Highland,51091,693,630,63,629,*,*,64,0,64,650,587,63,466,409,57,68,*,*,369
8/1/2014,VA,Virginia,Hopewell City,51670,4298,3697,601,3324,23,3301,974,34,940,4016,3415,601,2626,2044,582,905,135,35,1551
8/1/2014,VA,Virginia,Isle of Wight,51093,7101,5568,1533,6130,36,6094,971,31,940,6592,5059,1533,4507,3051,1456,859,181,77,3390
8/1/2014,VA,Virginia,James City,51095,17470,15512,1958,16341,48,16293,1129,40,1089,16165,14210,1955,9313,7598,1715,821,176,42,8274
8/1/2014,VA,Virginia,King and Queen,51097,1594,1393,201,1319,*,*,275,*,*,1497,1296,201,1097,915,182,271,76,11,739
8/1/2014,VA,Virginia,King George,51099,3289,3059,230,2793,16,2777,496,21,475,2866,2636,230,1385,1172,213,428,77,25,855
8/1/2014,VA,Virginia,King William,51101,2880,2520,360,2455,15,2440,425,22,403,2653,2293,360,2030,1722,308,367,81,22,1560
8/1/2014,VA,Virginia,Lancaster,51103,4103,3647,456,3751,15,3736,352,15,337,3921,3465,456,2622,2286,336,474,78,30,2040
8/1/2014,VA,Virginia,Lee,51105,6259,4323,1936,4092,13,4079,2167,16,2151,5939,4006,1933,4664,2864,1800,1938,245,78,2403
8/1/2014,VA,Virginia,Lexington City,51678,1578,1454,124,1435,12,1423,143,*,*,1479,1355,124,1096,1001,95,211,33,12,840
8/1/2014,VA,Virginia,Loudoun,51107,28844,25366,3478,26667,85,26582,2177,101,2076,23937,20463,3474,14192,11034,3158,2494,520,118,11060
8/1/2014,VA,Virginia,Louisa,51109,6819,5830,989,5633,35,5598,1186,33,1153,6260,5271,989,4391,3479,912,1030,245,68,3048
8/1/2014,VA,Virginia,Lunenburg,51111,2854,2522,332,2294,15,2279,560,22,538,2644,2312,332,1928,1620,308,678,121,34,1095
8/1/2014,VA,Virginia,Lynchburg City,51680,14167,12295,1872,11064,80,10984,3103,103,3000,13217,11346,1871,10433,8718,1715,3343,436,146,6508
8/1/2014,VA,Virginia,Madison,51113,2720,2429,291,2375,*,*,345,*,*,2541,2250,291,1789,1521,268,400,73,24,1292
8/1/2014,VA,Virginia,Manassas City,51683,3842,3320,522,3307,21,3286,535,34,501,3292,2771,521,2183,1687,496,512,96,28,1547
8/1/2014,VA,Virginia,Manassas Park City,51685,1062,902,160,908,*,*,154,11,143,898,738,160,579,431,148,145,*,*,389
8/1/2014,VA,Virginia,Martinsville City,51690,3919,3083,836,2912,21,2891,1007,35,972,3739,2903,836,3190,2547,643,1313,160,58,1659
8/1/2014,VA,Virginia,Mathews,51115,2647,2287,360,2403,*,*,244,*,*,2516,2156,360,1577,1253,324,247,49,19,1262
8/1/2014,VA,Virginia,Mecklenburg,51117,8780,7350,1430,7140,46,7094,1640,53,1587,8290,6862,1428,6357,5204,1153,1899,372,104,3982
8/1/2014,VA,Virginia,Middlesex,51119,3355,2894,461,2989,17,2972,366,*,*,3164,2704,460,2266,1903,363,415,92,18,1741
8/1/2014,VA,Virginia,Montgomery,51121,12552,10730,1822,10217,28,10189,2335,28,2307,11449,9627,1822,8967,7254,1713,1813,283,105,6766
8/1/2014,VA,Virginia,Nelson,51125,4084,3649,435,3531,14,3517,553,16,537,3774,3339,435,2670,2275,395,607,99,38,1926
8/1/2014,VA,Virginia,New Kent,51127,3581,2993,588,3123,14,3109,458,12,446,3270,2682,588,2168,1692,476,278,70,22,1798
8/1/2014,VA,Virginia,Newport News City,51700,25614,19656,5958,20885,160,20725,4729,230,4499,23497,17541,5956,14602,8938,5664,4322,748,214,9318
8/1/2014,VA,Virginia,Norfolk City,51710,30161,23089,7072,23707,227,23480,6454,337,6117,27288,20216,7072,17242,10638,6604,6727,1186,277,9052
8/1/2014,VA,Virginia,Northampton,51131,3315,2718,597,2794,30,2764,521,31,490,3125,2528,597,2431,1875,556,894,103,33,1401
8/1/2014,VA,Virginia,Northumberland,51133,4485,4048,437,4128,*,*,357,*,*,4216,3779,437,2598,2288,310,438,85,33,2042
8/1/2014,VA,Virginia,Norton City,51720,1179,893,286,737,*,*,442,*,*,1095,809,286,848,578,270,361,49,20,418
8/1/2014,VA,Virginia,Nottoway,51135,3503,3026,477,2830,25,2805,673,15,658,3243,2766,477,2451,2129,322,914,114,44,1379
8/1/2014,VA,Virginia,Orange,51137,7987,7189,798,6956,40,6916,1031,30,1001,7360,6563,797,4529,3866,663,927,236,61,3305
8/1/2014,VA,Virginia,Page,51139,5710,5061,649,4607,20,4587,1103,15,1088,5353,4704,649,3781,3202,579,1114,205,89,2373
8/1/2014,VA,Virginia,Patrick,51141,4956,3829,1127,4008,13,3995,948,13,935,4733,3607,1126,3749,2814,935,1002,176,81,2490
8/1/2014,VA,Virginia,Petersburg City,51730,7016,5921,1095,5065,75,4990,1951,88,1863,6406,5311,1095,4468,3450,1018,2033,327,80,2028
8/1/2014,VA,Virginia,Pittsylvania,51143,15083,12534,2549,12061,89,11972,3022,86,2936,14313,11764,2549,11503,9237,2266,3131,554,214,7604
8/1/2014,VA,Virginia,Poquoson City,51735,2363,2103,260,2174,*,*,189,0,189,2156,1896,260,1000,768,232,105,*,*,863
8/1/2014,VA,Virginia,Portsmouth City,51740,17099,13060,4039,13151,170,12981,3948,206,3742,15280,11241,4039,9285,5497,3788,3608,664,149,4864
8/1/2014,VA,Virginia,Powhatan,51145,5092,4155,937,4473,19,4454,619,19,600,4640,3703,937,3450,2605,845,380,95,34,2941
8/1/2014,VA,Virginia,Prince Edward,51147,4359,3737,622,3407,24,3383,952,32,920,4065,3443,622,3062,2576,486,1047,169,46,1800
8/1/2014,VA,Virginia,Prince George,51149,5166,4608,558,4304,24,4280,862,25,837,4801,4243,558,2708,2190,518,537,112,24,2035
8/1/2014,VA,Virginia,Prince William,51153,39510,34110,5400,34757,191,34566,4753,299,4454,33764,28370,5394,18034,13029,5005,4285,862,192,12695
8/1/2014,VA,Virginia,Pulaski,51155,8614,7314,1300,6639,29,6610,1975,29,1946,8080,6780,1300,6099,4874,1225,1663,310,117,4009
8/1/2014,VA,Virginia,Radford City,51750,1976,1653,323,1587,*,*,389,*,*,1826,1503,323,1477,1168,309,327,41,30,1079
8/1/2014,VA,Virginia,Rappahannock,51157,1814,1678,136,1659,*,*,155,*,*,1652,1516,136,1008,896,112,154,38,11,805
8/1/2014,VA,Virginia,Richmond,51159,1801,1523,278,1555,16,1539,246,*,*,1696,1418,278,1191,956,235,279,85,22,805
8/1/2014,VA,Virginia,Richmond City,51760,31205,23531,7674,23763,268,23495,7442,355,7087,28131,20457,7674,22291,14962,7329,8255,1358,308,12370
8/1/2014,VA,Virginia,Roanoke,51161,21432,17761,3671,18704,84,18620,2728,49,2679,19871,16200,3671,15026,11593,3433,1931,390,126,12579
8/1/2014,VA,Virginia,Roanoke City,51770,19298,15400,3898,14141,116,14025,5157,144,5013,17723,13826,3897,13871,10148,3723,4612,744,233,8282
8/1/2014,VA,Virginia,Rockbridge,51163,5523,4690,833,4614,19,4595,909,11,898,5177,4344,833,3713,3208,505,838,158,60,2657
8/1/2014,VA,Virginia,Rockingham,51165,15566,13415,2151,13496,51,13445,2070,52,2018,14421,12271,2150,10609,9129,1480,1746,441,140,8282
8/1/2014,VA,Virginia,Russell,51167,7640,5468,2172,4937,13,4924,2703,*,*,7290,5118,2172,6018,4259,1759,1712,285,120,3901
8/1/2014,VA,Virginia,Salem City,51775,5749,4889,860,4797,22,4775,952,23,929,5281,4421,860,4029,3221,808,803,129,44,3053
8/1/2014,VA,Virginia,Scott,51169,6424,3387,3037,4709,*,*,1715,13,1702,6155,3118,3037,5222,2246,2976,1554,236,105,3327
8/1/2014,VA,Virginia,Shenandoah,51171,9605,8535,1070,8357,17,8340,1248,26,1222,9011,7941,1070,5962,5060,902,1245,233,95,4389
8/1/2014,VA,Virginia,Smyth,51173,8585,6919,1666,6211,17,6194,2374,22,2352,8126,6460,1666,6385,4868,1517,2136,377,147,3725
8/1/2014,VA,Virginia,Southampton,51175,3786,3311,475,3116,24,3092,670,23,647,3534,3059,475,2687,2271,416,717,128,38,1804
8/1/2014,VA,Virginia,Spotsylvania,51177,17365,15601,1764,14867,89,14778,2498,88,2410,15491,13728,1763,8838,7291,1547,1744,490,114,6490
8/1/2014,VA,Virginia,Stafford,51179,14005,12914,1091,12148,68,12080,1857,94,1763,12292,11203,1089,5892,4944,948,1205,317,75,4295
8/1/2014,VA,Virginia,Staunton City,51790,5741,5148,593,4657,25,4632,1084,28,1056,5410,4817,593,4139,3654,485,1061,150,52,2876
8/1/2014,VA,Virginia,Suffolk City,51800,13885,11098,2787,11170,76,11094,2715,80,2635,12686,9901,2785,8296,5816,2480,2562,393,99,5242
8/1/2014,VA,Virginia,Surry,51181,1431,1126,305,1192,*,*,239,11,228,1323,1018,305,930,642,288,206,66,12,646
8/1/2014,VA,Virginia,Sussex,51183,2291,1905,386,1825,33,1792,466,*,*,2126,1740,386,1591,1225,366,483,140,26,942
8/1/2014,VA,Virginia,Tazewell,51185,11487,8482,3005,8169,33,8136,3318,37,3281,10895,7892,3003,8303,6394,1909,2228,416,160,5499
8/1/2014,VA,Virginia,Unknown,51999,*,*,*,*,*,*,*,*,*,*,*,*,*,*,*,*,*,*,*
8/1/2014,VA,Virginia,Virginia Beach City,51810,61753,52261,9492,53917,292,53625,7836,323,7513,56439,46953,9486,29915,21308,8607,6092,1240,328,22255
8/1/2014,VA,Virginia,Warren,51187,6579,5973,606,5548,19,5529,1031,26,1005,6035,5429,606,3808,3283,525,829,222,67,2690
8/1/2014,VA,Virginia,Washington,51191,14226,9982,4244,11037,48,10989,3189,15,3174,13409,9167,4242,10472,6558,3914,2527,487,175,7283
8/1/2014,VA,Virginia,Waynesboro City,51820,4657,4138,519,3770,18,3752,887,22,865,4380,3861,519,3359,2921,438,895,96,44,2324
8/1/2014,VA,Virginia,Westmoreland,51193,4541,4116,425,3956,21,3935,585,14,571,4188,3763,425,2504,2132,372,744,125,40,1595
8/1/2014,VA,Virginia,Williamsburg City,51830,2302,1992,310,2108,*,*,194,*,*,2094,1784,310,1372,1105,267,188,*,*,1147
8/1/2014,VA,Virginia,Winchester City,51840,4831,4344,487,4097,15,4082,734,16,718,4431,3944,487,3037,2609,428,798,121,47,2071
8/1/2014,VA,Virginia,Wise,51195,10218,7108,3110,6550,11,6539,3668,17,3651,9639,6530,3109,7345,4452,2893,2406,474,147,4318
8/1/2014,VA,Virginia,Wythe,51197,7215,5850,1365,5491,21,5470,1724,21,1703,6839,5474,1365,5207,4025,1182,1526,265,94,3322
8/1/2014,VA,Virginia,York,51199,10425,9217,1208,9513,36,9477,912,31,881,9508,8303,1205,4705,3576,1129,604,165,51,3885
12/1/2014,VA,Virginia,Accomack,51001,8233,7134,1099,6907,42,6865,1326,42,1284,7713,6614,1099,5439,4484,955,1565,361,86,3427
12/1/2014,VA,Virginia,Albemarle,51003,17569,15733,1836,15946,57,15889,1623,54,1569,15819,13983,1836,11397,9727,1670,1510,249,87,9551
12/1/2014,VA,Virginia,Alexandria City,51510,15878,14319,1559,14445,80,14365,1433,88,1345,12775,11219,1556,6846,5381,1465,1954,344,67,4481
12/1/2014,VA,Virginia,Alleghany,51005,4415,3784,631,3494,19,3475,921,*,*,4183,3552,631,3225,2728,497,844,92,44,2245
12/1/2014,VA,Virginia,Amelia,51007,2829,2194,635,2332,*,*,497,11,486,2620,1985,635,1943,1352,591,486,77,33,1347
12/1/2014,VA,Virginia,Amherst,51009,7300,6216,1084,5939,39,5900,1361,36,1325,6802,5718,1084,5300,4291,1009,1202,215,73,3810
12/1/2014,VA,Virginia,Appomattox,51011,3638,3110,528,2911,22,2889,727,14,713,3428,2900,528,2677,2191,486,707,97,51,1822
12/1/2014,VA,Virginia,Arlington,51013,21913,19718,2195,20223,66,20157,1690,79,1611,17512,15318,2194,9479,7439,2040,2866,314,121,6178
12/1/2014,VA,Virginia,Augusta,51015,16431,14113,2318,13910,47,13863,2521,42,2479,15418,13100,2318,11227,9297,1930,1871,361,141,8854
12/1/2014,VA,Virginia,Bath,51017,1266,1147,119,1094,*,*,172,*,*,1184,1065,119,911,806,105,206,34,24,647
12/1/2014,VA,Virginia,Bedford,51019,17767,14640,3127,14923,57,14866,2844,47,2797,16593,13469,3124,12397,9752,2645,2026,432,152,9787
12/1/2014,VA,Virginia,Bland,51021,1717,1384,333,1310,*,*,407,*,*,1624,1291,333,1182,926,256,248,58,17,859
12/1/2014,VA,Virginia,Botetourt,51023,7802,6085,1717,6642,27,6615,1160,15,1145,7196,5479,1717,5445,3895,1550,824,155,59,4407
12/1/2014,VA,Virginia,Bristol City,51520,4435,2745,1690,3374,*,*,1061,*,*,4174,2484,1690,3399,1756,1643,1047,147,58,2147
12/1/2014,VA,Virginia,Brunswick,51025,3805,3106,699,3048,19,3029,757,30,727,3589,2890,699,2764,2127,637,1095,108,38,1523
12/1/2014,VA,Virginia,Buchanan,51027,7387,4733,2654,4346,15,4331,3041,14,3027,7095,4442,2653,5693,3849,1844,1642,430,115,3506
12/1/2014,VA,Virginia,Buckingham,51029,3275,2660,615,2597,12,2585,678,13,665,3032,2417,615,2263,1714,549,719,143,46,1355
12/1/2014,VA,Virginia,Buena Vista City,51530,1423,1131,292,1125,*,*,298,*,*,1326,1034,292,1016,773,243,338,54,17,607
12/1/2014,VA,Virginia,Campbell,51031,11927,10151,1776,9674,62,9612,2253,66,2187,11185,9409,1776,8719,7090,1629,2045,368,174,6132
12/1/2014,VA,Virginia,Caroline,51033,5224,4360,864,4304,35,4269,920,36,884,4740,3876,864,3062,2259,803,764,227,52,2019
12/1/2014,VA,Virginia,Carroll,51035,7676,6641,1035,6025,17,6008,1651,18,1633,7299,6264,1035,5537,4741,796,1713,278,116,3430
12/1/2014,VA,Virginia,Charles City,51036,1694,1287,407,1406,14,1392,288,14,274,1572,1165,407,1149,832,317,260,77,18,794
12/1/2014,VA,Virginia,Charlotte,51037,3245,2787,458,2599,19,2580,646,11,635,3062,2604,458,2339,1931,408,797,124,52,1366
12/1/2014,VA,Virginia,Charlottesville City,51540,5868,5104,764,4685,18,4667,1183,45,1138,5256,4493,763,4108,3368,740,1263,147,59,2639
12/1/2014,VA,Virginia,Chesapeake City,51550,32951,27054,5897,27816,202,27614,5135,238,4897,29650,23753,5897,17132,11791,5341,3879,809,226,12218
12/1/2014,VA,Virginia,Chesterfield,51041,50493,39712,10781,43238,152,43086,7255,214,7041,45256,34476,10780,32434,22416,10018,4709,905,272,26548
12/1/2014,VA,Virginia,Clarke,51043,2796,2523,273,2534,*,*,262,*,*,2532,2259,273,1607,1375,232,263,70,28,1246
12/1/2014,VA,Virginia,Colonial Heights City,51570,4057,3536,521,3494,*,*,563,15,548,3716,3195,521,2183,1697,486,426,94,18,1645
12/1/2014,VA,Virginia,Covington City,51580,1691,1454,237,1290,*,*,401,*,*,1581,1344,237,1216,991,225,362,58,17,779
12/1/2014,VA,Virginia,Craig,51045,1259,996,263,947,*,*,312,*,*,1152,889,263,877,617,260,205,40,17,615
12/1/2014,VA,Virginia,Culpeper,51047,8197,7012,1185,6940,41,6899,1257,41,1216,7476,6291,1185,4868,3812,1056,1121,230,71,3446
12/1/2014,VA,Virginia,Cumberland,51049,2115,1671,444,1730,11,1719,385,*,*,1966,1524,442,1475,1063,412,427,75,26,947
12/1/2014,VA,Virginia,Danville City,51590,11018,9307,1711,8554,69,8485,2464,107,2357,10445,8734,1711,8460,7250,1210,3175,419,178,4688
12/1/2014,VA,Virginia,Dickenson,51051,4724,3254,1470,2770,*,*,1954,*,*,4497,3027,1470,3554,2270,1284,1134,214,97,2109
12/1/2014,VA,Virginia,Dinwiddie,51053,5389,4382,1007,4236,33,4203,1153,30,1123,4945,3938,1007,3462,2491,971,901,178,54,2329
12/1/2014,VA,Virginia,Emporia City,51595,1176,896,280,868,11,857,308,13,295,1105,825,280,890,645,245,445,63,14,368
12/1/2014,VA,Virginia,Essex,51057,2673,2230,443,2253,11,2242,420,13,407,2498,2055,443,1828,1433,395,437,91,25,1275
12/1/2014,VA,Virginia,Fairfax,51059,133216,117376,15840,124716,436,124280,8500,419,8081,107670,91859,15811,55796,41075,14721,12720,2424,438,40214
12/1/2014,VA,Virginia,Fairfax City,51600,3507,3067,440,3217,12,3205,290,*,*,2949,2509,440,1586,1172,414,378,53,16,1139
12/1/2014,VA,Virginia,Falls Church City,51610,1699,1511,188,1604,*,*,95,*,*,1339,1152,187,723,552,171,139,*,*,561
12/1/2014,VA,Virginia,Fauquier,51061,10912,9892,1020,9782,42,9740,1130,39,1091,9643,8624,1019,5595,4734,861,869,187,53,4486
12/1/2014,VA,Virginia,Floyd,51063,3706,2998,708,3133,*,*,573,*,*,3447,2739,708,2611,1957,654,535,88,49,1939
12/1/2014,VA,Virginia,Fluvanna,51065,5238,4567,671,4663,20,4643,575,26,549,4808,4137,671,3332,2737,595,463,118,21,2730
12/1/2014,VA,Virginia,Franklin,51067,13490,10024,3466,10955,35,10920,2535,24,2511,12671,9205,3466,9917,6701,3216,1997,431,150,7339
12/1/2014,VA,Virginia,Franklin City,51620,1863,1570,293,1415,*,*,448,19,429,1751,1458,293,1374,1106,268,522,78,16,758
12/1/2014,VA,Virginia,Frederick,51069,13947,12425,1522,12185,37,12148,1762,42,1720,12711,11191,1520,8221,6896,1325,1420,326,126,6349
12/1/2014,VA,Virginia,Fredericksburg City,51630,3681,3271,410,2966,14,2952,715,30,685,3314,2904,410,2147,1758,389,766,82,39,1260
12/1/2014,VA,Virginia,Galax City,51640,1954,1834,120,1488,*,*,466,*,*,1858,1738,120,1433,1338,95,665,68,30,670
12/1/2014,VA,Virginia,Giles,51071,4402,3278,1124,3401,18,3383,1001,*,*,4139,3016,1123,3297,2250,1047,786,130,37,2344
12/1/2014,VA,Virginia,Gloucester,51073,7638,6471,1167,6482,24,6458,1156,18,1138,7014,5847,1167,4241,3204,1037,921,171,59,3090
12/1/2014,VA,Virginia,Goochland,51075,4837,3936,901,4344,16,4328,493,16,477,4378,3477,901,3315,2506,809,406,98,32,2779
12/1/2014,VA,Virginia,Grayson,51077,4433,3949,484,3559,15,3544,874,*,*,4261,3777,484,3088,2668,420,1009,176,84,1819
12/1/2014,VA,Virginia,Greene,51079,3287,2844,443,2842,13,2829,445,12,433,3008,2565,443,2075,1661,414,410,76,21,1568
12/1/2014,VA,Virginia,Greensville,51081,2331,1726,605,1839,18,1821,492,17,475,2164,1559,605,1760,1213,547,551,128,22,1059
12/1/2014,VA,Virginia,Halifax,51083,9223,8028,1195,7315,51,7264,1908,63,1845,8659,7465,1194,6840,5740,1100,2226,425,134,4055
12/1/2014,VA,Virginia,Hampton City,51650,23123,18323,4800,18682,173,18509,4441,211,4230,21168,16368,4800,12027,7541,4486,3505,747,191,7584
12/1/2014,VA,Virginia,Hanover,51085,18043,14285,3758,16126,56,16070,1917,45,1872,16431,12673,3758,12213,8882,3331,1388,327,99,10399
12/1/2014,VA,Virginia,Harrisonburg City,51660,4985,4444,541,4149,17,4132,836,19,817,4552,4011,541,3449,3036,413,935,113,42,2359
12/1/2014,VA,Virginia,Henrico,51087,49797,38172,11625,42830,283,42547,6967,295,6672,45136,33513,11623,33731,23103,10628,5717,1225,384,26405
12/1/2014,VA,Virginia,Henry,51089,14809,10792,4017,11471,58,11413,3338,63,3275,14117,10100,4017,11748,8657,3091,3192,644,240,7672
12/1/2014,VA,Virginia,Highland,51091,705,636,69,641,*,*,64,0,64,665,596,69,476,413,63,70,*,*,379
12/1/2014,VA,Virginia,Hopewell City,51670,4300,3550,750,3311,21,3290,989,31,958,4002,3252,750,2629,1895,734,919,138,35,1537
12/1/2014,VA,Virginia,Isle of Wight,51093,7211,5683,1528,6214,34,6180,997,33,964,6690,5162,1528,4583,3131,1452,883,184,77,3439
12/1/2014,VA,Virginia,James City,51095,17649,15709,1940,16481,45,16436,1168,40,1128,16342,14405,1937,9406,7711,1695,845,177,40,8344
12/1/2014,VA,Virginia,King and Queen,51097,1620,1360,260,1341,*,*,279,*,*,1512,1252,260,1108,868,240,277,75,11,745
12/1/2014,VA,Virginia,King George,51099,3349,3031,318,2836,16,2820,513,21,492,2906,2588,318,1392,1092,300,438,78,24,852
12/1/2014,VA,Virginia,King William,51101,2902,2500,402,2466,13,2453,436,22,414,2666,2264,402,2041,1692,349,370,77,21,1573
12/1/2014,VA,Virginia,Lancaster,51103,4117,3590,527,3760,14,3746,357,13,344,3934,3407,527,2640,2233,407,484,78,31,2047
12/1/2014,VA,Virginia,Lee,51105,6274,4317,1957,4082,12,4070,2192,15,2177,5956,4002,1954,4664,2840,1824,1955,246,74,2389
12/1/2014,VA,Virginia,Lexington City,51678,1581,1420,161,1434,12,1422,147,*,*,1474,1313,161,1088,955,133,210,*,*,839
12/1/2014,VA,Virginia,Loudoun,51107,29449,25912,3537,27204,79,27125,2245,102,2143,24351,20819,3532,14453,11231,3222,2575,532,124,11222
12/1/2014,VA,Virginia,Louisa,51109,6915,5741,1174,5707,32,5675,1208,34,1174,6348,5174,1174,4443,3349,1094,1049,241,64,3089
12/1/2014,VA,Virginia,Lunenburg,51111,2895,2471,424,2320,14,2306,575,21,554,2674,2250,424,1941,1540,401,687,118,36,1100
12/1/2014,VA,Virginia,Lynchburg City,51680,14178,12290,1888,11031,75,10956,3147,104,3043,13207,11320,1887,10419,8685,1734,3371,428,141,6479
12/1/2014,VA,Virginia,Madison,51113,2721,2357,364,2369,*,*,352,*,*,2542,2178,364,1785,1445,340,391,76,24,1294
12/1/2014,VA,Virginia,Manassas City,51683,3925,3303,622,3366,20,3346,559,33,526,3339,2718,621,2202,1605,597,521,96,30,1555
12/1/2014,VA,Virginia,Manassas Park City,51685,1081,913,168,921,*,*,160,11,149,911,743,168,586,430,156,156,*,*,383
12/1/2014,VA,Virginia,Martinsville City,51690,3927,3091,836,2900,19,2881,1027,35,992,3736,2900,836,3181,2540,641,1327,160,59,1635
12/1/2014,VA,Virginia,Mathews,51115,2676,2328,348,2423,*,*,253,*,*,2541,2193,348,1602,1289,313,254,47,20,1281
12/1/2014,VA,Virginia,Mecklenburg,51117,8841,7399,1442,7172,42,7130,1669,51,1618,8340,6900,1440,6378,5218,1160,1925,369,107,3977
12/1/2014,VA,Virginia,Middlesex,51119,3370,2843,527,2995,15,2980,375,*,*,3174,2648,526,2280,1854,426,421,92,24,1743
12/1/2014,VA,Virginia,Montgomery,51121,12676,10505,2171,10287,27,10260,2389,29,2360,11525,9354,2171,9022,6957,2065,1828,281,115,6798
12/1/2014,VA,Virginia,Nelson,51125,4124,3580,544,3566,13,3553,558,15,543,3814,3270,544,2701,2195,506,621,100,39,1941
12/1/2014,VA,Virginia,New Kent,51127,3650,3023,627,3177,13,3164,473,12,461,3330,2703,627,2189,1679,510,287,68,23,1811
12/1/2014,VA,Virginia,Newport News City,51700,25899,19976,5923,21043,150,20893,4856,231,4625,23724,17803,5921,14743,9104,5639,4445,742,220,9336
12/1/2014,VA,Virginia,Norfolk City,51710,30529,23557,6972,23906,215,23691,6623,343,6280,27549,20577,6972,17479,10959,6520,6907,1190,288,9094
12/1/2014,VA,Virginia,Northampton,51131,3340,2808,532,2801,30,2771,539,32,507,3140,2608,532,2441,1949,492,903,98,38,1402
12/1/2014,VA,Virginia,Northumberland,51133,4510,4000,510,4145,*,*,365,*,*,4237,3727,510,2612,2225,387,443,89,34,2046
12/1/2014,VA,Virginia,Norton City,51720,1195,902,293,746,*,*,449,*,*,1109,816,293,857,581,276,369,49,21,418
12/1/2014,VA,Virginia,Nottoway,51135,3531,2884,647,2844,24,2820,687,15,672,3270,2623,647,2465,1969,496,927,116,44,1378
12/1/2014,VA,Virginia,Orange,51137,8051,7064,987,7001,40,6961,1050,29,1021,7421,6435,986,4573,3720,853,943,229,64,3337
12/1/2014,VA,Virginia,Page,51139,5771,5111,660,4630,16,4614,1141,15,1126,5417,4757,660,3834,3241,593,1147,204,88,2395
12/1/2014,VA,Virginia,Patrick,51141,4996,3780,1216,4034,12,4022,962,13,949,4770,3555,1215,3777,2747,1030,1026,173,82,2496
12/1/2014,VA,Virginia,Petersburg City,51730,7035,5453,1582,5058,70,4988,1977,91,1886,6431,4849,1582,4484,2969,1515,2051,327,81,2025
12/1/2014,VA,Virginia,Pittsylvania,51143,15193,12643,2550,12132,87,12045,3061,84,2977,14409,11859,2550,11539,9273,2266,3155,560,211,7613
12/1/2014,VA,Virginia,Poquoson City,51735,2382,2128,254,2191,*,*,191,0,191,2170,1916,254,1002,775,227,105,*,*,862
12/1/2014,VA,Virginia,Portsmouth City,51740,17231,13228,4003,13190,158,13032,4041,207,3834,15390,11387,4003,9393,5632,3761,3734,658,155,4846
12/1/2014,VA,Virginia,Powhatan,51145,5175,4151,1024,4542,20,4522,633,19,614,4726,3702,1024,3533,2603,930,393,95,34,3011
12/1/2014,VA,Virginia,Prince Edward,51147,4376,3586,790,3414,21,3393,962,32,930,4080,3290,790,3062,2404,658,1057,165,45,1795
12/1/2014,VA,Virginia,Prince George,51149,5237,4581,656,4347,23,4324,890,25,865,4848,4192,656,2732,2115,617,551,108,23,2050
12/1/2014,VA,Virginia,Prince William,51153,40301,33965,6336,35407,184,35223,4894,301,4593,34350,28019,6331,18270,12334,5936,4387,900,192,12791
12/1/2014,VA,Virginia,Pulaski,51155,8683,7137,1546,6664,26,6638,2019,29,1990,8139,6593,1546,6117,4647,1470,1704,310,118,3985
12/1/2014,VA,Virginia,Radford City,51750,1980,1599,381,1584,*,*,396,*,*,1825,1444,381,1473,1106,367,325,44,29,1075
12/1/2014,VA,Virginia,Rappahannock,51157,1848,1708,140,1683,*,*,165,*,*,1678,1538,140,1034,917,117,158,39,11,826
12/1/2014,VA,Virginia,Richmond,51159,1816,1495,321,1568,16,1552,248,*,*,1711,1390,321,1198,923,275,283,85,23,807
12/1/2014,VA,Virginia,Richmond City,51760,31497,22282,9215,23913,254,23659,7584,354,7230,28338,19123,9215,22452,13557,8895,8396,1344,315,12397
12/1/2014,VA,Virginia,Roanoke,51161,21593,17617,3976,18818,80,18738,2775,52,2723,20008,16032,3976,15125,11392,3733,1956,382,134,12653
12/1/2014,VA,Virginia,Roanoke City,51770,19481,14494,4987,14211,107,14104,5270,145,5125,17895,12909,4986,14011,9197,4814,4762,746,237,8266
12/1/2014,VA,Virginia,Rockbridge,51163,5589,4635,954,4665,18,4647,924,11,913,5228,4274,954,3758,3131,627,841,166,59,2692
12/1/2014,VA,Virginia,Rockingham,51165,15694,13307,2387,13566,43,13523,2128,50,2078,14532,12146,2386,10704,8983,1721,1776,460,144,8324
12/1/2014,VA,Virginia,Russell,51167,7638,5452,2186,4922,11,4911,2716,*,*,7287,5101,2186,6006,4229,1777,1726,283,125,3872
12/1/2014,VA,Virginia,Salem City,51775,5752,4702,1050,4788,21,4767,964,23,941,5277,4227,1050,4021,3023,998,796,131,45,3049
12/1/2014,VA,Virginia,Scott,51169,6473,3407,3066,4733,*,*,1740,12,1728,6195,3129,3066,5265,2259,3006,1568,242,112,3343
12/1/2014,VA,Virginia,Shenandoah,51171,9707,8648,1059,8434,17,8417,1273,24,1249,9099,8040,1059,6009,5117,892,1266,235,96,4412
12/1/2014,VA,Virginia,Smyth,51173,8624,6911,1713,6225,16,6209,2399,23,2376,8150,6437,1713,6402,4844,1558,2154,385,153,3710
12/1/2014,VA,Virginia,Southampton,51175,3824,3217,607,3136,22,3114,688,23,665,3560,2953,607,2699,2150,549,727,133,36,1803
12/1/2014,VA,Virginia,Spotsylvania,51177,17620,15607,2013,15055,81,14974,2565,90,2475,15686,13674,2012,8941,7145,1796,1811,485,119,6526
12/1/2014,VA,Virginia,Stafford,51179,14257,13001,1256,12333,64,12269,1924,95,1829,12482,11227,1255,5949,4837,1112,1230,310,74,4335
12/1/2014,VA,Virginia,Staunton City,51790,5777,5140,637,4667,23,4644,1110,27,1083,5433,4796,637,4127,3595,532,1069,147,54,2857
12/1/2014,VA,Virginia,Suffolk City,51800,14062,11343,2719,11276,73,11203,2786,76,2710,12832,10115,2717,8405,5987,2418,2634,385,106,5280
12/1/2014,VA,Virginia,Surry,51181,1444,1108,336,1201,*,*,243,11,232,1329,993,336,939,620,319,214,64,11,650
12/1/2014,VA,Virginia,Sussex,51183,2311,1834,477,1832,32,1800,479,*,*,2148,1671,477,1616,1159,457,501,140,26,949
12/1/2014,VA,Virginia,Tazewell,51185,11580,8574,3006,8203,32,8171,3377,38,3339,10982,7978,3004,8371,6446,1925,2264,424,159,5524
12/1/2014,VA,Virginia,Unknown,51999,*,*,*,*,*,*,*,*,*,*,*,*,*,*,*,*,*,*,*
12/1/2014,VA,Virginia,Virginia Beach City,51810,62592,53136,9456,54532,271,54261,8060,320,7740,57147,47696,9451,30350,21760,8590,6289,1245,337,22479
12/1/2014,VA,Virginia,Warren,51187,6627,6019,608,5583,18,5565,1044,24,1020,6061,5453,608,3838,3310,528,837,228,65,2708
12/1/2014,VA,Virginia,Washington,51191,14322,10058,4264,11078,43,11035,3244,14,3230,13468,9205,4263,10516,6579,3937,2568,486,174,7288
12/1/2014,VA,Virginia,Waynesboro City,51820,4681,4009,672,3776,18,3758,905,23,882,4400,3728,672,3397,2806,591,913,100,44,2340
12/1/2014,VA,Virginia,Westmoreland,51193,4577,4006,571,3983,20,3963,594,14,580,4212,3641,571,2521,2005,516,752,127,42,1600
12/1/2014,VA,Virginia,Williamsburg City,51830,2319,1992,327,2119,*,*,200,*,*,2106,1779,327,1381,1096,285,197,*,*,1147
12/1/2014,VA,Virginia,Winchester City,51840,4871,4383,488,4119,14,4105,752,18,734,4458,3970,488,3048,2619,429,810,118,45,2075
12/1/2014,VA,Virginia,Wise,51195,10255,7119,3136,6514,*,*,3741,17,3724,9658,6523,3135,7345,4411,2934,2423,473,155,4294
12/1/2014,VA,Virginia,Wythe,51197,7271,5899,1372,5518,20,5498,1753,21,1732,6883,5511,1372,5217,4030,1187,1546,265,97,3309
12/1/2014,VA,Virginia,York,51199,10547,9328,1219,9611,33,9578,936,32,904,9641,8425,1216,4768,3632,1136,628,159,50,3931
2/1/2014,VA,Virginia,Accomack,51001,8115,7068,1047,6866,49,6817,1249,43,1206,7570,6524,1046,5331,4428,903,1512,341,86,3392
2/1/2014,VA,Virginia,Albemarle,51003,17036,15503,1533,15524,64,15460,1512,54,1458,15367,13834,1533,11064,9703,1361,1464,253,87,9260
2/1/2014,VA,Virginia,Alexandria City,51510,15177,13706,1471,13809,90,13719,1368,86,1282,12264,10796,1468,6584,5208,1376,1826,364,62,4332
2/1/2014,VA,Virginia,Alleghany,51005,4404,3936,468,3527,21,3506,877,11,866,4169,3701,468,3218,2888,330,809,97,48,2264
2/1/2014,VA,Virginia,Amelia,51007,2749,2234,515,2272,*,*,477,12,465,2533,2018,515,1890,1416,474,455,80,32,1323
2/1/2014,VA,Virginia,Amherst,51009,7137,6069,1068,5857,51,5806,1280,37,1243,6655,5587,1068,5205,4221,984,1133,216,83,3773
2/1/2014,VA,Virginia,Appomattox,51011,3576,3061,515,2891,25,2866,685,14,671,3358,2843,515,2631,2157,474,682,101,53,1795
2/1/2014,VA,Virginia,Arlington,51013,21167,19122,2045,19554,73,19481,1613,76,1537,16956,14912,2044,9203,7307,1896,2746,316,116,6025
2/1/2014,VA,Virginia,Augusta,51015,16102,14046,2056,13711,60,13651,2391,42,2349,15070,13014,2056,10987,9334,1653,1795,366,142,8684
2/1/2014,VA,Virginia,Bath,51017,1228,1150,78,1068,*,*,160,*,*,1156,1078,78,897,834,63,196,36,25,640
2/1/2014,VA,Virginia,Bedford,51019,17314,14583,2731,14614,69,14545,2700,51,2649,16136,13408,2728,12011,9781,2230,1939,441,157,9474
2/1/2014,VA,Virginia,Bland,51021,1675,1340,335,1287,*,*,388,*,*,1590,1256,334,1157,901,256,235,59,18,845
2/1/2014,VA,Virginia,Botetourt,51023,7602,6092,1510,6491,31,6460,1111,13,1098,7018,5508,1510,5157,3816,1341,812,157,65,4123
2/1/2014,VA,Virginia,Bristol City,51520,4439,2742,1697,3415,12,3403,1024,*,*,4181,2484,1697,3400,1753,1647,1004,155,52,2189
2/1/2014,VA,Virginia,Brunswick,51025,3721,3194,527,3002,21,2981,719,31,688,3503,2976,527,2703,2242,461,1037,115,38,1513
2/1/2014,VA,Virginia,Buchanan,51027,7415,4755,2660,4421,19,4402,2994,14,2980,7076,4417,2659,5713,3880,1833,1563,452,122,3576
2/1/2014,VA,Virginia,Buckingham,51029,3167,2749,418,2524,14,2510,643,15,628,2946,2528,418,2209,1859,350,688,151,50,1320
2/1/2014,VA,Virginia,Buena Vista City,51530,1394,1165,229,1111,*,*,283,*,*,1299,1070,229,1005,825,180,320,56,20,609
2/1/2014,VA,Virginia,Campbell,51031,11717,9961,1756,9579,71,9508,2138,63,2075,11002,9246,1756,8571,6963,1608,1963,372,187,6049
2/1/2014,VA,Virginia,Caroline,51033,5063,4339,724,4194,36,4158,869,37,832,4577,3853,724,3000,2334,666,722,236,51,1991
2/1/2014,VA,Virginia,Carroll,51035,7571,6540,1031,5994,20,5974,1577,17,1560,7189,6158,1031,5512,4719,793,1658,289,121,3444
2/1/2014,VA,Virginia,Charles City,51036,1645,1299,346,1378,16,1362,267,15,252,1525,1179,346,1108,848,260,244,73,18,773
2/1/2014,VA,Virginia,Charlotte,51037,3191,2738,453,2583,20,2563,608,12,596,3013,2560,453,2313,1911,402,770,134,43,1366
2/1/2014,VA,Virginia,Charlottesville City,51540,5727,5280,447,4589,23,4566,1138,48,1090,5135,4689,446,4021,3599,422,1205,151,59,2606
2/1/2014,VA,Virginia,Chesapeake City,51550,31910,26817,5093,27088,229,26859,4822,234,4588,28739,23647,5092,16474,11985,4489,3623,821,228,11802
2/1/2014,VA,Virginia,Chesterfield,51041,48618,38966,9652,41765,193,41572,6853,209,6644,43672,34021,9651,31111,22255,8856,4483,899,286,25443
2/1/2014,VA,Virginia,Clarke,51043,2720,2415,305,2477,12,2465,243,*,*,2455,2150,305,1566,1301,265,250,71,32,1213
2/1/2014,VA,Virginia,Colonial Heights City,51570,4014,3570,444,3480,15,3465,534,14,520,3680,3236,444,2173,1765,408,416,94,16,1647
2/1/2014,VA,Virginia,Covington City,51580,1677,1523,154,1288,*,*,389,*,*,1560,1406,154,1203,1061,142,346,58,18,781
2/1/2014,VA,Virginia,Craig,51045,1229,1004,225,934,*,*,295,*,*,1123,898,225,851,632,219,194,41,17,599
2/1/2014,VA,Virginia,Culpeper,51047,8003,7033,970,6817,48,6769,1186,43,1143,7289,6319,970,4775,3941,834,1062,236,75,3402
2/1/2014,VA,Virginia,Cumberland,51049,2066,1706,360,1704,13,1691,362,11,351,1921,1562,359,1446,1118,328,402,76,28,940
2/1/2014,VA,Virginia,Danville City,51590,10954,9230,1724,8576,83,8493,2378,112,2266,10391,8667,1724,8438,7216,1222,3067,442,170,4759
2/1/2014,VA,Virginia,Dickenson,51051,4680,3252,1428,2813,*,*,1867,11,1856,4463,3035,1428,3532,2296,1236,1092,223,102,2115
2/1/2014,VA,Virginia,Dinwiddie,51053,5231,4422,809,4147,40,4107,1084,32,1052,4785,3976,809,3373,2597,776,875,173,48,2277
2/1/2014,VA,Virginia,Emporia City,51595,1181,966,215,886,14,872,295,13,282,1111,896,215,896,735,161,431,64,17,384
2/1/2014,VA,Virginia,Essex,51057,2606,2240,366,2213,14,2199,393,12,381,2437,2071,366,1768,1451,317,416,84,19,1249
2/1/2014,VA,Virginia,Fairfax,51059,126999,112066,14933,119074,499,118575,7925,399,7526,102865,87953,14912,53237,39381,13856,12086,2328,448,38375
2/1/2014,VA,Virginia,Fairfax City,51600,3382,2952,430,3111,16,3095,271,*,*,2857,2427,430,1543,1142,401,362,53,11,1117
2/1/2014,VA,Virginia,Falls Church City,51610,1637,1460,177,1541,*,*,96,*,*,1299,1123,176,714,554,160,140,*,*,549
2/1/2014,VA,Virginia,Fauquier,51061,10559,9544,1015,9516,56,9460,1043,36,1007,9292,8278,1014,5405,4548,857,799,192,63,4351
2/1/2014,VA,Virginia,Floyd,51063,3608,2982,626,3065,11,3054,543,*,*,3364,2738,626,2553,1982,571,521,92,43,1897
2/1/2014,VA,Virginia,Fluvanna,51065,5077,4522,555,4529,23,4506,548,22,526,4664,4109,555,3223,2745,478,445,114,21,2643
2/1/2014,VA,Virginia,Franklin,51067,13165,10087,3078,10751,48,10703,2414,25,2389,12331,9253,3078,9607,6794,2813,1906,428,160,7113
2/1/2014,VA,Virginia,Franklin City,51620,1825,1638,187,1397,*,*,428,20,408,1710,1523,187,1347,1187,160,494,81,19,753
2/1/2014,VA,Virginia,Frederick,51069,13635,12039,1596,11962,47,11915,1673,42,1631,12437,10843,1594,8038,6643,1395,1329,341,131,6237
2/1/2014,VA,Virginia,Fredericksburg City,51630,3585,3286,299,2908,17,2891,677,29,648,3241,2942,299,2102,1822,280,712,87,39,1264
2/1/2014,VA,Virginia,Galax City,51640,1956,1839,117,1499,*,*,457,11,446,1868,1751,117,1451,1358,93,674,67,32,678
2/1/2014,VA,Virginia,Giles,51071,4358,3452,906,3393,19,3374,965,14,951,4089,3184,905,3176,2348,828,766,132,34,2244
2/1/2014,VA,Virginia,Gloucester,51073,7414,6422,992,6345,36,6309,1069,17,1052,6819,5827,992,4115,3258,857,865,173,69,3008
2/1/2014,VA,Virginia,Goochland,51075,4698,3878,820,4224,20,4204,474,16,458,4235,3415,820,3207,2479,728,399,102,38,2668
2/1/2014,VA,Virginia,Grayson,51077,4391,3919,472,3560,16,3544,831,*,*,4229,3757,472,3079,2673,406,986,171,82,1840
2/1/2014,VA,Virginia,Greene,51079,3206,2851,355,2777,15,2762,429,11,418,2948,2593,355,2043,1713,330,413,77,22,1531
2/1/2014,VA,Virginia,Greensville,51081,2281,1740,541,1818,20,1798,463,21,442,2123,1582,541,1749,1276,473,531,128,26,1064
2/1/2014,VA,Virginia,Halifax,51083,9136,7916,1220,7299,60,7239,1837,60,1777,8590,7371,1219,6829,5706,1123,2176,420,137,4096
2/1/2014,VA,Virginia,Hampton City,51650,22566,18505,4061,18382,206,18176,4184,196,3988,20645,16584,4061,11708,7987,3721,3273,738,197,7500
2/1/2014,VA,Virginia,Hanover,51085,17517,14088,3429,15713,70,15643,1804,47,1757,15965,12536,3429,11768,8771,2997,1312,342,96,10018
2/1/2014,VA,Virginia,Harrisonburg City,51660,4850,4361,489,4067,19,4048,783,20,763,4448,3959,489,3361,3002,359,853,124,51,2333
2/1/2014,VA,Virginia,Henrico,51087,48539,38310,10229,41964,319,41645,6575,295,6280,44026,33799,10227,32693,23486,9207,5368,1249,370,25706
2/1/2014,VA,Virginia,Henry,51089,14631,10570,4061,11430,71,11359,3201,67,3134,13974,9913,4061,11665,8576,3089,3050,675,234,7706
2/1/2014,VA,Virginia,Highland,51091,686,626,60,623,*,*,63,0,63,644,584,60,461,406,55,67,*,*,365
2/1/2014,VA,Virginia,Hopewell City,51670,4288,3741,547,3335,25,3310,953,36,917,3982,3435,547,2611,2081,530,882,137,40,1552
2/1/2014,VA,Virginia,Isle of Wight,51093,6987,5622,1365,6050,41,6009,937,31,906,6476,5111,1365,4447,3162,1285,847,184,82,3334
2/1/2014,VA,Virginia,James City,51095,17242,15445,1797,16152,54,16098,1090,40,1050,15921,14127,1794,9124,7571,1553,803,182,47,8092
2/1/2014,VA,Virginia,King and Queen,51097,1563,1373,190,1302,*,*,261,*,*,1467,1277,190,1078,907,171,253,78,12,735
2/1/2014,VA,Virginia,King George,51099,3218,2990,228,2749,18,2731,469,20,449,2800,2572,228,1367,1155,212,404,81,21,861
2/1/2014,VA,Virginia,King William,51101,2829,2493,336,2421,19,2402,408,19,389,2604,2268,336,1992,1710,282,357,85,20,1530
2/1/2014,VA,Virginia,Lancaster,51103,4088,3634,454,3755,16,3739,333,16,317,3888,3434,454,2588,2257,331,467,77,31,2013
2/1/2014,VA,Virginia,Lee,51105,6237,4316,1921,4108,16,4092,2129,16,2113,5904,3986,1918,4624,2844,1780,1886,253,81,2404
2/1/2014,VA,Virginia,Lexington City,51678,1578,1456,122,1436,12,1424,142,*,*,1476,1354,122,1090,999,91,211,35,12,832
2/1/2014,VA,Virginia,Loudoun,51107,28029,24020,4009,25951,93,25858,2078,100,1978,23255,19250,4005,13753,10063,3690,2360,518,122,10753
2/1/2014,VA,Virginia,Louisa,51109,6695,5743,952,5560,37,5523,1135,29,1106,6136,5184,952,4315,3437,878,1011,252,74,2978
2/1/2014,VA,Virginia,Lunenburg,51111,2822,2506,316,2277,16,2261,545,21,524,2607,2291,316,1913,1622,291,666,116,37,1094
2/1/2014,VA,Virginia,Lynchburg City,51680,14133,12245,1888,11101,84,11017,3032,106,2926,13180,11292,1888,10382,8659,1723,3256,447,145,6534
2/1/2014,VA,Virginia,Madison,51113,2689,2394,295,2350,*,*,339,*,*,2515,2220,295,1771,1500,271,399,72,24,1276
2/1/2014,VA,Virginia,Manassas City,51683,3728,3218,510,3222,21,3201,506,30,476,3212,2703,509,2156,1672,484,497,94,29,1536
2/1/2014,VA,Virginia,Manassas Park City,51685,1029,866,163,878,*,*,151,11,140,874,711,163,569,421,148,136,*,*,385
2/1/2014,VA,Virginia,Martinsville City,51690,3897,3062,835,2899,22,2877,998,36,962,3716,2881,835,3172,2532,640,1285,169,59,1659
2/1/2014,VA,Virginia,Mathews,51115,2613,2302,311,2375,*,*,238,*,*,2471,2160,311,1545,1272,273,242,48,19,1236
2/1/2014,VA,Virginia,Mecklenburg,51117,8695,7263,1432,7090,54,7036,1605,56,1549,8197,6767,1430,6306,5156,1150,1862,381,110,3953
2/1/2014,VA,Virginia,Middlesex,51119,3319,2874,445,2959,18,2941,360,*,*,3111,2667,444,2236,1889,347,401,91,24,1720
2/1/2014,VA,Virginia,Montgomery,51121,12331,10541,1790,10046,30,10016,2285,29,2256,11258,9468,1790,8824,7140,1684,1752,296,114,6662
2/1/2014,VA,Virginia,Nelson,51125,4018,3593,425,3484,14,3470,534,15,519,3711,3286,425,2618,2234,384,593,106,41,1878
2/1/2014,VA,Virginia,New Kent,51127,3492,2928,564,3051,16,3035,441,11,430,3172,2608,564,2093,1638,455,268,77,24,1724
2/1/2014,VA,Virginia,Newport News City,51700,25241,20235,5006,20657,175,20482,4584,223,4361,23143,18138,5005,14442,9748,4694,4168,789,223,9262
2/1/2014,VA,Virginia,Norfolk City,51710,29709,24191,5518,23509,252,23257,6200,327,5873,26829,21311,5518,16904,11912,4992,6555,1201,292,8856
2/1/2014,VA,Virginia,Northampton,51131,3282,2900,382,2778,35,2743,504,32,472,3085,2703,382,2411,2070,341,899,101,33,1378
2/1/2014,VA,Virginia,Northumberland,51133,4429,4007,422,4084,12,4072,345,*,*,4165,3743,422,2577,2281,296,420,90,30,2037
2/1/2014,VA,Virginia,Norton City,51720,1163,889,274,731,*,*,432,*,*,1070,796,274,830,572,258,353,51,22,404
2/1/2014,VA,Virginia,Nottoway,51135,3495,3040,455,2843,26,2817,652,14,638,3222,2767,455,2432,2135,297,895,126,47,1364
2/1/2014,VA,Virginia,Orange,51137,7907,7131,776,6916,41,6875,991,32,959,7285,6510,775,4468,3825,643,899,236,63,3270
2/1/2014,VA,Virginia,Page,51139,5656,5004,652,4583,21,4562,1073,14,1059,5298,4646,652,3735,3150,585,1070,205,93,2367
2/1/2014,VA,Virginia,Patrick,51141,4920,3802,1118,3993,15,3978,927,12,915,4700,3583,1117,3712,2792,920,987,183,82,2460
2/1/2014,VA,Virginia,Petersburg City,51730,6971,5926,1045,5070,82,4988,1901,83,1818,6359,5314,1045,4483,3522,961,1999,334,84,2066
2/1/2014,VA,Virginia,Pittsylvania,51143,14933,12403,2530,11999,98,11901,2934,81,2853,14168,11638,2530,11412,9168,2244,3054,574,222,7562
2/1/2014,VA,Virginia,Poquoson City,51735,2332,2093,239,2150,*,*,182,*,*,2127,1888,239,986,776,210,104,22,12,848
2/1/2014,VA,Virginia,Portsmouth City,51740,16911,13707,3204,13092,183,12909,3819,214,3605,15110,11906,3204,9197,6273,2924,3505,694,159,4839
2/1/2014,VA,Virginia,Powhatan,51145,4978,4065,913,4375,23,4352,603,19,584,4516,3603,913,3346,2524,822,370,91,33,2852
2/1/2014,VA,Virginia,Prince Edward,51147,4315,3718,597,3394,27,3367,921,30,891,4023,3426,597,3046,2583,463,1039,175,47,1785
2/1/2014,VA,Virginia,Prince George,51149,5064,4514,550,4235,27,4208,829,26,803,4678,4128,550,2650,2139,511,521,114,25,1990
2/1/2014,VA,Virginia,Prince William,51153,38350,33157,5193,33802,201,33601,4548,286,4262,32724,27536,5188,17593,12793,4800,4124,841,207,12421
2/1/2014,VA,Virginia,Pulaski,51155,8500,7226,1274,6580,32,6548,1920,26,1894,7962,6688,1274,6007,4807,1200,1611,325,118,3953
2/1/2014,VA,Virginia,Radford City,51750,1973,1662,311,1589,*,*,384,*,*,1813,1502,311,1466,1169,297,316,41,29,1080
2/1/2014,VA,Virginia,Rappahannock,51157,1790,1652,138,1635,*,*,155,*,*,1618,1480,138,998,883,115,146,37,11,804
2/1/2014,VA,Virginia,Richmond,51159,1784,1515,269,1541,17,1524,243,*,*,1683,1414,269,1185,959,226,276,84,23,802
2/1/2014,VA,Virginia,Richmond City,51760,30741,23539,7202,23519,306,23213,7222,354,6868,27716,20515,7201,21983,15134,6849,7912,1394,328,12349
2/1/2014,VA,Virginia,Roanoke,51161,21166,17577,3589,18541,90,18451,2625,48,2577,19624,16035,3589,14173,10826,3347,1878,396,129,11770
2/1/2014,VA,Virginia,Roanoke City,51770,19051,15298,3753,14046,126,13920,5005,137,4868,17462,13710,3752,13413,9833,3580,4442,767,236,7968
2/1/2014,VA,Virginia,Rockbridge,51163,5450,4617,833,4565,22,4543,885,12,873,5110,4277,833,3677,3165,512,817,168,65,2627
2/1/2014,VA,Virginia,Rockingham,51165,15323,13156,2167,13316,54,13262,2007,51,1956,14222,12056,2166,10424,8934,1490,1697,434,146,8147
2/1/2014,VA,Virginia,Russell,51167,7565,5397,2168,4916,14,4902,2649,13,2636,7218,5050,2168,5973,4227,1746,1665,294,120,3894
2/1/2014,VA,Virginia,Salem City,51775,5682,4841,841,4770,31,4739,912,19,893,5217,4376,841,3898,3111,787,780,133,47,2938
2/1/2014,VA,Virginia,Scott,51169,6405,3368,3037,4722,13,4709,1683,11,1672,6132,3095,3037,5218,2244,2974,1521,236,110,3351
2/1/2014,VA,Virginia,Shenandoah,51171,9499,8425,1074,8304,20,8284,1195,26,1169,8910,7836,1074,5876,4970,906,1202,230,97,4347
2/1/2014,VA,Virginia,Smyth,51173,8538,6897,1641,6202,22,6180,2336,24,2312,8070,6429,1641,6344,4847,1497,2093,388,154,3709
2/1/2014,VA,Virginia,Southampton,51175,3728,3296,432,3095,26,3069,633,22,611,3467,3035,432,2638,2271,367,677,132,39,1790
2/1/2014,VA,Virginia,Spotsylvania,51177,16980,15245,1735,14569,98,14471,2411,90,2321,15105,13371,1734,8657,7137,1520,1634,494,117,6412
2/1/2014,VA,Virginia,Stafford,51179,13599,12524,1075,11841,71,11770,1758,86,1672,11916,10842,1074,5761,4835,926,1153,312,75,4221
2/1/2014,VA,Virginia,Staunton City,51790,5733,5136,597,4665,26,4639,1068,27,1041,5402,4805,597,4111,3620,491,1036,150,55,2870
2/1/2014,VA,Virginia,Suffolk City,51800,13634,11416,2218,10988,83,10905,2646,79,2567,12437,10221,2216,8184,6303,1881,2544,397,106,5137
2/1/2014,VA,Virginia,Surry,51181,1401,1108,293,1168,*,*,233,11,222,1294,1001,293,919,645,274,201,68,11,639
2/1/2014,VA,Virginia,Sussex,51183,2281,1907,374,1827,35,1792,454,*,*,2111,1737,374,1587,1233,354,494,147,28,918
2/1/2014,VA,Virginia,Tazewell,51185,11383,8365,3018,8134,34,8100,3249,37,3212,10805,7788,3017,8232,6334,1898,2168,426,159,5479
2/1/2014,VA,Virginia,Unknown,51999,*,*,*,*,*,*,*,*,*,*,*,*,*,*,*,*,*,*,*
2/1/2014,VA,Virginia,Virginia Beach City,51810,60642,52582,8060,53109,324,52785,7533,315,7218,55350,47295,8055,29156,22015,7141,5875,1217,345,21719
2/1/2014,VA,Virginia,Warren,51187,6485,5877,608,5495,24,5471,990,26,964,5939,5331,608,3722,3194,528,789,214,71,2648
2/1/2014,VA,Virginia,Washington,51191,14082,9897,4185,10965,53,10912,3117,14,3103,13259,9076,4183,10315,6466,3849,2454,504,181,7176
2/1/2014,VA,Virginia,Waynesboro City,51820,4614,4099,515,3749,20,3729,865,21,844,4333,3818,515,3317,2883,434,861,99,43,2314
2/1/2014,VA,Virginia,Westmoreland,51193,4499,4093,406,3935,25,3910,564,15,549,4149,3743,406,2497,2143,354,745,121,41,1590
2/1/2014,VA,Virginia,Williamsburg City,51830,2269,1989,280,2083,*,*,186,*,*,2061,1781,280,1355,1117,238,182,*,*,1131
2/1/2014,VA,Virginia,Winchester City,51840,4786,4282,504,4071,16,4055,715,19,696,4373,3869,504,3019,2574,445,775,134,45,2065
2/1/2014,VA,Virginia,Wise,51195,10190,7090,3100,6590,15,6575,3600,18,3582,9589,6490,3099,7340,4481,2859,2369,490,165,4316
2/1/2014,VA,Virginia,Wythe,51197,7174,5822,1352,5483,21,5462,1691,25,1666,6786,5434,1352,5166,3994,1172,1498,271,96,3301
2/1/2014,VA,Virginia,York,51199,10222,9148,1074,9343,40,9303,879,31,848,9289,8218,1071,4621,3629,992,584,160,44,3833
1/1/2014,VA,Virginia,Accomack,51001,8108,7062,1046,6867,50,6817,1241,43,1198,7563,6518,1045,5326,4425,901,1507,348,86,3385
1/1/2014,VA,Virginia,Albemarle,51003,17002,15474,1528,15498,64,15434,1504,55,1449,15345,13817,1528,11027,9670,1357,1460,249,92,9226
1/1/2014,VA,Virginia,Alexandria City,51510,15133,13665,1468,13771,93,13678,1362,86,1276,12238,10773,1465,6587,5216,1371,1828,364,63,4332
1/1/2014,VA,Virginia,Alleghany,51005,4406,3935,471,3532,24,3508,874,11,863,4176,3705,471,3219,2887,332,804,96,50,2269
1/1/2014,VA,Virginia,Amelia,51007,2740,2228,512,2267,*,*,473,11,462,2525,2013,512,1880,1408,472,455,79,32,1314
1/1/2014,VA,Virginia,Amherst,51009,7120,6051,1069,5846,51,5795,1274,36,1238,6645,5576,1069,5195,4209,986,1131,214,84,3766
1/1/2014,VA,Virginia,Appomattox,51011,3572,3054,518,2889,25,2864,683,14,669,3349,2831,518,2624,2147,477,678,99,54,1793
1/1/2014,VA,Virginia,Arlington,51013,21117,19063,2054,19511,74,19437,1606,75,1531,16954,14901,2053,9199,7294,1905,2737,311,118,6033
1/1/2014,VA,Virginia,Augusta,51015,16072,14012,2060,13691,60,13631,2381,42,2339,15055,12995,2060,10986,9333,1653,1783,369,139,8695
1/1/2014,VA,Virginia,Bath,51017,1234,1155,79,1074,*,*,160,*,*,1165,1086,79,906,842,64,200,35,26,645
1/1/2014,VA,Virginia,Bedford,51019,17259,14534,2725,14581,70,14511,2678,52,2626,16082,13360,2722,11954,9734,2220,1922,437,162,9433
1/1/2014,VA,Virginia,Bland,51021,1680,1342,338,1289,*,*,391,*,*,1595,1258,337,1157,899,258,233,57,19,848
1/1/2014,VA,Virginia,Botetourt,51023,7591,6089,1502,6480,31,6449,1111,13,1098,7012,5510,1502,5143,3810,1333,812,158,63,4110
1/1/2014,VA,Virginia,Bristol City,51520,4451,2745,1706,3429,12,3417,1022,*,*,4190,2484,1706,3404,1750,1654,1001,153,52,2198
1/1/2014,VA,Virginia,Brunswick,51025,3721,3192,529,3008,21,2987,713,33,680,3506,2977,529,2706,2243,463,1032,116,39,1519
1/1/2014,VA,Virginia,Buchanan,51027,7416,4755,2661,4429,19,4410,2987,14,2973,7077,4417,2660,5690,3857,1833,1552,452,122,3564
1/1/2014,VA,Virginia,Buckingham,51029,3158,2741,417,2521,14,2507,637,14,623,2936,2519,417,2199,1849,350,684,149,50,1316
1/1/2014,VA,Virginia,Buena Vista City,51530,1394,1168,226,1113,*,*,281,*,*,1300,1074,226,999,824,175,318,55,19,607
1/1/2014,VA,Virginia,Campbell,51031,11704,9946,1758,9578,71,9507,2126,63,2063,10986,9228,1758,8542,6933,1609,1953,374,188,6027
1/1/2014,VA,Virginia,Caroline,51033,5048,4326,722,4188,36,4152,860,37,823,4560,3838,722,2989,2326,663,721,233,51,1984
1/1/2014,VA,Virginia,Carroll,51035,7567,6535,1032,5991,20,5971,1576,18,1558,7189,6157,1032,5502,4712,790,1657,285,123,3437
1/1/2014,VA,Virginia,Charles City,51036,1637,1291,346,1372,16,1356,265,14,251,1515,1169,346,1100,845,255,241,73,18,768
1/1/2014,VA,Virginia,Charlotte,51037,3188,2736,452,2585,20,2565,603,12,591,3013,2561,452,2310,1909,401,762,132,43,1373
1/1/2014,VA,Virginia,Charlottesville City,51540,5716,5261,455,4588,23,4565,1128,48,1080,5128,4674,454,4001,3571,430,1196,151,60,2594
1/1/2014,VA,Virginia,Chesapeake City,51550,31807,26724,5083,27020,236,26784,4787,235,4552,28682,23600,5082,16424,11947,4477,3593,823,228,11780
1/1/2014,VA,Virginia,Chesterfield,51041,48482,38836,9646,41655,197,41458,6827,209,6618,43575,33930,9645,31030,22186,8844,4468,898,286,25378
1/1/2014,VA,Virginia,Clarke,51043,2715,2411,304,2475,12,2463,240,*,*,2450,2146,304,1561,1296,265,247,72,29,1213
1/1/2014,VA,Virginia,Colonial Heights City,51570,4018,3575,443,3486,15,3471,532,13,519,3684,3241,443,2172,1766,406,418,91,16,1647
1/1/2014,VA,Virginia,Covington City,51580,1671,1516,155,1286,*,*,385,*,*,1555,1400,155,1201,1058,143,342,59,18,782
1/1/2014,VA,Virginia,Craig,51045,1227,1000,227,932,*,*,295,*,*,1119,892,227,850,629,221,190,43,18,599
1/1/2014,VA,Virginia,Culpeper,51047,7984,7016,968,6808,49,6759,1176,41,1135,7272,6304,968,4761,3930,831,1061,233,75,3392
1/1/2014,VA,Virginia,Cumberland,51049,2059,1697,362,1702,13,1689,357,11,346,1918,1557,361,1446,1116,330,397,79,28,942
1/1/2014,VA,Virginia,Danville City,51590,10923,9205,1718,8556,83,8473,2367,113,2254,10366,8648,1718,8408,7198,1210,3047,443,168,4750
1/1/2014,VA,Virginia,Dickenson,51051,4673,3249,1424,2809,*,*,1864,11,1853,4458,3034,1424,3528,2298,1230,1085,221,102,2120
1/1/2014,VA,Virginia,Dinwiddie,51053,5221,4413,808,4140,40,4100,1081,31,1050,4780,3972,808,3364,2590,774,870,169,47,2278
1/1/2014,VA,Virginia,Emporia City,51595,1185,968,217,894,15,879,291,13,278,1113,896,217,903,739,164,434,64,17,388
1/1/2014,VA,Virginia,Essex,51057,2602,2241,361,2210,14,2196,392,12,380,2433,2072,361,1758,1446,312,411,84,19,1244
1/1/2014,VA,Virginia,Fairfax,51059,126552,111679,14873,118664,504,118160,7888,394,7494,102566,87714,14852,53024,39228,13796,12037,2326,446,38215
1/1/2014,VA,Virginia,Fairfax City,51600,3372,2945,427,3102,17,3085,270,*,*,2848,2421,427,1533,1136,397,362,52,11,1108
1/1/2014,VA,Virginia,Falls Church City,51610,1636,1460,176,1540,*,*,96,*,*,1301,1126,175,711,552,159,140,*,*,546
1/1/2014,VA,Virginia,Fauquier,51061,10520,9507,1013,9492,57,9435,1028,38,990,9268,8256,1012,5386,4530,856,799,187,62,4338
1/1/2014,VA,Virginia,Floyd,51063,3601,2976,625,3059,11,3048,542,*,*,3357,2732,625,2548,1977,571,520,91,44,1893
1/1/2014,VA,Virginia,Fluvanna,51065,5053,4497,556,4509,23,4486,544,21,523,4655,4099,556,3210,2731,479,438,112,21,2639
1/1/2014,VA,Virginia,Franklin,51067,13151,10088,3063,10742,48,10694,2409,27,2382,12318,9255,3063,9577,6776,2801,1908,427,157,7085
1/1/2014,VA,Virginia,Franklin City,51620,1831,1643,188,1408,*,*,423,20,403,1717,1529,188,1352,1191,161,493,82,18,759
1/1/2014,VA,Virginia,Frederick,51069,13633,12032,1601,11967,47,11920,1666,42,1624,12437,10838,1599,8030,6630,1400,1323,339,132,6236
1/1/2014,VA,Virginia,Fredericksburg City,51630,3587,3289,298,2915,17,2898,672,28,644,3249,2951,298,2106,1828,278,711,89,39,1267
1/1/2014,VA,Virginia,Galax City,51640,1955,1837,118,1501,*,*,454,11,443,1871,1753,118,1449,1356,93,676,68,32,673
1/1/2014,VA,Virginia,Giles,51071,4365,3463,902,3404,19,3385,961,14,947,4100,3199,901,3148,2326,822,767,135,34,2212
1/1/2014,VA,Virginia,Gloucester,51073,7397,6400,997,6335,38,6297,1062,18,1044,6795,5798,997,4100,3241,859,862,171,69,2998
1/1/2014,VA,Virginia,Goochland,51075,4688,3870,818,4217,20,4197,471,16,455,4222,3404,818,3198,2471,727,399,104,38,2657
1/1/2014,VA,Virginia,Grayson,51077,4391,3910,481,3565,17,3548,826,*,*,4227,3746,481,3069,2659,410,978,171,80,1840
1/1/2014,VA,Virginia,Greene,51079,3203,2851,352,2779,15,2764,424,11,413,2948,2596,352,2040,1714,326,411,78,23,1528
1/1/2014,VA,Virginia,Greensville,51081,2279,1736,543,1815,20,1795,464,21,443,2122,1579,543,1749,1274,475,530,129,26,1064
1/1/2014,VA,Virginia,Halifax,51083,9117,7891,1226,7293,61,7232,1824,60,1764,8575,7350,1225,6820,5690,1130,2172,421,136,4091
1/1/2014,VA,Virginia,Hampton City,51650,22546,18504,4042,18372,206,18166,4174,195,3979,20634,16592,4042,11676,7978,3698,3261,736,196,7483
1/1/2014,VA,Virginia,Hanover,51085,17470,14043,3427,15673,73,15600,1797,46,1751,15934,12507,3427,11727,8734,2993,1313,343,97,9974
1/1/2014,VA,Virginia,Harrisonburg City,51660,4834,4351,483,4065,20,4045,769,19,750,4434,3951,483,3349,2995,354,851,121,50,2327
1/1/2014,VA,Virginia,Henrico,51087,48460,38236,10224,41924,324,41600,6536,298,6238,43978,33756,10222,32622,23427,9195,5338,1256,375,25653
1/1/2014,VA,Virginia,Henry,51089,14625,10564,4061,11433,72,11361,3192,69,3123,13976,9915,4061,11664,8583,3081,3035,674,228,7727
1/1/2014,VA,Virginia,Highland,51091,686,625,61,624,*,*,62,0,62,642,581,61,460,404,56,68,*,*,363
1/1/2014,VA,Virginia,Hopewell City,51670,4287,3740,547,3340,25,3315,947,36,911,3984,3437,547,2601,2072,529,872,140,41,1548
1/1/2014,VA,Virginia,Isle of Wight,51093,6974,5607,1367,6041,41,6000,933,31,902,6474,5107,1367,4443,3154,1289,839,185,81,3338
1/1/2014,VA,Virginia,James City,51095,17223,15458,1765,16141,54,16087,1082,40,1042,15899,14137,1762,9081,7558,1523,794,183,47,8057
1/1/2014,VA,Virginia,King and Queen,51097,1561,1369,192,1300,*,*,261,*,*,1466,1274,192,1075,902,173,252,77,11,735
1/1/2014,VA,Virginia,King George,51099,3213,2984,229,2745,19,2726,468,19,449,2796,2567,229,1365,1151,214,408,80,21,856
1/1/2014,VA,Virginia,King William,51101,2821,2498,323,2414,20,2394,407,19,388,2595,2272,323,1979,1707,272,357,84,20,1518
1/1/2014,VA,Virginia,Lancaster,51103,4092,3645,447,3762,16,3746,330,16,314,3890,3443,447,2574,2249,325,470,79,32,1993
1/1/2014,VA,Virginia,Lee,51105,6224,4309,1915,4097,16,4081,2127,16,2111,5894,3982,1912,4617,2842,1775,1888,252,78,2399
1/1/2014,VA,Virginia,Lexington City,51678,1576,1455,121,1437,12,1425,139,*,*,1474,1353,121,1086,996,90,208,36,12,830
1/1/2014,VA,Virginia,Loudoun,51107,27935,23962,3973,25869,96,25773,2066,101,1965,23189,19220,3969,13691,10036,3655,2340,518,121,10712
1/1/2014,VA,Virginia,Louisa,51109,6678,5724,954,5550,37,5513,1128,29,1099,6117,5163,954,4298,3417,881,1007,251,75,2965
1/1/2014,VA,Virginia,Lunenburg,51111,2820,2504,316,2274,16,2258,546,21,525,2606,2290,316,1903,1611,292,657,117,38,1091
1/1/2014,VA,Virginia,Lynchburg City,51680,14110,12217,1893,11096,85,11011,3014,106,2908,13160,11267,1893,10362,8641,1721,3240,445,148,6529
1/1/2014,VA,Virginia,Madison,51113,2684,2387,297,2347,*,*,337,*,*,2516,2219,297,1779,1505,274,402,73,24,1280
1/1/2014,VA,Virginia,Manassas City,51683,3725,3222,503,3225,21,3204,500,30,470,3209,2707,502,2153,1675,478,492,99,27,1535
1/1/2014,VA,Virginia,Manassas Park City,51685,1023,860,163,873,*,*,150,11,139,870,707,163,568,419,149,134,*,*,388
1/1/2014,VA,Virginia,Martinsville City,51690,3904,3064,840,2909,22,2887,995,35,960,3719,2879,840,3175,2532,643,1285,171,60,1659
1/1/2014,VA,Virginia,Mathews,51115,2608,2302,306,2372,*,*,236,*,*,2467,2161,306,1533,1266,267,239,47,19,1228
1/1/2014,VA,Virginia,Mecklenburg,51117,8678,7246,1432,7083,55,7028,1595,56,1539,8189,6759,1430,6295,5151,1144,1851,384,110,3950
1/1/2014,VA,Virginia,Middlesex,51119,3316,2865,451,2957,18,2939,359,*,*,3113,2663,450,2234,1881,353,401,93,25,1715
1/1/2014,VA,Virginia,Montgomery,51121,12307,10522,1785,10036,31,10005,2271,30,2241,11246,9461,1785,8804,7126,1678,1741,297,115,6651
1/1/2014,VA,Virginia,Nelson,51125,3996,3572,424,3467,15,3452,529,15,514,3696,3272,424,2603,2221,382,589,106,41,1867
1/1/2014,VA,Virginia,New Kent,51127,3477,2913,564,3039,16,3023,438,11,427,3154,2590,564,2077,1623,454,266,76,24,1711
1/1/2014,VA,Virginia,Newport News City,51700,25206,20217,4989,20641,180,20461,4565,223,4342,23118,18130,4988,14421,9749,4672,4162,790,222,9247
1/1/2014,VA,Virginia,Norfolk City,51710,29668,24165,5503,23497,253,23244,6171,328,5843,26816,21313,5503,16892,11915,4977,6538,1200,290,8864
1/1/2014,VA,Virginia,Northampton,51131,3277,2894,383,2776,34,2742,501,31,470,3082,2699,383,2407,2065,342,893,100,33,1381
1/1/2014,VA,Virginia,Northumberland,51133,4411,3992,419,4072,12,4060,339,*,*,4147,3728,419,2566,2272,294,418,93,29,2026
1/1/2014,VA,Virginia,Norton City,51720,1167,894,273,735,*,*,432,*,*,1073,800,273,834,577,257,354,51,23,406
1/1/2014,VA,Virginia,Nottoway,51135,3488,3039,449,2841,26,2815,647,14,633,3221,2772,449,2424,2131,293,894,125,45,1360
1/1/2014,VA,Virginia,Orange,51137,7890,7117,773,6904,42,6862,986,31,955,7277,6505,772,4459,3820,639,893,238,64,3264
1/1/2014,VA,Virginia,Page,51139,5656,5001,655,4590,22,4568,1066,14,1052,5296,4641,655,3723,3135,588,1059,209,94,2361
1/1/2014,VA,Virginia,Patrick,51141,4921,3802,1119,3998,15,3983,923,12,911,4701,3583,1118,3718,2796,922,984,188,80,2466
1/1/2014,VA,Virginia,Petersburg City,51730,6970,5929,1041,5075,82,4993,1895,84,1811,6356,5315,1041,4477,3525,952,1997,333,85,2062
1/1/2014,VA,Virginia,Pittsylvania,51143,14912,12407,2505,12003,98,11905,2909,82,2827,14149,11644,2505,11382,9167,2215,3034,566,221,7561
1/1/2014,VA,Virginia,Poquoson City,51735,2320,2080,240,2142,*,*,178,*,*,2122,1882,240,985,774,211,104,22,12,847
1/1/2014,VA,Virginia,Portsmouth City,51740,16877,13693,3184,13080,185,12895,3797,213,3584,15086,11902,3184,9153,6249,2904,3484,691,158,4820
1/1/2014,VA,Virginia,Powhatan,51145,4972,4060,912,4371,23,4348,601,19,582,4514,3602,912,3336,2516,820,371,91,33,2841
1/1/2014,VA,Virginia,Prince Edward,51147,4304,3708,596,3388,28,3360,916,30,886,4012,3416,596,3039,2575,464,1034,175,47,1783
1/1/2014,VA,Virginia,Prince George,51149,5051,4502,549,4226,27,4199,825,26,799,4665,4116,549,2634,2125,509,519,110,24,1981
1/1/2014,VA,Virginia,Prince William,51153,38191,33012,5179,33674,204,33470,4517,287,4230,32600,27426,5174,17525,12744,4781,4067,860,207,12391
1/1/2014,VA,Virginia,Pulaski,51155,8498,7227,1271,6590,33,6557,1908,25,1883,7955,6684,1271,6012,4816,1196,1606,325,123,3958
1/1/2014,VA,Virginia,Radford City,51750,1972,1665,307,1592,11,1581,380,*,*,1816,1509,307,1463,1170,293,312,42,31,1078
1/1/2014,VA,Virginia,Rappahannock,51157,1786,1648,138,1631,*,*,155,*,*,1614,1476,138,995,880,115,143,37,11,804
1/1/2014,VA,Virginia,Richmond,51159,1786,1518,268,1543,17,1526,243,*,*,1686,1418,268,1188,964,224,273,86,24,805
1/1/2014,VA,Virginia,Richmond City,51760,30708,23507,7201,23518,312,23206,7190,354,6836,27710,20510,7200,21962,15127,6835,7894,1383,328,12357
1/1/2014,VA,Virginia,Roanoke,51161,21145,17569,3576,18538,92,18446,2607,47,2560,19599,16023,3576,14116,10783,3333,1867,403,128,11718
1/1/2014,VA,Virginia,Roanoke City,51770,19035,15278,3757,14048,127,13921,4987,140,4847,17451,13695,3756,13368,9787,3581,4410,764,235,7959
1/1/2014,VA,Virginia,Rockbridge,51163,5452,4630,822,4571,22,4549,881,12,869,5115,4293,822,3677,3166,511,815,168,65,2629
1/1/2014,VA,Virginia,Rockingham,51165,15322,13168,2154,13325,59,13266,1997,52,1945,14229,12076,2153,10402,8920,1482,1691,430,146,8135
1/1/2014,VA,Virginia,Russell,51167,7557,5388,2169,4917,14,4903,2640,14,2626,7212,5043,2169,5981,4232,1749,1662,297,116,3906
1/1/2014,VA,Virginia,Salem City,51775,5690,4841,849,4778,32,4746,912,19,893,5222,4373,849,3893,3097,796,779,137,46,2931
1/1/2014,VA,Virginia,Scott,51169,6405,3356,3049,4726,14,4712,1679,11,1668,6138,3089,3049,5229,2244,2985,1523,238,109,3359
1/1/2014,VA,Virginia,Shenandoah,51171,9503,8432,1071,8309,20,8289,1194,26,1168,8918,7847,1071,5881,4977,904,1206,228,97,4350
1/1/2014,VA,Virginia,Smyth,51173,8533,6895,1638,6201,22,6179,2332,26,2306,8073,6435,1638,6336,4845,1491,2086,388,152,3710
1/1/2014,VA,Virginia,Southampton,51175,3727,3294,433,3099,27,3072,628,22,606,3464,3031,433,2632,2265,367,677,134,37,1784
1/1/2014,VA,Virginia,Spotsylvania,51177,16923,15183,1740,14531,98,14433,2392,90,2302,15074,13335,1739,8631,7106,1525,1610,493,119,6409
1/1/2014,VA,Virginia,Stafford,51179,13560,12492,1068,11817,76,11741,1743,86,1657,11877,10810,1067,5753,4833,920,1142,315,76,4220
1/1/2014,VA,Virginia,Staunton City,51790,5740,5143,597,4675,26,4649,1065,27,1038,5409,4812,597,4105,3615,490,1032,150,55,2868
1/1/2014,VA,Virginia,Suffolk City,51800,13617,11395,2222,10983,84,10899,2634,81,2553,12431,10211,2220,8168,6288,1880,2530,399,105,5134
1/1/2014,VA,Virginia,Surry,51181,1398,1103,295,1165,*,*,233,11,222,1288,993,295,915,639,276,199,68,11,637
1/1/2014,VA,Virginia,Sussex,51183,2281,1903,378,1826,36,1790,455,*,*,2111,1733,378,1586,1228,358,493,146,28,919
1/1/2014,VA,Virginia,Tazewell,51185,11398,8379,3019,8155,35,8120,3243,37,3206,10823,7805,3018,8239,6344,1895,2168,433,161,5477
1/1/2014,VA,Virginia,Unknown,51999,*,*,*,*,*,*,*,*,*,*,*,*,*,*,*,*,*,*,*
1/1/2014,VA,Virginia,Virginia Beach City,51810,60511,52483,8028,53040,333,52707,7471,313,7158,55259,47236,8023,29062,21958,7104,5828,1205,348,21681
1/1/2014,VA,Virginia,Warren,51187,6471,5857,614,5490,24,5466,981,25,956,5933,5319,614,3718,3186,532,783,211,71,2653
1/1/2014,VA,Virginia,Washington,51191,14057,9880,4177,10958,55,10903,3099,14,3085,13227,9052,4175,10273,6436,3837,2442,510,181,7140
1/1/2014,VA,Virginia,Waynesboro City,51820,4622,4104,518,3759,21,3738,863,21,842,4333,3815,518,3324,2887,437,865,100,43,2316
1/1/2014,VA,Virginia,Westmoreland,51193,4489,4085,404,3928,25,3903,561,15,546,4143,3739,404,2483,2132,351,740,121,41,1581
1/1/2014,VA,Virginia,Williamsburg City,51830,2263,1985,278,2079,*,*,184,*,*,2051,1773,278,1341,1104,237,180,*,*,1120
1/1/2014,VA,Virginia,Winchester City,51840,4791,4283,508,4079,16,4063,712,19,693,4377,3869,508,3022,2573,449,777,135,46,2064
1/1/2014,VA,Virginia,Wise,51195,10191,7088,3103,6591,15,6576,3600,18,3582,9593,6491,3102,7343,4483,2860,2359,498,167,4319
1/1/2014,VA,Virginia,Wythe,51197,7179,5823,1356,5493,21,5472,1686,24,1662,6790,5434,1356,5177,4004,1173,1494,273,95,3315
1/1/2014,VA,Virginia,York,51199,10203,9141,1062,9329,42,9287,874,30,844,9277,8218,1059,4604,3626,978,580,157,46,3821
7/1/2014,VA,Virginia,Accomack,51001,8177,7070,1107,6881,46,6835,1296,44,1252,7640,6534,1106,5405,4445,960,1540,347,89,3429
7/1/2014,VA,Virginia,Albemarle,51003,17289,15737,1552,15723,62,15661,1566,55,1511,15606,14054,1552,11247,9867,1380,1488,254,82,9423
7/1/2014,VA,Virginia,Alexandria City,51510,15531,14020,1511,14148,85,14063,1383,87,1296,12570,11062,1508,6695,5277,1418,1866,353,59,4417
7/1/2014,VA,Virginia,Alleghany,51005,4401,3913,488,3502,20,3482,899,*,*,4178,3690,488,3225,2875,350,831,92,43,2259
7/1/2014,VA,Virginia,Amelia,51007,2783,2257,526,2296,*,*,487,11,476,2572,2046,526,1908,1426,482,469,73,35,1331
7/1/2014,VA,Virginia,Amherst,51009,7214,6147,1067,5903,47,5856,1311,35,1276,6728,5661,1067,5260,4272,988,1181,213,74,3792
7/1/2014,VA,Virginia,Appomattox,51011,3592,3075,517,2892,22,2870,700,14,686,3378,2861,517,2643,2166,477,682,102,52,1807
7/1/2014,VA,Virginia,Arlington,51013,21526,19372,2154,19863,70,19793,1663,76,1587,17281,15128,2153,9344,7344,2000,2808,318,115,6103
7/1/2014,VA,Virginia,Augusta,51015,16288,14213,2075,13844,54,13790,2444,41,2403,15278,13203,2075,11114,9432,1682,1828,362,137,8787
7/1/2014,VA,Virginia,Bath,51017,1250,1173,77,1083,*,*,167,*,*,1175,1098,77,906,843,63,201,33,23,649
7/1/2014,VA,Virginia,Bedford,51019,17539,14765,2774,14769,64,14705,2770,49,2721,16377,13606,2771,12288,10003,2285,1997,435,150,9706
7/1/2014,VA,Virginia,Bland,51021,1709,1377,332,1311,*,*,398,*,*,1619,1288,331,1177,923,254,241,59,19,858
7/1/2014,VA,Virginia,Botetourt,51023,7681,6138,1543,6551,29,6522,1130,13,1117,7087,5544,1543,5376,4001,1375,822,152,61,4341
7/1/2014,VA,Virginia,Bristol City,51520,4452,2753,1699,3404,11,3393,1048,*,*,4193,2494,1699,3410,1759,1651,1026,151,55,2178
7/1/2014,VA,Virginia,Brunswick,51025,3764,3226,538,3025,20,3005,739,31,708,3550,3012,538,2745,2269,476,1073,113,36,1523
7/1/2014,VA,Virginia,Buchanan,51027,7394,4729,2665,4384,16,4368,3010,15,2995,7089,4425,2664,5713,3868,1845,1596,444,118,3555
7/1/2014,VA,Virginia,Buckingham,51029,3219,2792,427,2559,13,2546,660,14,646,2996,2569,427,2236,1875,361,704,145,49,1338
7/1/2014,VA,Virginia,Buena Vista City,51530,1400,1168,232,1109,*,*,291,*,*,1309,1077,232,1010,826,184,332,54,19,605
7/1/2014,VA,Virginia,Campbell,51031,11795,10029,1766,9602,68,9534,2193,65,2128,11076,9310,1766,8642,7023,1619,1998,366,169,6109
7/1/2014,VA,Virginia,Caroline,51033,5128,4394,734,4232,35,4197,896,37,859,4662,3928,734,3016,2339,677,748,228,50,1990
7/1/2014,VA,Virginia,Carroll,51035,7633,6603,1030,6010,18,5992,1623,17,1606,7248,6218,1030,5531,4739,792,1686,287,114,3444
7/1/2014,VA,Virginia,Charles City,51036,1671,1313,358,1394,15,1379,277,14,263,1553,1195,358,1133,864,269,252,72,17,792
7/1/2014,VA,Virginia,Charlotte,51037,3189,2741,448,2569,19,2550,620,11,609,3014,2566,448,2308,1909,399,775,128,52,1353
7/1/2014,VA,Virginia,Charlottesville City,51540,5798,5342,456,4634,21,4613,1164,49,1115,5204,4749,455,4065,3633,432,1237,148,61,2619
7/1/2014,VA,Virginia,Chesapeake City,51550,32418,26444,5974,27434,219,27215,4984,234,4750,29228,23255,5973,16834,11432,5402,3779,820,213,12022
7/1/2014,VA,Virginia,Chesterfield,51041,49445,39511,9934,42424,176,42248,7021,208,6813,44463,34530,9933,31830,22677,9153,4602,896,270,26062
7/1/2014,VA,Virginia,Clarke,51043,2766,2501,265,2512,11,2501,254,*,*,2496,2231,265,1581,1355,226,255,70,29,1227
7/1/2014,VA,Virginia,Colonial Heights City,51570,4011,3554,457,3468,12,3456,543,15,528,3682,3225,457,2168,1747,421,418,91,16,1643
7/1/2014,VA,Virginia,Covington City,51580,1690,1534,156,1292,*,*,398,*,*,1575,1419,156,1201,1057,144,358,54,17,772
7/1/2014,VA,Virginia,Craig,51045,1246,1017,229,939,*,*,307,*,*,1137,908,229,871,646,225,202,40,16,613
7/1/2014,VA,Virginia,Culpeper,51047,8081,7111,970,6865,44,6821,1216,40,1176,7376,6406,970,4811,3974,837,1095,229,75,3412
7/1/2014,VA,Virginia,Cumberland,51049,2087,1718,369,1715,11,1704,372,*,*,1942,1575,367,1461,1125,336,413,74,26,948
7/1/2014,VA,Virginia,Danville City,51590,10982,9272,1710,8552,74,8478,2430,113,2317,10430,8720,1710,8442,7233,1209,3121,420,166,4735
7/1/2014,VA,Virginia,Dickenson,51051,4693,3255,1438,2797,*,*,1896,11,1885,4478,3040,1438,3539,2288,1251,1117,220,97,2105
7/1/2014,VA,Virginia,Dinwiddie,51053,5312,4481,831,4182,37,4145,1130,30,1100,4875,4044,831,3418,2620,798,890,172,53,2303
7/1/2014,VA,Virginia,Emporia City,51595,1190,975,215,885,12,873,305,12,293,1123,908,215,900,733,167,444,61,16,379
7/1/2014,VA,Virginia,Essex,51057,2620,2245,375,2219,12,2207,401,11,390,2450,2075,375,1791,1462,329,427,86,24,1254
7/1/2014,VA,Virginia,Fairfax,51059,129990,114618,15372,121829,468,121361,8161,404,7757,105402,90055,15347,54420,40147,14273,12324,2376,428,39292
7/1/2014,VA,Virginia,Fairfax City,51600,3447,3008,439,3166,13,3153,281,*,*,2905,2466,439,1561,1148,413,362,53,14,1132
7/1/2014,VA,Virginia,Falls Church City,51610,1652,1469,183,1557,*,*,95,*,*,1306,1124,182,713,547,166,138,*,*,551
7/1/2014,VA,Virginia,Fauquier,51061,10727,9731,996,9629,48,9581,1098,39,1059,9484,8489,995,5487,4649,838,839,181,55,4412
7/1/2014,VA,Virginia,Floyd,51063,3663,3033,630,3097,*,*,566,*,*,3419,2789,630,2593,2019,574,529,90,44,1930
7/1/2014,VA,Virginia,Fluvanna,51065,5150,4584,566,4587,22,4565,563,24,539,4741,4175,566,3289,2799,490,455,116,20,2698
7/1/2014,VA,Virginia,Franklin,51067,13329,10197,3132,10846,43,10803,2483,25,2458,12518,9386,3132,9800,6930,2870,1954,425,149,7272
7/1/2014,VA,Virginia,Franklin City,51620,1852,1646,206,1412,*,*,440,19,421,1736,1530,206,1372,1192,180,515,78,15,764
7/1/2014,VA,Virginia,Frederick,51069,13769,12239,1530,12049,40,12009,1720,42,1678,12569,11041,1528,8104,6775,1329,1368,327,132,6277
7/1/2014,VA,Virginia,Fredericksburg City,51630,3646,3341,305,2952,16,2936,694,29,665,3300,2995,305,2126,1842,284,737,84,39,1266
7/1/2014,VA,Virginia,Galax City,51640,1947,1829,118,1487,*,*,460,11,449,1860,1742,118,1448,1355,93,669,68,31,680
7/1/2014,VA,Virginia,Giles,51071,4375,3442,933,3389,18,3371,986,12,974,4111,3179,932,3272,2415,857,781,130,34,2327
7/1/2014,VA,Virginia,Gloucester,51073,7521,6336,1185,6411,31,6380,1110,16,1094,6919,5734,1185,4184,3131,1053,899,170,61,3054
7/1/2014,VA,Virginia,Goochland,51075,4755,3917,838,4272,20,4252,483,17,466,4304,3466,838,3262,2514,748,400,98,33,2731
7/1/2014,VA,Virginia,Grayson,51077,4402,3925,477,3554,15,3539,848,*,*,4243,3766,477,3078,2666,412,988,178,79,1833
7/1/2014,VA,Virginia,Greene,51079,3250,2893,357,2807,13,2794,443,12,431,2995,2638,357,2069,1740,329,427,76,20,1546
7/1/2014,VA,Virginia,Greensville,51081,2309,1766,543,1827,18,1809,482,18,464,2150,1607,543,1748,1271,477,538,127,23,1060
7/1/2014,VA,Virginia,Halifax,51083,9183,7980,1203,7310,54,7256,1873,61,1812,8637,7435,1202,6844,5738,1106,2204,421,133,4086
7/1/2014,VA,Virginia,Hampton City,51650,22825,17955,4870,18515,197,18318,4310,209,4101,20914,16045,4869,11872,7322,4550,3410,739,186,7537
7/1/2014,VA,Virginia,Hanover,51085,17792,14289,3503,15935,63,15872,1857,44,1813,16221,12718,3503,12007,8934,3073,1354,328,97,10228
7/1/2014,VA,Virginia,Harrisonburg City,51660,4917,4431,486,4104,17,4087,813,20,793,4510,4024,486,3423,3065,358,905,119,45,2354
7/1/2014,VA,Virginia,Henrico,51087,49078,38513,10565,42306,300,42006,6772,293,6479,44573,34010,10563,33247,23691,9556,5558,1215,362,26112
7/1/2014,VA,Virginia,Henry,51089,14743,10699,4044,11458,64,11394,3285,66,3219,14081,10037,4044,11727,8628,3099,3122,653,229,7723
7/1/2014,VA,Virginia,Highland,51091,691,628,63,627,*,*,64,0,64,649,586,63,465,408,57,68,*,*,368
7/1/2014,VA,Virginia,Hopewell City,51670,4303,3710,593,3328,23,3305,975,33,942,4014,3421,593,2613,2039,574,896,134,35,1548
7/1/2014,VA,Virginia,Isle of Wight,51093,7081,5526,1555,6120,37,6083,961,31,930,6578,5023,1555,4505,3027,1478,855,184,75,3391
7/1/2014,VA,Virginia,James City,51095,17441,15467,1974,16314,49,16265,1127,40,1087,16138,14167,1971,9279,7549,1730,819,181,42,8237
7/1/2014,VA,Virginia,King and Queen,51097,1589,1389,200,1314,*,*,275,*,*,1494,1294,200,1096,916,180,269,76,11,740
7/1/2014,VA,Virginia,King George,51099,3266,3036,230,2780,16,2764,486,21,465,2847,2617,230,1381,1168,213,419,81,22,859
7/1/2014,VA,Virginia,King William,51101,2868,2507,361,2445,15,2430,423,22,401,2644,2283,361,2024,1715,309,366,80,21,1557
7/1/2014,VA,Virginia,Lancaster,51103,4100,3643,457,3751,15,3736,349,14,335,3919,3462,457,2618,2282,336,475,80,30,2033
7/1/2014,VA,Virginia,Lee,51105,6262,4326,1936,4098,14,4084,2164,16,2148,5938,4005,1933,4662,2863,1799,1935,248,79,2400
7/1/2014,VA,Virginia,Lexington City,51678,1576,1453,123,1432,12,1420,144,*,*,1480,1357,123,1102,1008,94,215,32,12,843
7/1/2014,VA,Virginia,Loudoun,51107,28699,25223,3476,26541,86,26455,2158,101,2057,23849,20377,3472,14094,10938,3156,2469,523,119,10983
7/1/2014,VA,Virginia,Louisa,51109,6802,5818,984,5621,35,5586,1181,32,1149,6255,5271,984,4387,3479,908,1025,246,68,3048
7/1/2014,VA,Virginia,Lunenburg,51111,2849,2522,327,2290,15,2275,559,22,537,2644,2317,327,1925,1622,303,676,119,37,1093
7/1/2014,VA,Virginia,Lynchburg City,51680,14168,12280,1888,11070,80,10990,3098,103,2995,13222,11335,1887,10433,8704,1729,3330,435,147,6521
7/1/2014,VA,Virginia,Madison,51113,2708,2418,290,2366,*,*,342,*,*,2536,2246,290,1782,1515,267,403,69,23,1287
7/1/2014,VA,Virginia,Manassas City,51683,3819,3298,521,3290,21,3269,529,33,496,3281,2761,520,2182,1687,495,510,98,29,1545
7/1/2014,VA,Virginia,Manassas Park City,51685,1055,894,161,901,*,*,154,11,143,893,732,161,576,428,148,147,*,*,385
7/1/2014,VA,Virginia,Martinsville City,51690,3916,3081,835,2911,21,2890,1005,35,970,3733,2898,835,3181,2541,640,1304,156,60,1661
7/1/2014,VA,Virginia,Mathews,51115,2640,2270,370,2397,*,*,243,*,*,2508,2138,370,1572,1238,334,248,49,19,1256
7/1/2014,VA,Virginia,Mecklenburg,51117,8770,7338,1432,7131,48,7083,1639,54,1585,8279,6849,1430,6350,5196,1154,1890,372,105,3983
7/1/2014,VA,Virginia,Middlesex,51119,3341,2879,462,2975,17,2958,366,*,*,3146,2685,461,2250,1886,364,413,90,20,1727
7/1/2014,VA,Virginia,Montgomery,51121,12497,10687,1810,10172,28,10144,2325,27,2298,11404,9594,1810,8938,7237,1701,1800,285,108,6745
7/1/2014,VA,Virginia,Nelson,51125,4075,3644,431,3523,14,3509,552,16,536,3768,3337,431,2662,2271,391,609,102,38,1913
7/1/2014,VA,Virginia,New Kent,51127,3562,2980,582,3111,14,3097,451,11,440,3250,2668,582,2154,1684,470,274,73,22,1785
7/1/2014,VA,Virginia,Newport News City,51700,25570,19542,6028,20864,163,20701,4706,226,4480,23465,17439,6026,14588,8856,5732,4309,751,216,9312
7/1/2014,VA,Virginia,Norfolk City,51710,30075,22867,7208,23659,230,23429,6416,338,6078,27216,20008,7208,17237,10504,6733,6730,1174,274,9059
7/1/2014,VA,Virginia,Northampton,51131,3308,2657,651,2791,31,2760,517,31,486,3119,2468,651,2435,1825,610,900,101,33,1401
7/1/2014,VA,Virginia,Northumberland,51133,4484,4047,437,4127,*,*,357,*,*,4215,3778,437,2596,2287,309,434,86,32,2044
7/1/2014,VA,Virginia,Norton City,51720,1176,892,284,736,*,*,440,*,*,1090,806,284,844,576,268,358,49,20,417
7/1/2014,VA,Virginia,Nottoway,51135,3501,3026,475,2833,25,2808,668,15,653,3243,2768,475,2448,2130,318,911,118,44,1375
7/1/2014,VA,Virginia,Orange,51137,7971,7174,797,6940,40,6900,1031,30,1001,7339,6543,796,4509,3847,662,914,239,62,3294
7/1/2014,VA,Virginia,Page,51139,5706,5056,650,4603,21,4582,1103,14,1089,5352,4702,650,3778,3197,581,1106,207,92,2373
7/1/2014,VA,Virginia,Patrick,51141,4942,3816,1126,3997,13,3984,945,13,932,4716,3591,1125,3741,2805,936,1005,175,85,2476
7/1/2014,VA,Virginia,Petersburg City,51730,7005,5910,1095,5060,77,4983,1945,88,1857,6396,5301,1095,4459,3442,1017,2020,323,80,2036
7/1/2014,VA,Virginia,Pittsylvania,51143,15075,12531,2544,12063,93,11970,3012,85,2927,14306,11762,2544,11497,9236,2261,3124,555,212,7606
7/1/2014,VA,Virginia,Poquoson City,51735,2357,2090,267,2170,*,*,187,0,187,2150,1883,267,993,754,239,106,21,12,854
7/1/2014,VA,Virginia,Portsmouth City,51740,17074,12976,4098,13141,174,12967,3933,208,3725,15267,11169,4098,9288,5440,3848,3611,670,148,4859
7/1/2014,VA,Virginia,Powhatan,51145,5070,4137,933,4455,20,4435,615,19,596,4619,3686,933,3428,2589,839,376,94,34,2924
7/1/2014,VA,Virginia,Prince Edward,51147,4354,3734,620,3405,25,3380,949,31,918,4058,3438,620,3057,2571,486,1049,171,46,1791
7/1/2014,VA,Virginia,Prince George,51149,5150,4591,559,4291,24,4267,859,26,833,4783,4224,559,2704,2185,519,532,112,25,2035
7/1/2014,VA,Virginia,Prince William,51153,39312,33936,5376,34587,192,34395,4725,298,4427,33586,28216,5370,17919,12934,4985,4258,859,193,12609
7/1/2014,VA,Virginia,Pulaski,51155,8589,7299,1290,6629,30,6599,1960,29,1931,8054,6764,1290,6092,4875,1217,1658,312,117,4005
7/1/2014,VA,Virginia,Radford City,51750,1972,1655,317,1582,*,*,390,*,*,1823,1506,317,1475,1172,303,328,42,30,1075
7/1/2014,VA,Virginia,Rappahannock,51157,1808,1672,136,1653,*,*,155,*,*,1644,1508,136,1007,895,112,152,39,11,805
7/1/2014,VA,Virginia,Richmond,51159,1795,1520,275,1550,16,1534,245,*,*,1692,1417,275,1191,960,231,281,85,23,802
7/1/2014,VA,Virginia,Richmond City,51760,31119,23522,7597,23700,280,23420,7419,357,7062,28077,20480,7597,22241,14984,7257,8206,1364,306,12365
7/1/2014,VA,Virginia,Roanoke,51161,21380,17715,3665,18674,86,18588,2706,50,2656,19840,16175,3665,14992,11563,3429,1928,386,124,12554
7/1/2014,VA,Virginia,Roanoke City,51770,19271,15385,3886,14132,119,14013,5139,146,4993,17704,13819,3885,13846,10138,3708,4593,748,230,8275
7/1/2014,VA,Virginia,Rockbridge,51163,5511,4675,836,4602,19,4583,909,*,*,5167,4331,836,3715,3209,506,841,158,60,2656
7/1/2014,VA,Virginia,Rockingham,51165,15549,13394,2155,13487,51,13436,2062,52,2010,14414,12260,2154,10586,9104,1482,1740,438,140,8268
7/1/2014,VA,Virginia,Russell,51167,7627,5452,2175,4938,13,4925,2689,11,2678,7277,5102,2175,6017,4254,1763,1711,289,116,3901
7/1/2014,VA,Virginia,Salem City,51775,5731,4870,861,4791,22,4769,940,23,917,5266,4405,861,4021,3212,809,795,129,44,3053
7/1/2014,VA,Virginia,Scott,51169,6415,3382,3033,4706,11,4695,1709,13,1696,6146,3113,3033,5223,2251,2972,1548,234,106,3335
7/1/2014,VA,Virginia,Shenandoah,51171,9594,8519,1075,8355,17,8338,1239,27,1212,9004,7929,1075,5953,5047,906,1241,237,96,4379
7/1/2014,VA,Virginia,Smyth,51173,8569,6900,1669,6205,17,6188,2364,22,2342,8110,6441,1669,6373,4853,1520,2131,378,148,3716
7/1/2014,VA,Virginia,Southampton,51175,3777,3314,463,3112,25,3087,665,23,642,3529,3066,463,2682,2278,404,714,131,38,1799
7/1/2014,VA,Virginia,Spotsylvania,51177,17285,15534,1751,14800,89,14711,2485,89,2396,15418,13668,1750,8779,7245,1534,1722,483,115,6459
7/1/2014,VA,Virginia,Stafford,51179,13915,12818,1097,12079,69,12010,1836,92,1744,12221,11126,1095,5863,4910,953,1193,315,74,4281
7/1/2014,VA,Virginia,Staunton City,51790,5744,5150,594,4663,25,4638,1081,28,1053,5416,4822,594,4134,3648,486,1061,148,50,2875
7/1/2014,VA,Virginia,Suffolk City,51800,13840,10896,2944,11131,76,11055,2709,80,2629,12642,9700,2942,8308,5672,2636,2593,393,100,5222
7/1/2014,VA,Virginia,Surry,51181,1423,1121,302,1185,*,*,238,11,227,1319,1017,302,931,645,286,206,66,12,647
7/1/2014,VA,Virginia,Sussex,51183,2295,1908,387,1829,33,1796,466,*,*,2126,1739,387,1588,1221,367,484,141,25,938
7/1/2014,VA,Virginia,Tazewell,51185,11477,8468,3009,8171,33,8138,3306,37,3269,10894,7887,3007,8302,6387,1915,2219,416,158,5509
7/1/2014,VA,Virginia,Unknown,51999,*,*,*,*,*,*,*,*,*,*,*,*,*,*,*,*,*,*,*
7/1/2014,VA,Virginia,Virginia Beach City,51810,61595,52051,9544,53805,299,53506,7790,320,7470,56302,46764,9538,29849,21198,8651,6097,1236,325,22191
7/1/2014,VA,Virginia,Warren,51187,6561,5955,606,5534,20,5514,1027,26,1001,6017,5411,606,3780,3255,525,825,220,66,2669
7/1/2014,VA,Virginia,Washington,51191,14190,9962,4228,11018,49,10969,3172,15,3157,13377,9151,4226,10441,6541,3900,2517,489,175,7260
7/1/2014,VA,Virginia,Waynesboro City,51820,4652,4132,520,3769,18,3751,883,22,861,4371,3851,520,3351,2912,439,889,95,43,2324
7/1/2014,VA,Virginia,Westmoreland,51193,4535,4111,424,3954,21,3933,581,14,567,4182,3758,424,2504,2134,370,746,121,39,1598
7/1/2014,VA,Virginia,Williamsburg City,51830,2291,1984,307,2098,*,*,193,*,*,2086,1779,307,1368,1104,264,189,*,*,1142
7/1/2014,VA,Virginia,Winchester City,51840,4823,4336,487,4091,15,4076,732,17,715,4423,3936,487,3037,2609,428,796,123,47,2071
7/1/2014,VA,Virginia,Wise,51195,10216,7100,3116,6565,12,6553,3651,18,3633,9635,6520,3115,7340,4448,2892,2395,476,149,4320
7/1/2014,VA,Virginia,Wythe,51197,7198,5833,1365,5485,21,5464,1713,22,1691,6827,5462,1365,5191,4008,1183,1520,264,95,3312
7/1/2014,VA,Virginia,York,51199,10374,9165,1209,9468,36,9432,906,30,876,9455,8249,1206,4676,3545,1131,601,161,50,3864
6/1/2014,VA,Virginia,Accomack,51001,8155,7087,1068,6867,46,6821,1288,44,1244,7600,6533,1067,5387,4464,923,1528,348,89,3422
6/1/2014,VA,Virginia,Albemarle,51003,17250,15705,1545,15697,62,15635,1553,54,1499,15525,13980,1545,11213,9839,1374,1481,256,81,9395
6/1/2014,VA,Virginia,Alexandria City,51510,15448,13949,1499,14064,86,13978,1384,87,1297,12410,10914,1496,6659,5252,1407,1852,353,60,4394
6/1/2014,VA,Virginia,Alleghany,51005,4397,3913,484,3502,20,3482,895,*,*,4162,3678,484,3212,2865,347,827,91,42,2252
6/1/2014,VA,Virginia,Amelia,51007,2776,2257,519,2288,*,*,488,12,476,2558,2039,519,1899,1421,478,463,75,35,1326
6/1/2014,VA,Virginia,Amherst,51009,7196,6133,1063,5892,49,5843,1304,35,1269,6702,5639,1063,5253,4269,984,1177,211,75,3790
6/1/2014,VA,Virginia,Appomattox,51011,3590,3074,516,2891,22,2869,699,14,685,3372,2856,516,2644,2168,476,685,97,52,1810
6/1/2014,VA,Virginia,Arlington,51013,21437,19314,2123,19782,71,19711,1655,76,1579,17110,14988,2122,9282,7311,1971,2788,316,113,6065
6/1/2014,VA,Virginia,Augusta,51015,16241,14166,2075,13806,58,13748,2435,41,2394,15198,13123,2075,11070,9392,1678,1826,364,136,8744
6/1/2014,VA,Virginia,Bath,51017,1249,1174,75,1083,*,*,166,*,*,1171,1096,75,906,844,62,200,34,23,649
6/1/2014,VA,Virginia,Bedford,51019,17475,14717,2758,14723,65,14658,2752,50,2702,16288,13533,2755,12146,9883,2263,1981,432,148,9585
6/1/2014,VA,Virginia,Bland,51021,1703,1370,333,1307,*,*,396,*,*,1611,1279,332,1169,915,254,240,59,18,852
6/1/2014,VA,Virginia,Botetourt,51023,7658,6130,1528,6530,31,6499,1128,13,1115,7061,5533,1528,5179,3820,1359,819,152,59,4149
6/1/2014,VA,Virginia,Bristol City,51520,4441,2747,1694,3400,12,3388,1041,*,*,4179,2485,1694,3404,1757,1647,1023,151,54,2176
6/1/2014,VA,Virginia,Brunswick,51025,3757,3216,541,3019,20,2999,738,31,707,3536,2995,541,2735,2257,478,1061,114,36,1524
6/1/2014,VA,Virginia,Buchanan,51027,7406,4748,2658,4397,16,4381,3009,14,2995,7069,4412,2657,5715,3878,1837,1591,444,118,3562
6/1/2014,VA,Virginia,Buckingham,51029,3199,2773,426,2545,13,2532,654,13,641,2974,2548,426,2229,1869,360,700,145,49,1335
6/1/2014,VA,Virginia,Buena Vista City,51530,1401,1170,231,1113,*,*,288,*,*,1306,1075,231,1009,826,183,332,55,19,603
6/1/2014,VA,Virginia,Campbell,51031,11777,10015,1762,9602,69,9533,2175,65,2110,11044,9282,1762,8615,7001,1614,1985,367,172,6091
6/1/2014,VA,Virginia,Caroline,51033,5113,4383,730,4226,35,4191,887,37,850,4621,3891,730,3011,2340,671,744,226,50,1991
6/1/2014,VA,Virginia,Carroll,51035,7609,6582,1027,5996,18,5978,1613,16,1597,7213,6186,1027,5513,4723,790,1676,284,114,3439
6/1/2014,VA,Virginia,Charles City,51036,1663,1309,354,1390,15,1375,273,14,259,1539,1185,354,1124,856,268,251,71,17,785
6/1/2014,VA,Virginia,Charlotte,51037,3186,2739,447,2568,19,2549,618,11,607,3005,2558,447,2305,1908,397,773,131,52,1349
6/1/2014,VA,Virginia,Charlottesville City,51540,5785,5330,455,4628,21,4607,1157,49,1108,5171,4717,454,4048,3617,431,1233,147,60,2608
6/1/2014,VA,Virginia,Chesapeake City,51550,32279,27069,5210,27328,219,27109,4951,236,4715,29001,23792,5209,16681,12058,4623,3757,817,213,11894
6/1/2014,VA,Virginia,Chesterfield,51041,49239,39342,9897,42256,180,42076,6983,209,6774,44160,34264,9896,31616,22508,9108,4564,888,271,25893
6/1/2014,VA,Virginia,Clarke,51043,2755,2482,273,2502,11,2491,253,*,*,2478,2205,273,1582,1348,234,255,70,29,1228
6/1/2014,VA,Virginia,Colonial Heights City,51570,4011,3551,460,3473,12,3461,538,15,523,3665,3205,460,2172,1748,424,419,93,16,1644
6/1/2014,VA,Virginia,Covington City,51580,1683,1527,156,1287,*,*,396,*,*,1568,1412,156,1199,1055,144,352,55,17,775
6/1/2014,VA,Virginia,Craig,51045,1242,1016,226,936,*,*,306,*,*,1133,907,226,855,633,222,201,38,16,600
6/1/2014,VA,Virginia,Culpeper,51047,8058,7085,973,6856,45,6811,1202,40,1162,7324,6351,973,4793,3954,839,1086,229,73,3405
6/1/2014,VA,Virginia,Cumberland,51049,2078,1708,370,1712,11,1701,366,*,*,1931,1563,368,1454,1117,337,411,75,26,942
6/1/2014,VA,Virginia,Danville City,51590,10959,9246,1713,8537,76,8461,2422,113,2309,10384,8671,1713,8417,7209,1208,3100,421,165,4731
6/1/2014,VA,Virginia,Dickenson,51051,4695,3256,1439,2808,*,*,1887,11,1876,4471,3032,1439,3542,2292,1250,1114,219,98,2111
6/1/2014,VA,Virginia,Dinwiddie,51053,5295,4467,828,4172,38,4134,1123,30,1093,4846,4018,828,3405,2611,794,885,175,53,2292
6/1/2014,VA,Virginia,Emporia City,51595,1189,978,211,885,13,872,304,12,292,1121,910,211,897,734,163,443,60,16,378
6/1/2014,VA,Virginia,Essex,51057,2615,2241,374,2214,13,2201,401,12,389,2439,2065,374,1783,1455,328,422,85,22,1254
6/1/2014,VA,Virginia,Fairfax,51059,129228,113997,15231,121113,472,120641,8115,404,7711,104241,89034,15207,54009,39877,14132,12261,2334,423,38991
6/1/2014,VA,Virginia,Fairfax City,51600,3423,2983,440,3144,13,3131,279,*,*,2878,2438,440,1556,1143,413,358,53,14,1131
6/1/2014,VA,Virginia,Falls Church City,51610,1649,1469,180,1553,*,*,96,*,*,1298,1119,179,710,547,163,138,*,*,548
6/1/2014,VA,Virginia,Fauquier,51061,10710,9711,999,9620,48,9572,1090,40,1050,9422,8424,998,5469,4630,839,833,183,54,4399
6/1/2014,VA,Virginia,Floyd,51063,3656,3029,627,3093,*,*,563,*,*,3403,2776,627,2579,2008,571,523,89,45,1922
6/1/2014,VA,Virginia,Fluvanna,51065,5128,4562,566,4570,22,4548,558,22,536,4713,4147,566,3269,2780,489,456,116,20,2677
6/1/2014,VA,Virginia,Franklin,51067,13290,10172,3118,10821,44,10777,2469,25,2444,12452,9334,3118,9700,6847,2853,1936,427,150,7187
6/1/2014,VA,Virginia,Franklin City,51620,1842,1645,197,1404,*,*,438,19,419,1721,1524,197,1365,1195,170,508,78,16,763
6/1/2014,VA,Virginia,Frederick,51069,13724,12186,1538,12014,40,11974,1710,43,1667,12492,10956,1536,8071,6733,1338,1353,334,130,6254
6/1/2014,VA,Virginia,Fredericksburg City,51630,3627,3321,306,2935,16,2919,692,29,663,3273,2967,306,2121,1837,284,737,83,37,1264
6/1/2014,VA,Virginia,Galax City,51640,1945,1826,119,1486,*,*,459,11,448,1857,1738,119,1448,1354,94,673,67,31,677
6/1/2014,VA,Virginia,Giles,51071,4357,3435,922,3379,19,3360,978,12,966,4090,3169,921,3240,2393,847,768,129,32,2311
6/1/2014,VA,Virginia,Gloucester,51073,7490,6480,1010,6389,32,6357,1101,17,1084,6882,5872,1010,4175,3300,875,891,173,62,3049
6/1/2014,VA,Virginia,Goochland,51075,4742,3910,832,4261,20,4241,481,17,464,4273,3441,832,3248,2505,743,403,96,34,2715
6/1/2014,VA,Virginia,Grayson,51077,4395,3920,475,3553,16,3537,842,*,*,4227,3752,475,3069,2659,410,986,177,79,1827
6/1/2014,VA,Virginia,Greene,51079,3250,2889,361,2806,13,2793,444,12,432,2986,2625,361,2072,1738,334,427,78,21,1546
6/1/2014,VA,Virginia,Greensville,51081,2302,1760,542,1823,18,1805,479,19,460,2142,1600,542,1748,1271,477,540,128,24,1056
6/1/2014,VA,Virginia,Halifax,51083,9191,7979,1212,7318,55,7263,1873,62,1811,8628,7417,1211,6846,5731,1115,2204,420,132,4090
6/1/2014,VA,Virginia,Hampton City,51650,22758,18593,4165,18474,198,18276,4284,208,4076,20796,16632,4164,11834,8001,3833,3377,742,187,7528
6/1/2014,VA,Virginia,Hanover,51085,17720,14236,3484,15873,66,15807,1847,44,1803,16119,12635,3484,11953,8900,3053,1343,332,96,10182
6/1/2014,VA,Virginia,Harrisonburg City,51660,4898,4413,485,4091,18,4073,807,20,787,4474,3989,485,3392,3036,356,885,120,44,2343
6/1/2014,VA,Virginia,Henrico,51087,48924,38429,10495,42189,305,41884,6735,295,6440,44299,33806,10493,33096,23611,9485,5506,1215,361,26014
6/1/2014,VA,Virginia,Henry,51089,14694,10654,4040,11430,66,11364,3264,65,3199,14012,9972,4040,11685,8594,3091,3097,652,228,7708
6/1/2014,VA,Virginia,Highland,51091,689,627,62,625,*,*,64,0,64,644,582,62,466,409,57,68,*,*,368
6/1/2014,VA,Virginia,Hopewell City,51670,4289,3702,587,3323,23,3300,966,33,933,3990,3403,587,2606,2038,568,883,136,37,1550
6/1/2014,VA,Virginia,Isle of Wight,51093,7051,5664,1387,6096,38,6058,955,30,925,6545,5158,1387,4496,3191,1305,854,181,77,3384
6/1/2014,VA,Virginia,James City,51095,17392,15576,1816,16274,51,16223,1118,39,1079,16064,14251,1813,9243,7672,1571,817,180,42,8204
6/1/2014,VA,Virginia,King and Queen,51097,1580,1382,198,1310,*,*,270,*,*,1478,1280,198,1091,912,179,263,78,11,739
6/1/2014,VA,Virginia,King George,51099,3249,3019,230,2764,17,2747,485,21,464,2822,2592,230,1381,1168,213,415,84,22,860
6/1/2014,VA,Virginia,King William,51101,2863,2509,354,2442,15,2427,421,21,400,2634,2280,354,2023,1721,302,367,80,20,1556
6/1/2014,VA,Virginia,Lancaster,51103,4094,3639,455,3746,15,3731,348,14,334,3901,3446,455,2602,2268,334,470,79,29,2024
6/1/2014,VA,Virginia,Lee,51105,6246,4319,1927,4091,15,4076,2155,17,2138,5908,3984,1924,4651,2861,1790,1924,251,78,2398
6/1/2014,VA,Virginia,Lexington City,51678,1576,1452,124,1431,12,1419,145,*,*,1473,1349,124,1096,1002,94,216,32,12,836
6/1/2014,VA,Virginia,Loudoun,51107,28545,24931,3614,26400,88,26312,2145,100,2045,23597,19987,3610,13999,10702,3297,2460,508,119,10912
6/1/2014,VA,Virginia,Louisa,51109,6772,5801,971,5603,35,5568,1169,31,1138,6205,5234,971,4350,3453,897,1018,248,68,3016
6/1/2014,VA,Virginia,Lunenburg,51111,2846,2517,329,2289,15,2274,557,22,535,2631,2302,329,1919,1614,305,673,118,36,1092
6/1/2014,VA,Virginia,Lynchburg City,51680,14154,12279,1875,11070,81,10989,3084,103,2981,13174,11300,1874,10405,8690,1715,3309,437,142,6517
6/1/2014,VA,Virginia,Madison,51113,2707,2417,290,2364,*,*,343,*,*,2525,2235,290,1777,1510,267,404,70,23,1280
6/1/2014,VA,Virginia,Manassas City,51683,3798,3280,518,3274,21,3253,524,33,491,3239,2722,517,2174,1682,492,505,97,28,1544
6/1/2014,VA,Virginia,Manassas Park City,51685,1051,890,161,895,*,*,156,12,144,886,725,161,578,431,147,145,*,*,390
6/1/2014,VA,Virginia,Martinsville City,51690,3919,3084,835,2914,21,2893,1005,35,970,3728,2893,835,3182,2542,640,1300,161,60,1661
6/1/2014,VA,Virginia,Mathews,51115,2635,2317,318,2392,*,*,243,*,*,2492,2174,318,1569,1288,281,248,48,19,1254
6/1/2014,VA,Virginia,Mecklenburg,51117,8735,7306,1429,7108,50,7058,1627,54,1573,8228,6801,1427,6308,5155,1153,1869,372,104,3963
6/1/2014,VA,Virginia,Middlesex,51119,3327,2881,446,2963,17,2946,364,*,*,3120,2675,445,2239,1890,349,405,91,20,1723
6/1/2014,VA,Virginia,Montgomery,51121,12462,10653,1809,10144,28,10116,2318,27,2291,11353,9544,1809,8896,7196,1700,1788,286,110,6712
6/1/2014,VA,Virginia,Nelson,51125,4048,3619,429,3499,14,3485,549,15,534,3739,3310,429,2643,2254,389,604,99,37,1903
6/1/2014,VA,Virginia,New Kent,51127,3561,2982,579,3109,15,3094,452,11,441,3230,2651,579,2147,1678,469,275,73,22,1777
6/1/2014,VA,Virginia,Newport News City,51700,25499,20353,5146,20819,167,20652,4680,221,4459,23334,18190,5144,14558,9717,4841,4287,758,212,9301
6/1/2014,VA,Virginia,Norfolk City,51710,29987,24277,5710,23602,233,23369,6385,335,6050,27026,21316,5710,17131,11935,5196,6686,1180,271,8994
6/1/2014,VA,Virginia,Northampton,51131,3313,2924,389,2796,31,2765,517,31,486,3118,2729,389,2428,2080,348,897,100,32,1399
6/1/2014,VA,Virginia,Northumberland,51133,4469,4033,436,4116,*,*,353,*,*,4185,3749,436,2592,2284,308,430,86,30,2046
6/1/2014,VA,Virginia,Norton City,51720,1172,889,283,735,*,*,437,*,*,1081,798,283,840,573,267,357,49,20,414
6/1/2014,VA,Virginia,Nottoway,51135,3501,3027,474,2838,25,2813,663,14,649,3222,2748,474,2420,2104,316,905,118,44,1353
6/1/2014,VA,Virginia,Orange,51137,7967,7168,799,6942,41,6901,1025,30,995,7321,6523,798,4507,3842,665,913,237,61,3296
6/1/2014,VA,Virginia,Page,51139,5696,5050,646,4598,21,4577,1098,14,1084,5333,4687,646,3764,3188,576,1097,205,90,2372
6/1/2014,VA,Virginia,Patrick,51141,4946,3823,1123,4001,13,3988,945,13,932,4717,3595,1122,3735,2804,931,1005,178,84,2468
6/1/2014,VA,Virginia,Petersburg City,51730,6989,5899,1090,5053,79,4974,1936,87,1849,6365,5275,1090,4465,3454,1011,2017,326,79,2043
6/1/2014,VA,Virginia,Pittsylvania,51143,15039,12490,2549,12034,93,11941,3005,86,2919,14254,11705,2549,11474,9210,2264,3109,557,209,7599
6/1/2014,VA,Virginia,Poquoson City,51735,2350,2113,237,2165,*,*,185,0,185,2141,1904,237,986,778,208,105,21,12,848
6/1/2014,VA,Virginia,Portsmouth City,51740,17028,13724,3304,13125,176,12949,3903,208,3695,15173,11869,3304,9239,6203,3036,3585,667,148,4839
6/1/2014,VA,Virginia,Powhatan,51145,5041,4113,928,4423,21,4402,618,19,599,4583,3655,928,3416,2579,837,377,91,33,2915
6/1/2014,VA,Virginia,Prince Edward,51147,4344,3732,612,3397,26,3371,947,31,916,4039,3427,612,3041,2562,479,1040,171,44,1786
6/1/2014,VA,Virginia,Prince George,51149,5133,4574,559,4276,24,4252,857,28,829,4743,4184,559,2689,2170,519,524,108,26,2031
6/1/2014,VA,Virginia,Prince William,51153,39082,33749,5333,34391,193,34198,4691,298,4393,33195,27868,5327,17841,12900,4941,4227,858,194,12562
6/1/2014,VA,Virginia,Pulaski,51155,8563,7273,1290,6607,30,6577,1956,28,1928,8012,6722,1290,6067,4848,1219,1651,316,116,3984
6/1/2014,VA,Virginia,Radford City,51750,1967,1651,316,1580,*,*,387,*,*,1809,1493,316,1466,1164,302,323,43,30,1070
6/1/2014,VA,Virginia,Rappahannock,51157,1808,1672,136,1653,*,*,155,*,*,1628,1492,136,1007,894,113,151,36,11,809
6/1/2014,VA,Virginia,Richmond,51159,1791,1511,280,1545,16,1529,246,*,*,1683,1403,280,1191,955,236,280,84,23,804
6/1/2014,VA,Virginia,Richmond City,51760,31028,23522,7506,23650,288,23362,7378,360,7018,27892,20386,7506,22160,14994,7166,8135,1371,300,12354
6/1/2014,VA,Virginia,Roanoke,51161,21306,17698,3608,18622,87,18535,2684,49,2635,19737,16129,3608,14322,10952,3370,1920,386,123,11893
6/1/2014,VA,Virginia,Roanoke City,51770,19219,15385,3834,14105,121,13984,5114,144,4970,17617,13784,3833,13546,9885,3661,4558,751,228,8009
6/1/2014,VA,Virginia,Rockbridge,51163,5507,4670,837,4601,19,4582,906,12,894,5150,4313,837,3714,3203,511,842,164,61,2647
6/1/2014,VA,Virginia,Rockingham,51165,15486,13336,2150,13435,53,13382,2051,53,1998,14341,12192,2149,10535,9055,1480,1731,439,139,8226
6/1/2014,VA,Virginia,Russell,51167,7613,5438,2175,4931,13,4918,2682,12,2670,7247,5072,2175,5990,4228,1762,1696,286,118,3890
6/1/2014,VA,Virginia,Salem City,51775,5722,4868,854,4788,23,4765,934,22,912,5249,4395,854,3939,3138,801,796,129,42,2972
6/1/2014,VA,Virginia,Scott,51169,6408,3363,3045,4701,11,4690,1707,13,1694,6130,3085,3045,5216,2232,2984,1540,238,106,3332
6/1/2014,VA,Virginia,Shenandoah,51171,9570,8501,1069,8334,17,8317,1236,26,1210,8962,7893,1069,5924,5022,902,1231,233,94,4366
6/1/2014,VA,Virginia,Smyth,51173,8547,6891,1656,6199,18,6181,2348,22,2326,8080,6424,1656,6359,4851,1508,2118,376,147,3718
6/1/2014,VA,Virginia,Southampton,51175,3765,3315,450,3105,25,3080,660,22,638,3506,3056,450,2675,2287,388,708,129,38,1800
6/1/2014,VA,Virginia,Spotsylvania,51177,17219,15465,1754,14741,92,14649,2478,91,2387,15302,13549,1753,8746,7211,1535,1709,481,112,6444
6/1/2014,VA,Virginia,Stafford,51179,13837,12740,1097,12018,71,11947,1819,92,1727,12075,10980,1095,5822,4870,952,1189,314,72,4247
6/1/2014,VA,Virginia,Staunton City,51790,5740,5144,596,4661,25,4636,1079,28,1051,5402,4806,596,4129,3641,488,1055,146,50,2878
6/1/2014,VA,Virginia,Suffolk City,51800,13799,11503,2296,11104,78,11026,2695,80,2615,12558,10264,2294,8263,6288,1975,2580,389,100,5194
6/1/2014,VA,Virginia,Surry,51181,1416,1116,300,1180,*,*,236,11,225,1306,1006,300,925,643,282,204,66,12,643
6/1/2014,VA,Virginia,Sussex,51183,2287,1901,386,1823,34,1789,464,*,*,2118,1732,386,1579,1213,366,486,138,25,930
6/1/2014,VA,Virginia,Tazewell,51185,11448,8444,3004,8158,33,8125,3290,37,3253,10860,7858,3002,8256,6348,1908,2205,416,157,5478
6/1/2014,VA,Virginia,Unknown,51999,*,*,*,*,*,*,*,*,*,*,*,*,*,*,*,*,*,*,*
6/1/2014,VA,Virginia,Virginia Beach City,51810,61348,53024,8324,53611,303,53308,7737,318,7419,55893,47575,8318,29547,22130,7417,6055,1233,325,21934
6/1/2014,VA,Virginia,Warren,51187,6548,5945,603,5524,22,5502,1024,26,998,5985,5382,603,3757,3235,522,820,220,67,2650
6/1/2014,VA,Virginia,Washington,51191,14151,9935,4216,10992,50,10942,3159,14,3145,13311,9097,4214,10374,6487,3887,2500,496,171,7207
6/1/2014,VA,Virginia,Waynesboro City,51820,4648,4130,518,3771,20,3751,877,21,856,4355,3837,518,3351,2912,439,887,95,42,2327
6/1/2014,VA,Virginia,Westmoreland,51193,4527,4102,425,3950,21,3929,577,14,563,4170,3745,425,2504,2133,371,744,121,40,1599
6/1/2014,VA,Virginia,Williamsburg City,51830,2292,2013,279,2102,*,*,190,*,*,2076,1797,279,1367,1131,236,188,*,*,1142
6/1/2014,VA,Virginia,Winchester City,51840,4817,4332,485,4087,16,4071,730,18,712,4407,3922,485,3033,2607,426,792,127,43,2071
6/1/2014,VA,Virginia,Wise,51195,10202,7088,3114,6562,12,6550,3640,18,3622,9596,6483,3113,7317,4430,2887,2380,479,149,4309
6/1/2014,VA,Virginia,Wythe,51197,7197,5835,1362,5489,21,5468,1708,22,1686,6813,5451,1362,5180,4000,1180,1514,266,95,3305
6/1/2014,VA,Virginia,York,51199,10321,9227,1094,9423,36,9387,898,29,869,9367,8276,1091,4654,3636,1018,596,159,50,3849
3/1/2014,VA,Virginia,Accomack,51001,8131,7078,1053,6870,48,6822,1261,45,1216,7581,6529,1052,5342,4433,909,1513,348,86,3395
3/1/2014,VA,Virginia,Albemarle,51003,17080,15556,1524,15559,63,15496,1521,56,1465,15389,13865,1524,11079,9726,1353,1470,254,88,9267
3/1/2014,VA,Virginia,Alexandria City,51510,15239,13768,1471,13868,90,13778,1371,87,1284,12298,10830,1468,6587,5213,1374,1832,360,61,4334
3/1/2014,VA,Virginia,Alleghany,51005,4414,3946,468,3531,20,3511,883,11,872,4177,3709,468,3216,2884,332,816,95,46,2259
3/1/2014,VA,Virginia,Amelia,51007,2753,2240,513,2274,*,*,479,12,467,2541,2028,513,1893,1421,472,458,81,32,1322
3/1/2014,VA,Virginia,Amherst,51009,7151,6086,1065,5870,50,5820,1281,37,1244,6666,5601,1065,5214,4231,983,1144,218,80,3772
3/1/2014,VA,Virginia,Appomattox,51011,3578,3064,514,2891,23,2868,687,14,673,3360,2846,514,2634,2161,473,686,101,53,1794
3/1/2014,VA,Virginia,Arlington,51013,21223,19174,2049,19598,71,19527,1625,77,1548,16972,14924,2048,9210,7310,1900,2760,313,115,6022
3/1/2014,VA,Virginia,Augusta,51015,16161,14103,2058,13754,60,13694,2407,41,2366,15122,13064,2058,11014,9357,1657,1804,365,142,8703
3/1/2014,VA,Virginia,Bath,51017,1236,1158,78,1073,*,*,163,*,*,1162,1084,78,899,836,63,196,35,24,644
3/1/2014,VA,Virginia,Bedford,51019,17357,14620,2737,14650,69,14581,2707,50,2657,16173,13439,2734,12048,9808,2240,1951,436,155,9506
3/1/2014,VA,Virginia,Bland,51021,1683,1351,332,1290,*,*,393,*,*,1597,1266,331,1160,906,254,236,61,18,845
3/1/2014,VA,Virginia,Botetourt,51023,7616,6103,1513,6500,31,6469,1116,13,1103,7030,5517,1513,5157,3813,1344,813,159,65,4120
3/1/2014,VA,Virginia,Bristol City,51520,4445,2747,1698,3416,12,3404,1029,*,*,4187,2489,1698,3402,1754,1648,1008,154,51,2189
3/1/2014,VA,Virginia,Brunswick,51025,3738,3213,525,3016,21,2995,722,30,692,3514,2989,525,2711,2251,460,1043,115,39,1514
3/1/2014,VA,Virginia,Buchanan,51027,7419,4758,2661,4423,19,4404,2996,14,2982,7084,4424,2660,5712,3877,1835,1573,453,122,3564
3/1/2014,VA,Virginia,Buckingham,51029,3173,2756,417,2529,15,2514,644,14,630,2950,2533,417,2211,1861,350,689,151,50,1321
3/1/2014,VA,Virginia,Buena Vista City,51530,1395,1166,229,1110,*,*,285,*,*,1300,1071,229,1004,825,179,323,56,19,606
3/1/2014,VA,Virginia,Campbell,51031,11729,9975,1754,9583,72,9511,2146,62,2084,11013,9259,1754,8574,6967,1607,1966,372,185,6051
3/1/2014,VA,Virginia,Caroline,51033,5064,4338,726,4193,36,4157,871,36,835,4580,3854,726,2998,2330,668,725,235,52,1986
3/1/2014,VA,Virginia,Carroll,51035,7582,6551,1031,5994,20,5974,1588,17,1571,7198,6167,1031,5520,4726,794,1663,293,119,3445
3/1/2014,VA,Virginia,Charles City,51036,1652,1306,346,1382,16,1366,270,15,255,1532,1186,346,1110,851,259,245,72,18,775
3/1/2014,VA,Virginia,Charlotte,51037,3190,2740,450,2578,19,2559,612,12,600,3012,2562,450,2307,1909,398,774,132,46,1355
3/1/2014,VA,Virginia,Charlottesville City,51540,5744,5298,446,4603,22,4581,1141,47,1094,5142,4697,445,4028,3606,422,1213,150,59,2606
3/1/2014,VA,Virginia,Chesapeake City,51550,32020,26917,5103,27171,228,26943,4849,236,4613,28827,23725,5102,16525,12021,4504,3661,827,226,11811
3/1/2014,VA,Virginia,Chesterfield,51041,48810,39146,9664,41919,190,41729,6891,210,6681,43806,34143,9663,31211,22338,8873,4521,897,286,25507
3/1/2014,VA,Virginia,Clarke,51043,2723,2418,305,2475,12,2463,248,*,*,2457,2152,305,1570,1305,265,253,71,32,1214
3/1/2014,VA,Virginia,Colonial Heights City,51570,4005,3562,443,3472,13,3459,533,14,519,3668,3225,443,2173,1766,407,417,94,17,1645
3/1/2014,VA,Virginia,Covington City,51580,1680,1528,152,1288,*,*,392,*,*,1561,1409,152,1202,1062,140,345,61,17,779
3/1/2014,VA,Virginia,Craig,51045,1232,1007,225,935,*,*,297,*,*,1126,901,225,848,629,219,193,40,17,598
3/1/2014,VA,Virginia,Culpeper,51047,8016,7049,967,6826,47,6779,1190,43,1147,7293,6326,967,4778,3946,832,1068,236,75,3399
3/1/2014,VA,Virginia,Cumberland,51049,2064,1703,361,1701,13,1688,363,11,352,1922,1562,360,1444,1115,329,403,74,28,939
3/1/2014,VA,Virginia,Danville City,51590,10961,9235,1726,8571,84,8487,2390,112,2278,10392,8666,1726,8444,7220,1224,3091,438,173,4742
3/1/2014,VA,Virginia,Dickenson,51051,4689,3254,1435,2815,*,*,1874,11,1863,4473,3038,1435,3537,2295,1242,1098,225,100,2114
3/1/2014,VA,Virginia,Dinwiddie,51053,5254,4443,811,4159,40,4119,1095,32,1063,4804,3993,811,3375,2598,777,875,175,50,2275
3/1/2014,VA,Virginia,Emporia City,51595,1182,971,211,886,14,872,296,12,284,1113,902,211,894,736,158,428,65,17,384
3/1/2014,VA,Virginia,Essex,51057,2614,2247,367,2216,14,2202,398,12,386,2442,2075,367,1778,1459,319,417,83,20,1258
3/1/2014,VA,Virginia,Fairfax,51059,127511,112528,14983,119551,489,119062,7960,399,7561,103158,88198,14960,53415,39511,13904,12108,2367,444,38496
3/1/2014,VA,Virginia,Fairfax City,51600,3392,2957,435,3120,15,3105,272,*,*,2866,2431,435,1548,1142,406,362,53,11,1122
3/1/2014,VA,Virginia,Falls Church City,51610,1636,1459,177,1541,*,*,95,*,*,1296,1120,176,712,552,160,139,*,*,548
3/1/2014,VA,Virginia,Fauquier,51061,10590,9569,1021,9538,54,9484,1052,37,1015,9319,8299,1020,5410,4548,862,811,190,60,4349
3/1/2014,VA,Virginia,Floyd,51063,3617,2996,621,3066,11,3055,551,*,*,3372,2751,621,2552,1985,567,521,92,43,1896
3/1/2014,VA,Virginia,Fluvanna,51065,5094,4538,556,4545,23,4522,549,22,527,4682,4126,556,3230,2751,479,447,114,21,2648
3/1/2014,VA,Virginia,Franklin,51067,13203,10116,3087,10775,47,10728,2428,24,2404,12371,9284,3087,9625,6801,2824,1912,426,158,7129
3/1/2014,VA,Virginia,Franklin City,51620,1831,1642,189,1401,*,*,430,20,410,1715,1526,189,1353,1192,161,495,82,19,757
3/1/2014,VA,Virginia,Frederick,51069,13658,12065,1593,11975,45,11930,1683,42,1641,12446,10855,1591,8037,6646,1391,1332,335,135,6235
3/1/2014,VA,Virginia,Fredericksburg City,51630,3605,3304,301,2920,16,2904,685,29,656,3254,2953,301,2112,1830,282,722,85,39,1266
3/1/2014,VA,Virginia,Galax City,51640,1954,1835,119,1496,*,*,458,11,447,1863,1744,119,1452,1358,94,675,65,32,680
3/1/2014,VA,Virginia,Giles,51071,4357,3449,908,3393,19,3374,964,13,951,4084,3177,907,3188,2358,830,766,128,34,2260
3/1/2014,VA,Virginia,Gloucester,51073,7440,6444,996,6364,36,6328,1076,17,1059,6838,5842,996,4141,3280,861,878,176,68,3019
3/1/2014,VA,Virginia,Goochland,51075,4709,3891,818,4232,20,4212,477,16,461,4245,3427,818,3223,2497,726,401,103,40,2679
3/1/2014,VA,Virginia,Grayson,51077,4386,3914,472,3554,16,3538,832,*,*,4222,3750,472,3077,2670,407,988,170,81,1838
3/1/2014,VA,Virginia,Greene,51079,3217,2864,353,2785,13,2772,432,11,421,2957,2604,353,2047,1719,328,417,77,21,1532
3/1/2014,VA,Virginia,Greensville,51081,2280,1741,539,1814,20,1794,466,19,447,2120,1581,539,1748,1278,470,531,125,26,1066
3/1/2014,VA,Virginia,Halifax,51083,9131,7918,1213,7289,59,7230,1842,60,1782,8586,7374,1212,6822,5705,1117,2180,426,135,4081
3/1/2014,VA,Virginia,Hampton City,51650,22608,18534,4074,18405,204,18201,4203,199,4004,20671,16597,4074,11738,7998,3740,3293,747,196,7502
3/1/2014,VA,Virginia,Hanover,51085,17577,14141,3436,15759,67,15692,1818,46,1772,16019,12583,3436,11812,8809,3003,1317,339,98,10058
3/1/2014,VA,Virginia,Harrisonburg City,51660,4860,4373,487,4074,19,4055,786,20,766,4453,3966,487,3359,3001,358,857,124,49,2329
3/1/2014,VA,Virginia,Henrico,51087,48654,38395,10259,42042,314,41728,6612,293,6319,44103,33846,10257,32769,23533,9236,5403,1245,370,25751
3/1/2014,VA,Virginia,Henry,51089,14657,10606,4051,11448,70,11378,3209,67,3142,13993,9942,4051,11673,8583,3090,3064,664,236,7709
3/1/2014,VA,Virginia,Highland,51091,688,627,61,625,*,*,63,0,63,644,583,61,463,407,56,67,*,*,366
3/1/2014,VA,Virginia,Hopewell City,51670,4296,3744,552,3337,25,3312,959,36,923,3988,3436,552,2615,2080,535,888,139,40,1548
3/1/2014,VA,Virginia,Isle of Wight,51093,6987,5619,1368,6051,40,6011,936,30,906,6481,5113,1368,4456,3168,1288,847,183,82,3344
3/1/2014,VA,Virginia,James City,51095,17284,15487,1797,16188,53,16135,1096,40,1056,15958,14164,1794,9165,7612,1553,814,181,47,8123
3/1/2014,VA,Virginia,King and Queen,51097,1571,1383,188,1307,*,*,264,*,*,1473,1285,188,1085,916,169,259,78,12,736
3/1/2014,VA,Virginia,King George,51099,3222,2996,226,2750,18,2732,472,20,452,2806,2580,226,1369,1160,209,410,82,22,855
3/1/2014,VA,Virginia,King William,51101,2830,2494,336,2419,17,2402,411,19,392,2605,2269,336,1996,1712,284,361,82,20,1533
3/1/2014,VA,Virginia,Lancaster,51103,4095,3642,453,3758,16,3742,337,15,322,3898,3445,453,2587,2256,331,467,78,31,2011
3/1/2014,VA,Virginia,Lee,51105,6246,4325,1921,4108,16,4092,2138,17,2121,5911,3993,1918,4631,2851,1780,1900,252,84,2395
3/1/2014,VA,Virginia,Lexington City,51678,1579,1458,121,1437,12,1425,142,*,*,1478,1357,121,1089,999,90,214,34,13,828
3/1/2014,VA,Virginia,Loudoun,51107,28183,24165,4018,26085,92,25993,2098,100,1998,23347,19333,4014,13821,10120,3701,2380,527,123,10791
3/1/2014,VA,Virginia,Louisa,51109,6710,5754,956,5573,36,5537,1137,30,1107,6149,5193,956,4319,3439,880,1008,251,73,2987
3/1/2014,VA,Virginia,Lunenburg,51111,2834,2520,314,2288,16,2272,546,21,525,2614,2300,314,1918,1628,290,669,115,38,1096
3/1/2014,VA,Virginia,Lynchburg City,51680,14144,12260,1884,11092,84,11008,3052,106,2946,13176,11292,1884,10376,8654,1722,3276,446,148,6506
3/1/2014,VA,Virginia,Madison,51113,2690,2397,293,2350,*,*,340,*,*,2511,2218,293,1763,1494,269,399,71,24,1269
3/1/2014,VA,Virginia,Manassas City,51683,3755,3246,509,3243,21,3222,512,31,481,3223,2715,508,2161,1678,483,501,93,28,1539
3/1/2014,VA,Virginia,Manassas Park City,51685,1037,873,164,884,*,*,153,11,142,880,716,164,576,427,149,142,*,*,386
3/1/2014,VA,Virginia,Martinsville City,51690,3899,3064,835,2898,22,2876,1001,36,965,3718,2883,835,3163,2525,638,1284,168,59,1652
3/1/2014,VA,Virginia,Mathews,51115,2631,2319,312,2389,*,*,242,*,*,2488,2176,312,1554,1279,275,244,49,19,1242
3/1/2014,VA,Virginia,Mecklenburg,51117,8714,7283,1431,7102,53,7049,1612,56,1556,8208,6779,1429,6305,5154,1151,1862,380,110,3953
3/1/2014,VA,Virginia,Middlesex,51119,3319,2873,446,2961,18,2943,358,*,*,3112,2667,445,2236,1887,349,398,91,24,1723
3/1/2014,VA,Virginia,Montgomery,51121,12364,10573,1791,10075,29,10046,2289,29,2260,11275,9484,1791,8828,7143,1685,1760,298,113,6657
3/1/2014,VA,Virginia,Nelson,51125,4029,3604,425,3492,14,3478,537,15,522,3720,3295,425,2618,2233,385,594,105,40,1879
3/1/2014,VA,Virginia,New Kent,51127,3509,2940,569,3066,16,3050,443,11,432,3193,2624,569,2106,1647,459,269,75,24,1738
3/1/2014,VA,Virginia,Newport News City,51700,25324,20294,5030,20718,171,20547,4606,223,4383,23212,18183,5029,14479,9759,4720,4208,786,223,9262
3/1/2014,VA,Virginia,Norfolk City,51710,29772,24238,5534,23531,244,23287,6241,328,5913,26866,21332,5534,16951,11938,5013,6596,1207,293,8855
3/1/2014,VA,Virginia,Northampton,51131,3295,2910,385,2789,34,2755,506,31,475,3096,2711,385,2421,2077,344,899,102,33,1387
3/1/2014,VA,Virginia,Northumberland,51133,4444,4020,424,4097,11,4086,347,*,*,4172,3748,424,2578,2282,296,418,91,30,2039
3/1/2014,VA,Virginia,Norton City,51720,1167,889,278,732,*,*,435,*,*,1076,798,278,833,571,262,355,50,23,405
3/1/2014,VA,Virginia,Nottoway,51135,3489,3032,457,2832,26,2806,657,14,643,3214,2757,457,2422,2123,299,891,125,47,1359
3/1/2014,VA,Virginia,Orange,51137,7920,7140,780,6924,40,6884,996,32,964,7295,6516,779,4480,3832,648,897,238,64,3281
3/1/2014,VA,Virginia,Page,51139,5661,5010,651,4582,21,4561,1079,13,1066,5300,4649,651,3736,3153,583,1077,205,93,2361
3/1/2014,VA,Virginia,Patrick,51141,4930,3812,1118,3997,15,3982,933,12,921,4710,3593,1117,3714,2792,922,992,183,81,2458
3/1/2014,VA,Virginia,Petersburg City,51730,6978,5935,1043,5073,80,4993,1905,83,1822,6360,5317,1043,4472,3511,961,2000,335,84,2053
3/1/2014,VA,Virginia,Pittsylvania,51143,14976,12442,2534,12023,95,11928,2953,81,2872,14200,11666,2534,11431,9183,2248,3071,569,218,7573
3/1/2014,VA,Virginia,Poquoson City,51735,2335,2096,239,2154,*,*,181,*,*,2127,1888,239,983,773,210,103,20,12,848
3/1/2014,VA,Virginia,Portsmouth City,51740,16952,13742,3210,13107,182,12925,3845,210,3635,15145,11935,3210,9227,6297,2930,3543,692,160,4832
3/1/2014,VA,Virginia,Powhatan,51145,4998,4083,915,4392,22,4370,606,19,587,4532,3617,915,3361,2537,824,368,92,33,2868
3/1/2014,VA,Virginia,Prince Edward,51147,4321,3721,600,3400,27,3373,921,30,891,4028,3428,600,3036,2572,464,1036,174,47,1779
3/1/2014,VA,Virginia,Prince George,51149,5088,4542,546,4252,26,4226,836,26,810,4699,4153,546,2660,2152,508,525,112,26,1997
3/1/2014,VA,Virginia,Prince William,51153,38500,33297,5203,33935,199,33736,4565,287,4278,32815,27617,5198,17664,12851,4813,4149,856,207,12452
3/1/2014,VA,Virginia,Pulaski,51155,8529,7251,1278,6602,32,6570,1927,27,1900,7981,6703,1278,6027,4822,1205,1626,324,117,3960
3/1/2014,VA,Virginia,Radford City,51750,1969,1656,313,1584,*,*,385,*,*,1810,1497,313,1465,1166,299,319,43,30,1073
3/1/2014,VA,Virginia,Rappahannock,51157,1795,1660,135,1640,*,*,155,*,*,1622,1487,135,999,887,112,145,37,11,806
3/1/2014,VA,Virginia,Richmond,51159,1790,1519,271,1545,17,1528,245,*,*,1687,1416,271,1191,964,227,278,85,23,805
3/1/2014,VA,Virginia,Richmond City,51760,30845,23642,7203,23570,300,23270,7275,357,6918,27791,20589,7202,22015,15162,6853,7981,1395,324,12315
3/1/2014,VA,Virginia,Roanoke,51161,21183,17596,3587,18543,90,18453,2640,48,2592,19646,16059,3587,14191,10843,3348,1884,399,129,11779
3/1/2014,VA,Virginia,Roanoke City,51770,19094,15335,3759,14072,123,13949,5022,137,4885,17503,13745,3758,13433,9847,3586,4471,763,235,7964
3/1/2014,VA,Virginia,Rockbridge,51163,5472,4637,835,4580,21,4559,892,12,880,5126,4291,835,3688,3177,511,825,167,63,2633
3/1/2014,VA,Virginia,Rockingham,51165,15366,13201,2165,13346,54,13292,2020,52,1968,14250,12086,2164,10447,8959,1488,1704,437,145,8161
3/1/2014,VA,Virginia,Russell,51167,7582,5398,2184,4919,13,4906,2663,13,2650,7235,5051,2184,5978,4216,1762,1674,290,121,3893
3/1/2014,VA,Virginia,Salem City,51775,5699,4856,843,4778,30,4748,921,19,902,5236,4393,843,3916,3127,789,788,133,47,2948
3/1/2014,VA,Virginia,Scott,51169,6409,3379,3030,4718,13,4705,1691,11,1680,6134,3104,3030,5217,2248,2969,1525,239,109,3344
3/1/2014,VA,Virginia,Shenandoah,51171,9516,8442,1074,8309,18,8291,1207,25,1182,8918,7844,1074,5875,4969,906,1211,228,98,4338
3/1/2014,VA,Virginia,Smyth,51173,8538,6891,1647,6197,21,6176,2341,25,2316,8071,6424,1647,6342,4841,1501,2091,387,155,3709
3/1/2014,VA,Virginia,Southampton,51175,3733,3300,433,3093,26,3067,640,22,618,3473,3040,433,2635,2267,368,683,132,39,1781
3/1/2014,VA,Virginia,Spotsylvania,51177,17052,15329,1723,14625,97,14528,2427,91,2336,15168,13446,1722,8692,7186,1506,1664,494,117,6417
3/1/2014,VA,Virginia,Stafford,51179,13667,12591,1076,11890,71,11819,1777,89,1688,11961,10887,1074,5771,4843,928,1157,313,75,4226
3/1/2014,VA,Virginia,Staunton City,51790,5735,5139,596,4664,26,4638,1071,28,1043,5401,4805,596,4111,3621,490,1040,148,54,2869
3/1/2014,VA,Virginia,Suffolk City,51800,13681,11465,2216,11023,81,10942,2658,78,2580,12462,10248,2214,8199,6319,1880,2548,389,106,5156
3/1/2014,VA,Virginia,Surry,51181,1404,1114,290,1169,*,*,235,11,224,1294,1004,290,920,649,271,201,69,11,639
3/1/2014,VA,Virginia,Sussex,51183,2277,1903,374,1825,35,1790,452,*,*,2112,1738,374,1580,1226,354,491,144,28,917
3/1/2014,VA,Virginia,Tazewell,51185,11390,8379,3011,8136,34,8102,3254,38,3216,10813,7804,3009,8237,6339,1898,2177,426,160,5474
3/1/2014,VA,Virginia,Unknown,51999,*,*,*,*,*,*,*,*,*,*,*,*,*,*,*,*,*,*,*
3/1/2014,VA,Virginia,Virginia Beach City,51810,60848,52747,8101,53262,319,52943,7586,318,7268,55513,47417,8096,29239,22050,7189,5945,1216,347,21731
3/1/2014,VA,Virginia,Warren,51187,6497,5892,605,5502,23,5479,995,26,969,5949,5344,605,3728,3203,525,799,213,68,2648
3/1/2014,VA,Virginia,Washington,51191,14102,9910,4192,10972,53,10919,3130,15,3115,13270,9080,4190,10323,6465,3858,2467,507,179,7170
3/1/2014,VA,Virginia,Waynesboro City,51820,4628,4113,515,3759,20,3739,869,21,848,4344,3829,515,3322,2888,434,867,95,44,2316
3/1/2014,VA,Virginia,Westmoreland,51193,4512,4102,410,3946,24,3922,566,15,551,4159,3749,410,2496,2140,356,748,120,41,1587
3/1/2014,VA,Virginia,Williamsburg City,51830,2275,1997,278,2090,*,*,185,*,*,2063,1785,278,1355,1119,236,182,*,*,1132
3/1/2014,VA,Virginia,Winchester City,51840,4796,4294,502,4074,16,4058,722,19,703,4378,3876,502,3019,2575,444,785,130,45,2059
3/1/2014,VA,Virginia,Wise,51195,10200,7107,3093,6583,15,6568,3617,18,3599,9596,6504,3092,7331,4473,2858,2381,491,162,4297
3/1/2014,VA,Virginia,Wythe,51197,7189,5834,1355,5491,21,5470,1698,24,1674,6803,5448,1355,5178,4002,1176,1507,273,97,3301
3/1/2014,VA,Virginia,York,51199,10243,9161,1082,9357,39,9318,886,31,855,9296,8217,1079,4622,3620,1002,584,161,45,3832
5/1/2014,VA,Virginia,Accomack,51001,8134,7070,1064,6858,47,6811,1276,44,1232,7583,6520,1063,5378,4458,920,1524,346,87,3421
5/1/2014,VA,Virginia,Albemarle,51003,17198,15661,1537,15660,62,15598,1538,55,1483,15470,13933,1537,11173,9809,1364,1479,256,79,9359
5/1/2014,VA,Virginia,Alexandria City,51510,15402,13917,1485,14026,87,13939,1376,85,1291,12379,10897,1482,6649,5258,1391,1851,357,60,4381
5/1/2014,VA,Virginia,Alleghany,51005,4399,3935,464,3510,20,3490,889,*,*,4166,3702,464,3209,2883,326,820,93,45,2251
5/1/2014,VA,Virginia,Amelia,51007,2770,2246,524,2286,*,*,484,12,472,2550,2026,524,1898,1415,483,463,78,32,1325
5/1/2014,VA,Virginia,Amherst,51009,7178,6113,1065,5879,49,5830,1299,36,1263,6687,5622,1065,5246,4260,986,1169,211,75,3791
5/1/2014,VA,Virginia,Appomattox,51011,3584,3069,515,2892,22,2870,692,13,679,3362,2847,515,2640,2165,475,685,96,52,1807
5/1/2014,VA,Virginia,Arlington,51013,21347,19275,2072,19705,71,19634,1642,77,1565,17052,14980,2072,9237,7316,1921,2769,312,114,6042
5/1/2014,VA,Virginia,Augusta,51015,16214,14144,2070,13796,58,13738,2418,41,2377,15169,13099,2070,11058,9387,1671,1816,363,136,8743
5/1/2014,VA,Virginia,Bath,51017,1245,1169,76,1081,*,*,164,*,*,1168,1092,76,900,838,62,196,34,23,647
5/1/2014,VA,Virginia,Bedford,51019,17440,14701,2739,14709,67,14642,2731,51,2680,16256,13520,2736,12121,9873,2248,1967,436,149,9569
5/1/2014,VA,Virginia,Bland,51021,1692,1359,333,1296,*,*,396,*,*,1606,1274,332,1168,914,254,240,59,17,852
5/1/2014,VA,Virginia,Botetourt,51023,7642,6127,1515,6520,31,6489,1122,13,1109,7046,5531,1515,5166,3818,1348,814,152,60,4140
5/1/2014,VA,Virginia,Bristol City,51520,4441,2750,1691,3409,12,3397,1032,*,*,4178,2487,1691,3390,1747,1643,1016,152,52,2170
5/1/2014,VA,Virginia,Brunswick,51025,3749,3206,543,3013,20,2993,736,31,705,3530,2987,543,2730,2250,480,1059,113,39,1519
5/1/2014,VA,Virginia,Buchanan,51027,7411,4757,2654,4410,18,4392,3001,14,2987,7073,4420,2653,5715,3886,1829,1582,446,117,3570
5/1/2014,VA,Virginia,Buckingham,51029,3183,2766,417,2533,13,2520,650,13,637,2957,2540,417,2214,1863,351,694,146,49,1325
5/1/2014,VA,Virginia,Buena Vista City,51530,1399,1171,228,1110,*,*,289,*,*,1304,1076,228,1009,829,180,330,55,19,605
5/1/2014,VA,Virginia,Campbell,51031,11766,10003,1763,9602,71,9531,2164,65,2099,11040,9277,1763,8610,6995,1615,1978,370,173,6089
5/1/2014,VA,Virginia,Caroline,51033,5103,4367,736,4217,35,4182,886,37,849,4611,3875,736,3010,2333,677,741,224,51,1994
5/1/2014,VA,Virginia,Carroll,51035,7580,6551,1029,5982,18,5964,1598,16,1582,7191,6162,1029,5510,4718,792,1670,286,113,3441
5/1/2014,VA,Virginia,Charles City,51036,1661,1307,354,1387,15,1372,274,14,260,1536,1182,354,1122,854,268,249,72,17,784
5/1/2014,VA,Virginia,Charlotte,51037,3187,2739,448,2574,19,2555,613,11,602,3007,2559,448,2306,1909,397,777,130,49,1350
5/1/2014,VA,Virginia,Charlottesville City,51540,5765,5318,447,4610,21,4589,1155,48,1107,5155,4709,446,4030,3607,423,1223,146,58,2603
5/1/2014,VA,Virginia,Chesapeake City,51550,32210,26999,5211,27302,223,27079,4908,232,4676,28967,23757,5210,16639,12021,4618,3717,818,212,11892
5/1/2014,VA,Virginia,Chesterfield,51041,49085,39241,9844,42137,183,41954,6948,207,6741,44018,34175,9843,31473,22421,9052,4548,876,271,25778
5/1/2014,VA,Virginia,Clarke,51043,2746,2471,275,2495,11,2484,251,*,*,2467,2192,275,1576,1340,236,254,72,29,1221
5/1/2014,VA,Virginia,Colonial Heights City,51570,4007,3548,459,3473,12,3461,534,14,520,3663,3204,459,2171,1748,423,417,93,16,1645
5/1/2014,VA,Virginia,Covington City,51580,1680,1528,152,1286,*,*,394,*,*,1564,1412,152,1200,1060,140,350,55,17,778
5/1/2014,VA,Virginia,Craig,51045,1239,1016,223,934,*,*,305,*,*,1133,910,223,852,634,218,202,38,16,596
5/1/2014,VA,Virginia,Culpeper,51047,8048,7083,965,6851,46,6805,1197,40,1157,7316,6351,965,4798,3968,830,1079,230,73,3416
5/1/2014,VA,Virginia,Cumberland,51049,2072,1700,372,1706,11,1695,366,*,*,1927,1556,371,1444,1105,339,403,74,27,940
5/1/2014,VA,Virginia,Danville City,51590,10953,9235,1718,8544,78,8466,2409,113,2296,10379,8661,1718,8409,7195,1214,3094,426,162,4727
5/1/2014,VA,Virginia,Dickenson,51051,4684,3248,1436,2808,*,*,1876,11,1865,4464,3028,1436,3532,2287,1245,1106,222,97,2107
5/1/2014,VA,Virginia,Dinwiddie,51053,5273,4443,830,4162,38,4124,1111,31,1080,4826,3996,830,3396,2601,795,882,173,52,2289
5/1/2014,VA,Virginia,Emporia City,51595,1187,975,212,887,13,874,300,12,288,1118,906,212,897,733,164,436,62,15,384
5/1/2014,VA,Virginia,Essex,51057,2613,2241,372,2213,13,2200,400,12,388,2434,2062,372,1781,1456,325,420,86,22,1253
5/1/2014,VA,Virginia,Fairfax,51059,128614,113464,15150,120561,481,120080,8053,402,7651,103848,88722,15126,53768,39705,14063,12174,2327,419,38848
5/1/2014,VA,Virginia,Fairfax City,51600,3412,2976,436,3135,13,3122,277,*,*,2874,2438,436,1554,1146,408,363,52,14,1125
5/1/2014,VA,Virginia,Falls Church City,51610,1642,1464,178,1547,*,*,95,*,*,1294,1117,177,714,553,161,139,*,*,550
5/1/2014,VA,Virginia,Fauquier,51061,10656,9654,1002,9584,52,9532,1072,38,1034,9379,8378,1001,5456,4613,843,828,185,55,4388
5/1/2014,VA,Virginia,Floyd,51063,3633,3010,623,3076,*,*,557,*,*,3384,2761,623,2563,1995,568,523,89,44,1907
5/1/2014,VA,Virginia,Fluvanna,51065,5118,4557,561,4562,22,4540,556,22,534,4701,4140,561,3263,2779,484,455,117,20,2671
5/1/2014,VA,Virginia,Franklin,51067,13262,10161,3101,10812,45,10767,2450,25,2425,12420,9319,3101,9676,6840,2836,1929,420,148,7179
5/1/2014,VA,Virginia,Franklin City,51620,1839,1641,198,1406,*,*,433,19,414,1719,1521,198,1367,1196,171,507,77,16,767
5/1/2014,VA,Virginia,Frederick,51069,13686,12146,1540,11988,42,11946,1698,43,1655,12454,10916,1538,8052,6713,1339,1338,330,132,6252
5/1/2014,VA,Virginia,Fredericksburg City,51630,3619,3312,307,2932,16,2916,687,29,658,3268,2961,307,2117,1831,286,731,82,37,1267
5/1/2014,VA,Virginia,Galax City,51640,1949,1829,120,1493,*,*,456,11,445,1862,1742,120,1450,1355,95,672,67,32,679
5/1/2014,VA,Virginia,Giles,51071,4356,3440,916,3382,19,3363,974,12,962,4087,3172,915,3234,2393,841,765,126,32,2311
5/1/2014,VA,Virginia,Gloucester,51073,7472,6465,1007,6382,35,6347,1090,17,1073,6857,5850,1007,4166,3293,873,885,174,63,3044
5/1/2014,VA,Virginia,Goochland,51075,4736,3906,830,4257,20,4237,479,17,462,4270,3440,830,3245,2505,740,401,97,34,2713
5/1/2014,VA,Virginia,Grayson,51077,4394,3920,474,3558,16,3542,836,*,*,4225,3751,474,3069,2662,407,990,177,81,1821
5/1/2014,VA,Virginia,Greene,51079,3240,2884,356,2800,13,2787,440,12,428,2978,2622,356,2062,1732,330,424,78,22,1538
5/1/2014,VA,Virginia,Greensville,51081,2298,1753,545,1824,18,1806,474,18,456,2135,1590,545,1747,1266,481,538,127,26,1056
5/1/2014,VA,Virginia,Halifax,51083,9171,7962,1209,7314,57,7257,1857,60,1797,8616,7408,1208,6849,5736,1113,2191,420,133,4105
5/1/2014,VA,Virginia,Hampton City,51650,22702,18552,4150,18455,200,18255,4247,207,4040,20747,16597,4150,11797,7980,3817,3347,742,187,7521
5/1/2014,VA,Virginia,Hanover,51085,17688,14211,3477,15849,66,15783,1839,44,1795,16103,12626,3477,11940,8895,3045,1339,331,98,10172
5/1/2014,VA,Virginia,Harrisonburg City,51660,4887,4403,484,4086,18,4068,801,20,781,4468,3984,484,3383,3028,355,877,124,44,2338
5/1/2014,VA,Virginia,Henrico,51087,48834,38361,10473,42142,311,41831,6692,294,6398,44231,33760,10471,33042,23584,9458,5478,1212,360,25992
5/1/2014,VA,Virginia,Henry,51089,14679,10631,4048,11440,68,11372,3239,65,3174,14004,9956,4048,11691,8600,3091,3081,653,227,7730
5/1/2014,VA,Virginia,Highland,51091,688,626,62,624,*,*,64,0,64,643,581,62,466,409,57,67,*,*,369
5/1/2014,VA,Virginia,Hopewell City,51670,4281,3698,583,3317,24,3293,964,33,931,3976,3393,583,2600,2035,565,876,138,36,1550
5/1/2014,VA,Virginia,Isle of Wight,51093,7029,5649,1380,6084,39,6045,945,30,915,6527,5147,1380,4482,3183,1299,846,180,77,3379
5/1/2014,VA,Virginia,James City,51095,17349,15538,1811,16236,51,16185,1113,40,1073,16022,14214,1808,9209,7641,1568,814,180,41,8174
5/1/2014,VA,Virginia,King and Queen,51097,1579,1382,197,1309,*,*,270,*,*,1478,1281,197,1091,913,178,260,79,11,741
5/1/2014,VA,Virginia,King George,51099,3242,3009,233,2761,18,2743,481,20,461,2818,2585,233,1380,1164,216,411,82,21,866
5/1/2014,VA,Virginia,King William,51101,2851,2499,352,2433,16,2417,418,21,397,2623,2271,352,2021,1721,300,365,81,20,1555
5/1/2014,VA,Virginia,Lancaster,51103,4096,3641,455,3753,16,3737,343,15,328,3898,3443,455,2598,2266,332,471,78,29,2020
5/1/2014,VA,Virginia,Lee,51105,6244,4314,1930,4097,15,4082,2147,17,2130,5905,3978,1927,4642,2850,1792,1910,249,79,2404
5/1/2014,VA,Virginia,Lexington City,51678,1584,1463,121,1439,12,1427,145,*,*,1481,1360,121,1099,1008,91,216,34,12,837
5/1/2014,VA,Virginia,Loudoun,51107,28421,24813,3608,26290,89,26201,2131,99,2032,23516,19912,3604,13939,10647,3292,2420,508,121,10890
5/1/2014,VA,Virginia,Louisa,51109,6751,5782,969,5599,36,5563,1152,31,1121,6187,5218,969,4334,3441,893,1012,252,67,3003
5/1/2014,VA,Virginia,Lunenburg,51111,2837,2509,328,2285,15,2270,552,22,530,2623,2295,328,1920,1616,304,670,118,36,1096
5/1/2014,VA,Virginia,Lynchburg City,51680,14147,12279,1868,11077,81,10996,3070,103,2967,13174,11307,1867,10404,8696,1708,3305,436,141,6522
5/1/2014,VA,Virginia,Madison,51113,2697,2412,285,2353,*,*,344,*,*,2513,2228,285,1770,1508,262,399,71,23,1277
5/1/2014,VA,Virginia,Manassas City,51683,3782,3270,512,3264,21,3243,518,32,486,3235,2724,511,2175,1689,486,506,98,28,1543
5/1/2014,VA,Virginia,Manassas Park City,51685,1041,877,164,887,*,*,154,11,143,880,716,164,576,427,149,144,*,*,389
5/1/2014,VA,Virginia,Martinsville City,51690,3918,3084,834,2914,22,2892,1004,35,969,3732,2898,834,3185,2545,640,1299,160,58,1668
5/1/2014,VA,Virginia,Mathews,51115,2632,2314,318,2390,*,*,242,*,*,2493,2175,318,1563,1283,280,245,50,19,1249
5/1/2014,VA,Virginia,Mecklenburg,51117,8718,7291,1427,7094,50,7044,1624,55,1569,8216,6791,1425,6306,5157,1149,1861,375,104,3966
5/1/2014,VA,Virginia,Middlesex,51119,3324,2875,449,2963,17,2946,361,*,*,3114,2666,448,2239,1888,351,402,93,22,1722
5/1/2014,VA,Virginia,Montgomery,51121,12420,10613,1807,10116,28,10088,2304,25,2279,11315,9508,1807,8866,7167,1699,1776,286,110,6694
5/1/2014,VA,Virginia,Nelson,51125,4045,3621,424,3501,14,3487,544,15,529,3735,3311,424,2639,2255,384,602,104,36,1897
5/1/2014,VA,Virginia,New Kent,51127,3543,2966,577,3095,16,3079,448,11,437,3212,2635,577,2136,1667,469,273,72,23,1768
5/1/2014,VA,Virginia,Newport News City,51700,25461,20316,5145,20812,169,20643,4649,220,4429,23309,18165,5144,14538,9701,4837,4274,761,210,9293
5/1/2014,VA,Virginia,Norfolk City,51710,29885,24198,5687,23562,238,23324,6323,328,5995,26932,21245,5687,17048,11876,5172,6642,1179,271,8956
5/1/2014,VA,Virginia,Northampton,51131,3313,2917,396,2802,32,2770,511,30,481,3117,2721,396,2435,2080,355,901,100,34,1400
5/1/2014,VA,Virginia,Northumberland,51133,4467,4032,435,4115,11,4104,352,*,*,4184,3749,435,2598,2292,306,427,87,30,2054
5/1/2014,VA,Virginia,Norton City,51720,1168,888,280,733,*,*,435,*,*,1077,797,280,836,572,264,354,51,21,410
5/1/2014,VA,Virginia,Nottoway,51135,3499,3026,473,2838,25,2813,661,14,647,3222,2749,473,2422,2104,318,902,118,48,1354
5/1/2014,VA,Virginia,Orange,51137,7945,7162,783,6929,41,6888,1016,30,986,7303,6521,782,4495,3843,652,912,237,61,3285
5/1/2014,VA,Virginia,Page,51139,5687,5040,647,4596,21,4575,1091,14,1077,5329,4682,647,3760,3183,577,1092,204,90,2374
5/1/2014,VA,Virginia,Patrick,51141,4939,3821,1118,4000,14,3986,939,13,926,4713,3596,1117,3736,2810,926,1001,179,80,2476
5/1/2014,VA,Virginia,Petersburg City,51730,6984,5900,1084,5060,79,4981,1924,87,1837,6366,5282,1084,4460,3456,1004,2012,328,81,2039
5/1/2014,VA,Virginia,Pittsylvania,51143,15019,12472,2547,12033,95,11938,2986,86,2900,14238,11691,2547,11457,9196,2261,3096,551,212,7598
5/1/2014,VA,Virginia,Poquoson City,51735,2339,2101,238,2156,*,*,183,*,*,2132,1894,238,983,775,208,105,*,*,847
5/1/2014,VA,Virginia,Portsmouth City,51740,16976,13684,3292,13095,180,12915,3881,208,3673,15146,11854,3292,9210,6189,3021,3556,669,147,4838
5/1/2014,VA,Virginia,Powhatan,51145,5025,4095,930,4412,21,4391,613,19,594,4566,3636,930,3391,2553,838,374,90,32,2895
5/1/2014,VA,Virginia,Prince Edward,51147,4339,3731,608,3397,26,3371,942,31,911,4034,3426,608,3041,2567,474,1036,172,44,1789
5/1/2014,VA,Virginia,Prince George,51149,5111,4555,556,4259,25,4234,852,27,825,4726,4170,556,2679,2163,516,527,107,25,2020
5/1/2014,VA,Virginia,Prince William,51153,38871,33610,5261,34229,195,34034,4642,295,4347,33058,27802,5256,17792,12922,4870,4210,857,195,12530
5/1/2014,VA,Virginia,Pulaski,51155,8567,7280,1287,6617,31,6586,1950,27,1923,8009,6722,1287,6051,4838,1213,1637,318,118,3978
5/1/2014,VA,Virginia,Radford City,51750,1972,1656,316,1586,*,*,386,*,*,1812,1496,316,1468,1166,302,325,43,28,1072
5/1/2014,VA,Virginia,Rappahannock,51157,1807,1671,136,1651,*,*,156,*,*,1630,1494,136,1009,896,113,148,36,11,814
5/1/2014,VA,Virginia,Richmond,51159,1797,1519,278,1552,16,1536,245,*,*,1690,1412,278,1194,960,234,280,84,23,807
5/1/2014,VA,Virginia,Richmond City,51760,30946,23488,7458,23621,293,23328,7325,356,6969,27852,20394,7458,22118,15005,7113,8057,1379,299,12383
5/1/2014,VA,Virginia,Roanoke,51161,21243,17653,3590,18578,90,18488,2665,48,2617,19691,16101,3590,14286,10934,3352,1910,390,121,11865
5/1/2014,VA,Virginia,Roanoke City,51770,19167,15374,3793,14086,121,13965,5081,139,4942,17564,13772,3792,13512,9891,3621,4524,757,230,8001
5/1/2014,VA,Virginia,Rockbridge,51163,5494,4664,830,4592,20,4572,902,12,890,5141,4311,830,3711,3208,503,844,165,60,2642
5/1/2014,VA,Virginia,Rockingham,51165,15430,13287,2143,13389,53,13336,2041,53,1988,14297,12155,2142,10500,9024,1476,1721,443,137,8199
5/1/2014,VA,Virginia,Russell,51167,7593,5423,2170,4925,13,4912,2668,12,2656,7237,5067,2170,5972,4216,1756,1684,288,118,3882
5/1/2014,VA,Virginia,Salem City,51775,5720,4871,849,4790,24,4766,930,20,910,5243,4394,849,3934,3138,796,794,128,43,2969
5/1/2014,VA,Virginia,Scott,51169,6414,3368,3046,4708,11,4697,1706,13,1693,6134,3088,3046,5218,2233,2985,1538,237,105,3338
5/1/2014,VA,Virginia,Shenandoah,51171,9555,8487,1068,8331,18,8313,1224,25,1199,8946,7878,1068,5905,5003,902,1220,231,94,4360
5/1/2014,VA,Virginia,Smyth,51173,8558,6906,1652,6215,20,6195,2343,23,2320,8088,6436,1652,6355,4849,1506,2111,376,148,3720
5/1/2014,VA,Virginia,Southampton,51175,3743,3292,451,3091,25,3066,652,22,630,3492,3041,451,2660,2272,388,702,131,38,1789
5/1/2014,VA,Virginia,Spotsylvania,51177,17164,15413,1751,14694,94,14600,2470,92,2378,15250,13500,1750,8735,7203,1532,1696,480,111,6448
5/1/2014,VA,Virginia,Stafford,51179,13782,12677,1105,11981,71,11910,1801,91,1710,12036,10933,1103,5815,4856,959,1182,313,71,4249
5/1/2014,VA,Virginia,Staunton City,51790,5744,5154,590,4665,26,4639,1079,28,1051,5405,4815,590,4125,3644,481,1050,146,51,2878
5/1/2014,VA,Virginia,Suffolk City,51800,13760,11473,2287,11076,78,10998,2684,79,2605,12530,10245,2285,8251,6291,1960,2566,396,99,5190
5/1/2014,VA,Virginia,Surry,51181,1408,1110,298,1173,*,*,235,11,224,1301,1003,298,923,644,279,203,66,12,642
5/1/2014,VA,Virginia,Sussex,51183,2287,1905,382,1828,35,1793,459,*,*,2120,1738,382,1576,1214,362,489,136,26,925
5/1/2014,VA,Virginia,Tazewell,51185,11430,8429,3001,8155,34,8121,3275,38,3237,10847,7848,2999,8245,6339,1906,2195,418,157,5475
5/1/2014,VA,Virginia,Unknown,51999,*,*,*,*,*,*,*,*,*,*,*,*,*,*,*,*,*,*,*
5/1/2014,VA,Virginia,Virginia Beach City,51810,61127,52826,8301,53442,308,53134,7685,319,7366,55709,47414,8295,29461,22063,7398,6021,1223,321,21896
5/1/2014,VA,Virginia,Warren,51187,6525,5922,603,5513,22,5491,1012,27,985,5967,5364,603,3746,3224,522,811,217,66,2652
5/1/2014,VA,Virginia,Washington,51191,14132,9943,4189,10984,51,10933,3148,15,3133,13288,9101,4187,10353,6495,3858,2490,496,170,7197
5/1/2014,VA,Virginia,Waynesboro City,51820,4638,4132,506,3765,20,3745,873,21,852,4349,3843,506,3342,2915,427,877,96,40,2329
5/1/2014,VA,Virginia,Westmoreland,51193,4517,4096,421,3945,22,3923,572,14,558,4163,3742,421,2498,2131,367,745,118,41,1594
5/1/2014,VA,Virginia,Williamsburg City,51830,2290,2011,279,2102,*,*,188,*,*,2076,1797,279,1366,1130,236,186,*,*,1142
5/1/2014,VA,Virginia,Winchester City,51840,4814,4326,488,4085,16,4069,729,19,710,4398,3910,488,3029,2600,429,788,126,44,2071
5/1/2014,VA,Virginia,Wise,51195,10187,7089,3098,6564,14,6550,3623,18,3605,9588,6491,3097,7307,4435,2872,2380,482,149,4296
5/1/2014,VA,Virginia,Wythe,51197,7193,5840,1353,5488,21,5467,1705,23,1682,6806,5453,1353,5182,4009,1173,1518,266,95,3303
5/1/2014,VA,Virginia,York,51199,10289,9200,1089,9397,36,9361,892,30,862,9350,8264,1086,4654,3641,1013,589,158,47,3860
11/1/2014,VA,Virginia,Accomack,51001,8221,7121,1100,6900,44,6856,1321,42,1279,7704,6604,1100,5438,4482,956,1551,360,89,3438
11/1/2014,VA,Virginia,Albemarle,51003,17506,15668,1838,15897,57,15840,1609,55,1554,15779,13941,1838,11392,9720,1672,1507,249,84,9552
11/1/2014,VA,Virginia,Alexandria City,51510,15815,14256,1559,14401,81,14320,1414,88,1326,12737,11181,1556,6846,5380,1466,1944,341,66,4495
11/1/2014,VA,Virginia,Alleghany,51005,4413,3774,639,3498,19,3479,915,*,*,4187,3548,639,3230,2724,506,844,90,44,2252
11/1/2014,VA,Virginia,Amelia,51007,2817,2185,632,2323,*,*,494,11,483,2609,1977,632,1940,1352,588,485,76,34,1345
11/1/2014,VA,Virginia,Amherst,51009,7291,6206,1085,5940,42,5898,1351,36,1315,6792,5707,1085,5299,4289,1010,1198,217,73,3811
11/1/2014,VA,Virginia,Appomattox,51011,3639,3116,523,2912,22,2890,727,14,713,3421,2898,523,2670,2189,481,703,100,51,1816
11/1/2014,VA,Virginia,Arlington,51013,21840,19647,2193,20157,67,20090,1683,79,1604,17459,15267,2192,9461,7425,2036,2853,315,118,6175
11/1/2014,VA,Virginia,Augusta,51015,16410,14078,2332,13907,48,13859,2503,43,2460,15388,13056,2332,11227,9284,1943,1867,366,137,8857
11/1/2014,VA,Virginia,Bath,51017,1266,1140,126,1097,*,*,169,*,*,1183,1057,126,907,795,112,203,33,25,646
11/1/2014,VA,Virginia,Bedford,51019,17707,14589,3118,14884,57,14827,2823,47,2776,16541,13426,3115,12373,9735,2638,2021,432,147,9773
11/1/2014,VA,Virginia,Bland,51021,1719,1389,330,1313,*,*,406,*,*,1626,1296,330,1188,935,253,248,57,18,865
11/1/2014,VA,Virginia,Botetourt,51023,7791,6067,1724,6639,27,6612,1152,15,1137,7176,5452,1724,5442,3886,1556,823,157,60,4402
11/1/2014,VA,Virginia,Bristol City,51520,4432,2741,1691,3375,*,*,1057,*,*,4175,2484,1691,3396,1752,1644,1041,144,57,2154
11/1/2014,VA,Virginia,Brunswick,51025,3804,3096,708,3049,19,3030,755,30,725,3588,2880,708,2767,2121,646,1096,107,38,1526
11/1/2014,VA,Virginia,Buchanan,51027,7380,4728,2652,4356,15,4341,3024,14,3010,7083,4432,2651,5695,3856,1839,1634,432,115,3514
11/1/2014,VA,Virginia,Buckingham,51029,3259,2638,621,2589,13,2576,670,13,657,3024,2403,621,2260,1706,554,714,144,47,1355
11/1/2014,VA,Virginia,Buena Vista City,51530,1415,1120,295,1120,*,*,295,*,*,1321,1026,295,1012,766,246,334,54,18,606
11/1/2014,VA,Virginia,Campbell,51031,11902,10131,1771,9659,63,9596,2243,65,2178,11161,9390,1771,8708,7084,1624,2036,361,173,6138
11/1/2014,VA,Virginia,Caroline,51033,5217,4346,871,4300,35,4265,917,36,881,4735,3864,871,3068,2257,811,769,230,50,2019
11/1/2014,VA,Virginia,Carroll,51035,7679,6646,1033,6033,17,6016,1646,18,1628,7296,6263,1033,5539,4743,796,1707,279,115,3438
11/1/2014,VA,Virginia,Charles City,51036,1684,1276,408,1401,14,1387,283,14,269,1566,1158,408,1143,825,318,253,76,17,797
11/1/2014,VA,Virginia,Charlotte,51037,3239,2776,463,2600,19,2581,639,11,628,3060,2597,463,2337,1924,413,798,124,52,1363
11/1/2014,VA,Virginia,Charlottesville City,51540,5841,5070,771,4669,20,4649,1172,46,1126,5238,4468,770,4097,3350,747,1256,144,58,2639
11/1/2014,VA,Virginia,Chesapeake City,51550,32857,26985,5872,27757,205,27552,5100,237,4863,29563,23691,5872,17087,11771,5316,3860,814,223,12190
11/1/2014,VA,Virginia,Chesterfield,51041,50297,39541,10756,43109,157,42952,7188,212,6976,45100,34345,10755,32334,22346,9988,4686,900,271,26477
11/1/2014,VA,Virginia,Clarke,51043,2793,2521,272,2532,*,*,261,*,*,2527,2255,272,1608,1376,232,263,69,28,1248
11/1/2014,VA,Virginia,Colonial Heights City,51570,4044,3521,523,3485,*,*,559,15,544,3704,3181,523,2176,1688,488,421,94,17,1644
11/1/2014,VA,Virginia,Covington City,51580,1693,1456,237,1292,*,*,401,*,*,1582,1345,237,1210,985,225,362,56,17,775
11/1/2014,VA,Virginia,Craig,51045,1259,992,267,948,*,*,311,*,*,1153,886,267,881,617,264,207,40,16,618
11/1/2014,VA,Virginia,Culpeper,51047,8173,6951,1222,6923,42,6881,1250,41,1209,7457,6235,1222,4863,3770,1093,1122,230,72,3439
11/1/2014,VA,Virginia,Cumberland,51049,2114,1663,451,1732,11,1721,382,*,*,1968,1519,449,1476,1057,419,424,76,27,949
11/1/2014,VA,Virginia,Danville City,51590,11004,9294,1710,8549,70,8479,2455,107,2348,10437,8727,1710,8464,7255,1209,3168,421,177,4698
11/1/2014,VA,Virginia,Dickenson,51051,4724,3258,1466,2781,*,*,1943,*,*,4500,3034,1466,3561,2283,1278,1130,215,97,2119
11/1/2014,VA,Virginia,Dinwiddie,51053,5376,4357,1019,4226,34,4192,1150,30,1120,4933,3914,1019,3461,2478,983,899,176,54,2332
11/1/2014,VA,Virginia,Emporia City,51595,1181,898,283,872,11,861,309,13,296,1110,827,283,895,647,248,443,66,14,372
11/1/2014,VA,Virginia,Essex,51057,2664,2216,448,2249,12,2237,415,13,402,2490,2042,448,1831,1428,403,436,92,25,1278
11/1/2014,VA,Virginia,Fairfax,51059,132555,116782,15773,124160,443,123717,8395,417,7978,107189,91444,15745,55665,41015,14650,12659,2415,443,40148
11/1/2014,VA,Virginia,Fairfax City,51600,3495,3050,445,3207,12,3195,288,*,*,2947,2502,445,1583,1165,418,376,53,16,1138
11/1/2014,VA,Virginia,Falls Church City,51610,1686,1500,186,1592,*,*,94,*,*,1330,1145,185,716,547,169,138,*,*,555
11/1/2014,VA,Virginia,Fauquier,51061,10881,9863,1018,9756,42,9714,1125,40,1085,9613,8596,1017,5582,4722,860,859,186,54,4483
11/1/2014,VA,Virginia,Floyd,51063,3706,2994,712,3133,*,*,573,*,*,3445,2733,712,2614,1958,656,539,87,49,1939
11/1/2014,VA,Virginia,Fluvanna,51065,5226,4549,677,4653,21,4632,573,26,547,4802,4125,677,3330,2729,601,462,116,21,2731
11/1/2014,VA,Virginia,Franklin,51067,13457,9986,3471,10930,37,10893,2527,24,2503,12645,9174,3471,9924,6707,3217,1998,428,151,7347
11/1/2014,VA,Virginia,Franklin City,51620,1865,1567,298,1418,*,*,447,19,428,1754,1456,298,1382,1109,273,526,77,16,763
11/1/2014,VA,Virginia,Frederick,51069,13922,12403,1519,12165,37,12128,1757,43,1714,12697,11180,1517,8208,6886,1322,1418,325,128,6337
11/1/2014,VA,Virginia,Fredericksburg City,51630,3674,3258,416,2964,14,2950,710,30,680,3311,2895,416,2149,1754,395,763,82,40,1264
11/1/2014,VA,Virginia,Galax City,51640,1948,1826,122,1483,*,*,465,11,454,1853,1731,122,1438,1341,97,666,68,30,674
11/1/2014,VA,Virginia,Giles,51071,4394,3267,1127,3401,18,3383,993,*,*,4134,3008,1126,3299,2248,1051,786,130,38,2345
11/1/2014,VA,Virginia,Gloucester,51073,7613,6455,1158,6468,27,6441,1145,17,1128,6994,5836,1158,4238,3209,1029,923,169,60,3086
11/1/2014,VA,Virginia,Goochland,51075,4823,3916,907,4333,17,4316,490,17,473,4369,3462,907,3314,2499,815,405,96,33,2780
11/1/2014,VA,Virginia,Grayson,51077,4423,3937,486,3552,15,3537,871,*,*,4251,3765,486,3088,2666,422,1005,177,83,1823
11/1/2014,VA,Virginia,Greene,51079,3281,2834,447,2834,13,2821,447,12,435,3008,2561,447,2076,1657,419,416,76,20,1564
11/1/2014,VA,Virginia,Greensville,51081,2325,1713,612,1833,18,1815,492,18,474,2161,1549,612,1762,1207,555,551,129,21,1061
11/1/2014,VA,Virginia,Halifax,51083,9214,8015,1199,7316,52,7264,1898,61,1837,8652,7454,1198,6843,5739,1104,2220,425,134,4064
11/1/2014,VA,Virginia,Hampton City,51650,23067,18270,4797,18663,177,18486,4404,209,4195,21133,16336,4797,12033,7551,4482,3494,754,190,7595
11/1/2014,VA,Virginia,Hanover,51085,17981,14229,3752,16085,57,16028,1896,43,1853,16379,12627,3752,12186,8861,3325,1384,330,97,10375
11/1/2014,VA,Virginia,Harrisonburg City,51660,4972,4428,544,4142,17,4125,830,19,811,4543,3999,544,3450,3035,415,934,112,44,2360
11/1/2014,VA,Virginia,Henrico,51087,49698,38078,11620,42777,286,42491,6921,296,6625,45041,33423,11618,33712,23093,10619,5698,1214,376,26424
11/1/2014,VA,Virginia,Henry,51089,14796,10760,4036,11467,58,11409,3329,65,3264,14111,10075,4036,11759,8655,3104,3170,654,235,7700
11/1/2014,VA,Virginia,Highland,51091,706,637,69,642,*,*,64,0,64,666,597,69,476,413,63,68,*,*,380
11/1/2014,VA,Virginia,Hopewell City,51670,4308,3545,763,3320,21,3299,988,32,956,4014,3251,763,2638,1891,747,915,140,36,1547
11/1/2014,VA,Virginia,Isle of Wight,51093,7175,5647,1528,6190,34,6156,985,32,953,6659,5131,1528,4573,3121,1452,874,184,76,3439
11/1/2014,VA,Virginia,James City,51095,17607,15666,1941,16452,45,16407,1155,40,1115,16300,14362,1938,9386,7689,1697,840,176,39,8331
11/1/2014,VA,Virginia,King and Queen,51097,1614,1352,262,1337,*,*,277,*,*,1509,1247,262,1106,864,242,277,75,11,743
11/1/2014,VA,Virginia,King George,51099,3334,3012,322,2832,16,2816,502,21,481,2894,2572,322,1393,1089,304,434,76,24,859
11/1/2014,VA,Virginia,King William,51101,2912,2508,404,2478,15,2463,434,22,412,2675,2271,404,2046,1695,351,372,79,21,1574
11/1/2014,VA,Virginia,Lancaster,51103,4114,3583,531,3758,15,3743,356,14,342,3935,3404,531,2637,2224,413,483,77,31,2046
11/1/2014,VA,Virginia,Lee,51105,6263,4317,1946,4079,13,4066,2184,15,2169,5946,4003,1943,4668,2854,1814,1956,244,75,2393
11/1/2014,VA,Virginia,Lexington City,51678,1582,1416,166,1437,12,1425,145,*,*,1478,1312,166,1092,955,137,215,*,*,838
11/1/2014,VA,Virginia,Loudoun,51107,29314,25797,3517,27089,79,27010,2225,100,2125,24248,20735,3513,14412,11209,3203,2557,523,122,11210
11/1/2014,VA,Virginia,Louisa,51109,6897,5714,1183,5692,32,5660,1205,34,1171,6326,5143,1183,4440,3337,1103,1047,241,66,3086
11/1/2014,VA,Virginia,Lunenburg,51111,2879,2454,425,2309,14,2295,570,21,549,2667,2242,425,1936,1534,402,681,119,36,1100
11/1/2014,VA,Virginia,Lynchburg City,51680,14174,12284,1890,11037,77,10960,3137,105,3032,13213,11324,1889,10434,8698,1736,3366,422,141,6505
11/1/2014,VA,Virginia,Madison,51113,2728,2353,375,2376,*,*,352,*,*,2552,2177,375,1794,1443,351,394,74,24,1302
11/1/2014,VA,Virginia,Manassas City,51683,3903,3271,632,3355,20,3335,548,32,516,3326,2695,631,2205,1598,607,515,98,30,1562
11/1/2014,VA,Virginia,Manassas Park City,51685,1081,914,167,922,*,*,159,11,148,910,743,167,591,436,155,155,*,*,387
11/1/2014,VA,Virginia,Martinsville City,51690,3915,3074,841,2895,19,2876,1020,35,985,3729,2888,841,3186,2541,645,1320,160,59,1647
11/1/2014,VA,Virginia,Mathews,51115,2677,2324,353,2422,*,*,255,*,*,2538,2185,353,1605,1287,318,256,48,19,1282
11/1/2014,VA,Virginia,Mecklenburg,51117,8825,7385,1440,7165,44,7121,1660,52,1608,8325,6887,1438,6379,5222,1157,1923,370,105,3981
11/1/2014,VA,Virginia,Middlesex,51119,3369,2846,523,2996,15,2981,373,*,*,3175,2653,522,2280,1858,422,420,91,22,1747
11/1/2014,VA,Virginia,Montgomery,51121,12654,10468,2186,10283,27,10256,2371,29,2342,11515,9329,2186,9027,6947,2080,1822,280,112,6813
11/1/2014,VA,Virginia,Nelson,51125,4109,3562,547,3553,13,3540,556,15,541,3797,3250,547,2689,2181,508,618,98,39,1934
11/1/2014,VA,Virginia,New Kent,51127,3620,2996,624,3157,13,3144,463,12,451,3304,2680,624,2184,1675,509,286,68,22,1808
11/1/2014,VA,Virginia,Newport News City,51700,25831,19911,5920,21021,155,20866,4810,231,4579,23678,17760,5918,14751,9119,5632,4430,740,220,9361
11/1/2014,VA,Virginia,Norfolk City,51710,30435,23473,6962,23863,218,23645,6572,343,6229,27473,20511,6962,17468,10960,6508,6890,1179,282,9117
11/1/2014,VA,Virginia,Northampton,51131,3334,2791,543,2801,30,2771,533,32,501,3137,2594,543,2442,1938,504,901,102,37,1402
11/1/2014,VA,Virginia,Northumberland,51133,4506,3994,512,4141,*,*,365,*,*,4235,3723,512,2612,2222,390,443,88,34,2047
11/1/2014,VA,Virginia,Norton City,51720,1192,901,291,745,*,*,447,*,*,1107,816,291,859,584,275,366,49,21,423
11/1/2014,VA,Virginia,Nottoway,51135,3529,2881,648,2842,25,2817,687,15,672,3267,2619,648,2473,1976,497,931,116,45,1381
11/1/2014,VA,Virginia,Orange,51137,8051,7050,1001,7004,40,6964,1047,29,1018,7417,6417,1000,4572,3706,866,944,230,62,3336
11/1/2014,VA,Virginia,Page,51139,5750,5093,657,4622,18,4604,1128,15,1113,5396,4739,657,3825,3235,590,1143,202,87,2393
11/1/2014,VA,Virginia,Patrick,51141,4980,3757,1223,4021,12,4009,959,13,946,4756,3534,1222,3777,2741,1036,1020,173,82,2502
11/1/2014,VA,Virginia,Petersburg City,51730,7027,5446,1581,5052,71,4981,1975,91,1884,6424,4843,1581,4478,2965,1513,2047,325,80,2026
11/1/2014,VA,Virginia,Pittsylvania,51143,15157,12598,2559,12105,87,12018,3052,85,2967,14373,11814,2559,11548,9275,2273,3154,559,213,7622
11/1/2014,VA,Virginia,Poquoson City,51735,2380,2125,255,2190,*,*,190,0,190,2170,1915,255,1003,775,228,103,*,*,866
11/1/2014,VA,Virginia,Portsmouth City,51740,17184,13179,4005,13172,160,13012,4012,205,3807,15354,11349,4005,9381,5620,3761,3706,657,152,4866
11/1/2014,VA,Virginia,Powhatan,51145,5150,4131,1019,4521,20,4501,629,19,610,4695,3676,1019,3516,2591,925,392,95,34,2995
11/1/2014,VA,Virginia,Prince Edward,51147,4368,3563,805,3410,22,3388,958,32,926,4069,3264,805,3057,2384,673,1048,167,45,1797
11/1/2014,VA,Virginia,Prince George,51149,5212,4552,660,4332,23,4309,880,26,854,4829,4169,660,2735,2114,621,547,110,23,2055
11/1/2014,VA,Virginia,Prince William,51153,40071,33702,6369,35226,185,35041,4845,300,4545,34196,27833,6363,18264,12288,5976,4389,890,192,12793
11/1/2014,VA,Virginia,Pulaski,51155,8651,7092,1559,6649,26,6623,2002,28,1974,8113,6554,1559,6105,4621,1484,1696,309,118,3982
11/1/2014,VA,Virginia,Radford City,51750,1974,1593,381,1582,*,*,392,*,*,1821,1440,381,1470,1103,367,323,43,30,1074
11/1/2014,VA,Virginia,Rappahannock,51157,1841,1703,138,1680,*,*,161,*,*,1674,1536,138,1032,917,115,156,39,11,826
11/1/2014,VA,Virginia,Richmond,51159,1817,1492,325,1568,16,1552,249,*,*,1713,1388,325,1199,917,282,285,84,23,807
11/1/2014,VA,Virginia,Richmond City,51760,31421,22192,9229,23883,259,23624,7538,356,7182,28299,19070,9229,22451,13544,8907,8363,1351,313,12424
11/1/2014,VA,Virginia,Roanoke,51161,21566,17574,3992,18809,81,18728,2757,51,2706,19987,15995,3992,15131,11380,3751,1955,381,130,12665
11/1/2014,VA,Virginia,Roanoke City,51770,19457,14468,4989,14208,110,14098,5249,145,5104,17862,12874,4988,14009,9193,4816,4738,751,237,8283
11/1/2014,VA,Virginia,Rockbridge,51163,5573,4608,965,4653,18,4635,920,11,909,5215,4250,965,3748,3110,638,838,164,60,2686
11/1/2014,VA,Virginia,Rockingham,51165,15667,13281,2386,13565,46,13519,2102,52,2050,14506,12121,2385,10687,8967,1720,1768,452,144,8323
11/1/2014,VA,Virginia,Russell,51167,7659,5471,2188,4942,11,4931,2717,*,*,7305,5117,2188,6036,4260,1776,1725,284,125,3902
11/1/2014,VA,Virginia,Salem City,51775,5752,4695,1057,4793,22,4771,959,23,936,5283,4226,1057,4029,3024,1005,804,128,45,3052
11/1/2014,VA,Virginia,Scott,51169,6468,3405,3063,4734,*,*,1734,12,1722,6190,3127,3063,5260,2257,3003,1564,243,110,3343
11/1/2014,VA,Virginia,Shenandoah,51171,9700,8637,1063,8432,17,8415,1268,25,1243,9081,8018,1063,6002,5107,895,1264,238,95,4405
11/1/2014,VA,Virginia,Smyth,51173,8610,6905,1705,6219,16,6203,2391,22,2369,8142,6437,1705,6395,4845,1550,2150,382,149,3714
11/1/2014,VA,Virginia,Southampton,51175,3820,3213,607,3135,22,3113,685,24,661,3560,2953,607,2700,2151,549,723,130,38,1809
11/1/2014,VA,Virginia,Spotsylvania,51177,17567,15552,2015,15017,82,14935,2550,87,2463,15642,13628,2014,8943,7146,1797,1809,483,115,6536
11/1/2014,VA,Virginia,Stafford,51179,14190,12932,1258,12291,66,12225,1899,93,1806,12426,11169,1257,5950,4836,1114,1219,314,75,4342
11/1/2014,VA,Virginia,Staunton City,51790,5758,5114,644,4658,24,4634,1100,27,1073,5416,4772,644,4127,3589,538,1062,148,54,2863
11/1/2014,VA,Virginia,Suffolk City,51800,14022,11297,2725,11254,75,11179,2768,79,2689,12784,10061,2723,8395,5973,2422,2627,384,106,5278
11/1/2014,VA,Virginia,Surry,51181,1444,1109,335,1204,*,*,240,11,229,1330,995,335,940,622,318,212,64,11,653
11/1/2014,VA,Virginia,Sussex,51183,2303,1824,479,1827,32,1795,476,*,*,2144,1665,479,1609,1150,459,499,137,26,947
11/1/2014,VA,Virginia,Tazewell,51185,11566,8552,3014,8198,32,8166,3368,38,3330,10969,7957,3012,8372,6444,1928,2254,423,160,5535
11/1/2014,VA,Virginia,Unknown,51999,*,*,*,*,*,*,*,*,*,*,*,*,*,*,*,*,*,*,*
11/1/2014,VA,Virginia,Virginia Beach City,51810,62413,52979,9434,54416,278,54138,7997,321,7676,56995,47566,9429,30314,21750,8564,6272,1240,340,22462
11/1/2014,VA,Virginia,Warren,51187,6620,6017,603,5580,18,5562,1040,25,1015,6058,5455,603,3828,3304,524,837,222,66,2703
11/1/2014,VA,Virginia,Washington,51191,14294,10036,4258,11061,43,11018,3233,14,3219,13449,9193,4256,10508,6581,3927,2556,485,178,7289
11/1/2014,VA,Virginia,Waynesboro City,51820,4683,4011,672,3778,18,3760,905,23,882,4404,3732,672,3392,2801,591,909,98,45,2340
11/1/2014,VA,Virginia,Westmoreland,51193,4568,3994,574,3977,20,3957,591,15,576,4205,3631,574,2525,2006,519,752,128,41,1604
11/1/2014,VA,Virginia,Williamsburg City,51830,2320,1995,325,2121,*,*,199,*,*,2106,1781,325,1376,1094,282,193,*,*,1146
11/1/2014,VA,Virginia,Winchester City,51840,4872,4383,489,4120,15,4105,752,18,734,4460,3971,489,3055,2625,430,807,120,45,2083
11/1/2014,VA,Virginia,Wise,51195,10236,7114,3122,6522,11,6511,3714,16,3698,9646,6525,3121,7343,4427,2916,2415,476,157,4295
11/1/2014,VA,Virginia,Wythe,51197,7257,5890,1367,5511,20,5491,1746,22,1724,6872,5505,1367,5216,4033,1183,1536,265,97,3318
11/1/2014,VA,Virginia,York,51199,10504,9291,1213,9576,33,9543,928,31,897,9597,8387,1210,4754,3622,1132,620,161,51,3922
10/1/2014,VA,Virginia,Accomack,51001,8218,7116,1102,6901,45,6856,1317,42,1275,7686,6584,1102,5426,4470,956,1547,359,88,3432
10/1/2014,VA,Virginia,Albemarle,51003,17462,15597,1865,15862,57,15805,1600,55,1545,15751,13886,1865,11378,9679,1699,1506,253,82,9537
10/1/2014,VA,Virginia,Alexandria City,51510,15740,14196,1544,14334,81,14253,1406,87,1319,12692,11151,1541,6819,5368,1451,1931,341,64,4483
10/1/2014,VA,Virginia,Alleghany,51005,4412,3770,642,3499,20,3479,913,*,*,4189,3547,642,3234,2725,509,844,90,43,2257
10/1/2014,VA,Virginia,Amelia,51007,2805,2167,638,2316,*,*,489,*,*,2594,1956,638,1935,1341,594,482,75,36,1342
10/1/2014,VA,Virginia,Amherst,51009,7268,6178,1090,5934,42,5892,1334,36,1298,6783,5693,1090,5293,4280,1013,1198,216,74,3805
10/1/2014,VA,Virginia,Appomattox,51011,3632,3106,526,2912,22,2890,720,14,706,3415,2889,526,2667,2183,484,703,98,52,1814
10/1/2014,VA,Virginia,Arlington,51013,21781,19599,2182,20094,67,20027,1687,82,1605,17425,15244,2181,9446,7420,2026,2858,313,116,6159
10/1/2014,VA,Virginia,Augusta,51015,16403,14047,2356,13908,49,13859,2495,44,2451,15396,13040,2356,11221,9255,1966,1856,366,138,8861
10/1/2014,VA,Virginia,Bath,51017,1260,1128,132,1093,*,*,167,*,*,1179,1047,132,905,787,118,202,32,26,645
10/1/2014,VA,Virginia,Bedford,51019,17678,14525,3153,14868,59,14809,2810,48,2762,16514,13364,3150,12366,9695,2671,2018,431,145,9772
10/1/2014,VA,Virginia,Bland,51021,1717,1385,332,1314,*,*,403,*,*,1626,1294,332,1185,931,254,247,58,18,862
10/1/2014,VA,Virginia,Botetourt,51023,7757,6018,1739,6616,28,6588,1141,13,1128,7155,5416,1739,5432,3861,1571,824,154,60,4394
10/1/2014,VA,Virginia,Bristol City,51520,4445,2751,1694,3391,*,*,1054,*,*,4188,2494,1694,3405,1758,1647,1040,144,56,2165
10/1/2014,VA,Virginia,Brunswick,51025,3787,3056,731,3038,19,3019,749,30,719,3571,2840,731,2757,2088,669,1095,107,38,1517
10/1/2014,VA,Virginia,Buchanan,51027,7377,4722,2655,4362,15,4347,3015,14,3001,7083,4429,2654,5691,3851,1840,1624,436,116,3515
10/1/2014,VA,Virginia,Buckingham,51029,3252,2616,636,2585,13,2572,667,13,654,3022,2386,636,2265,1694,571,719,144,49,1353
10/1/2014,VA,Virginia,Buena Vista City,51530,1413,1116,297,1118,*,*,295,*,*,1321,1024,297,1010,762,248,334,54,17,605
10/1/2014,VA,Virginia,Campbell,51031,11871,10097,1774,9645,65,9580,2226,64,2162,11131,9357,1774,8688,7061,1627,2028,362,170,6128
10/1/2014,VA,Virginia,Caroline,51033,5195,4320,875,4284,35,4249,911,36,875,4720,3845,875,3058,2241,817,762,235,51,2010
10/1/2014,VA,Virginia,Carroll,51035,7657,6623,1034,6018,18,6000,1639,17,1622,7278,6244,1034,5529,4732,797,1697,279,113,3440
10/1/2014,VA,Virginia,Charles City,51036,1678,1271,407,1397,14,1383,281,14,267,1562,1155,407,1139,821,318,252,75,17,795
10/1/2014,VA,Virginia,Charlotte,51037,3229,2766,463,2592,19,2573,637,11,626,3050,2587,463,2335,1922,413,790,126,53,1366
10/1/2014,VA,Virginia,Charlottesville City,51540,5841,5055,786,4670,20,4650,1171,46,1125,5240,4455,785,4097,3335,762,1250,146,58,2643
10/1/2014,VA,Virginia,Chesapeake City,51550,32760,26878,5882,27696,211,27485,5064,235,4829,29501,23619,5882,17034,11711,5323,3829,811,221,12173
10/1/2014,VA,Virginia,Chesterfield,51041,50109,39344,10765,42969,159,42810,7140,212,6928,44958,34194,10764,32196,22199,9997,4663,900,274,26359
10/1/2014,VA,Virginia,Clarke,51043,2789,2517,272,2529,*,*,260,*,*,2523,2251,272,1602,1369,233,259,70,28,1245
10/1/2014,VA,Virginia,Colonial Heights City,51570,4043,3512,531,3494,*,*,549,15,534,3703,3172,531,2179,1683,496,423,93,17,1646
10/1/2014,VA,Virginia,Covington City,51580,1694,1458,236,1292,*,*,402,*,*,1583,1347,236,1211,987,224,362,56,16,777
10/1/2014,VA,Virginia,Craig,51045,1259,994,265,947,*,*,312,*,*,1151,886,265,878,616,262,205,39,16,618
10/1/2014,VA,Virginia,Culpeper,51047,8162,7157,1005,6917,43,6874,1245,41,1204,7449,6444,1005,4869,3998,871,1121,230,73,3445
10/1/2014,VA,Virginia,Cumberland,51049,2106,1648,458,1726,11,1715,380,*,*,1961,1505,456,1471,1045,426,421,76,27,947
10/1/2014,VA,Virginia,Danville City,51590,11004,9293,1711,8554,71,8483,2450,108,2342,10443,8732,1711,8463,7254,1209,3161,424,173,4705
10/1/2014,VA,Virginia,Dickenson,51051,4724,3272,1452,2795,*,*,1929,*,*,4503,3051,1452,3562,2299,1263,1129,216,98,2119
10/1/2014,VA,Virginia,Dinwiddie,51053,5360,4332,1028,4213,36,4177,1147,30,1117,4914,3886,1028,3452,2460,992,901,171,54,2326
10/1/2014,VA,Virginia,Emporia City,51595,1185,876,309,878,11,867,307,13,294,1114,805,309,901,627,274,444,65,14,378
10/1/2014,VA,Virginia,Essex,51057,2659,2213,446,2247,12,2235,412,13,399,2487,2041,446,1827,1423,404,435,92,25,1275
10/1/2014,VA,Virginia,Fairfax,51059,132009,116382,15627,123679,451,123228,8330,411,7919,106758,91158,15600,55403,40894,14509,12585,2400,435,39983
10/1/2014,VA,Virginia,Fairfax City,51600,3491,3051,440,3203,12,3191,288,*,*,2946,2506,440,1585,1170,415,374,53,15,1143
10/1/2014,VA,Virginia,Falls Church City,51610,1676,1494,182,1582,*,*,94,*,*,1324,1143,181,711,546,165,138,*,*,550
10/1/2014,VA,Virginia,Fauquier,51061,10860,9858,1002,9744,43,9701,1116,38,1078,9591,8590,1001,5571,4728,843,860,183,54,4474
10/1/2014,VA,Virginia,Floyd,51063,3693,2976,717,3122,*,*,571,*,*,3434,2717,717,2607,1945,662,540,86,46,1935
10/1/2014,VA,Virginia,Fluvanna,51065,5207,4518,689,4639,21,4618,568,25,543,4790,4101,689,3321,2708,613,462,114,21,2724
10/1/2014,VA,Virginia,Franklin,51067,13416,9924,3492,10900,41,10859,2516,24,2492,12609,9117,3492,9904,6671,3233,1987,428,151,7338
10/1/2014,VA,Virginia,Franklin City,51620,1866,1559,307,1417,*,*,449,19,430,1753,1446,307,1383,1101,282,523,78,16,766
10/1/2014,VA,Virginia,Frederick,51069,13906,12381,1525,12157,39,12118,1749,42,1707,12679,11156,1523,8197,6870,1327,1412,330,128,6327
10/1/2014,VA,Virginia,Fredericksburg City,51630,3665,3239,426,2959,15,2944,706,29,677,3311,2885,426,2155,1750,405,761,83,41,1270
10/1/2014,VA,Virginia,Galax City,51640,1951,1830,121,1488,*,*,463,11,452,1857,1736,121,1442,1346,96,666,67,31,678
10/1/2014,VA,Virginia,Giles,51071,4392,3257,1135,3398,18,3380,994,11,983,4131,2997,1134,3292,2233,1059,786,133,35,2338
10/1/2014,VA,Virginia,Gloucester,51073,7599,6435,1164,6462,27,6435,1137,17,1120,6991,5827,1164,4230,3196,1034,916,169,60,3085
10/1/2014,VA,Virginia,Goochland,51075,4813,3902,911,4324,17,4307,489,17,472,4361,3450,911,3307,2487,820,404,96,33,2774
10/1/2014,VA,Virginia,Grayson,51077,4424,3938,486,3561,15,3546,863,*,*,4256,3770,486,3091,2670,421,1004,177,80,1830
10/1/2014,VA,Virginia,Greene,51079,3274,2815,459,2829,13,2816,445,12,433,3003,2544,459,2075,1644,431,421,75,20,1559
10/1/2014,VA,Virginia,Greensville,51081,2320,1693,627,1832,18,1814,488,18,470,2159,1532,627,1754,1186,568,543,129,22,1060
10/1/2014,VA,Virginia,Halifax,51083,9203,7999,1204,7310,53,7257,1893,60,1833,8644,7441,1203,6830,5721,1109,2211,423,134,4062
10/1/2014,VA,Virginia,Hampton City,51650,23027,18221,4806,18651,184,18467,4376,207,4169,21108,16302,4806,11986,7497,4489,3458,748,190,7590
10/1/2014,VA,Virginia,Hanover,51085,17939,14186,3753,16047,59,15988,1892,44,1848,16344,12591,3753,12142,8819,3323,1374,327,98,10343
10/1/2014,VA,Virginia,Harrisonburg City,51660,4962,4415,547,4138,17,4121,824,19,805,4534,3987,547,3443,3024,419,926,113,45,2359
10/1/2014,VA,Virginia,Henrico,51087,49571,37894,11677,42684,288,42396,6887,298,6589,44961,33286,11675,33638,22963,10675,5662,1210,372,26394
10/1/2014,VA,Virginia,Henry,51089,14788,10740,4048,11473,59,11414,3315,66,3249,14112,10064,4048,11766,8654,3112,3157,648,234,7727
10/1/2014,VA,Virginia,Highland,51091,702,632,70,637,*,*,65,0,65,663,593,70,473,409,64,69,*,*,377
10/1/2014,VA,Virginia,Hopewell City,51670,4306,3524,782,3322,22,3300,984,33,951,4017,3235,782,2629,1864,765,908,137,35,1549
10/1/2014,VA,Virginia,Isle of Wight,51093,7146,5626,1520,6167,36,6131,979,33,946,6636,5116,1520,4556,3111,1445,869,184,77,3426
10/1/2014,VA,Virginia,James City,51095,17575,15626,1949,16430,46,16384,1145,40,1105,16260,14314,1946,9363,7658,1705,830,179,40,8314
10/1/2014,VA,Virginia,King and Queen,51097,1608,1341,267,1331,*,*,277,*,*,1507,1240,267,1103,856,247,275,75,11,742
10/1/2014,VA,Virginia,King George,51099,3321,2996,325,2817,16,2801,504,22,482,2884,2559,325,1397,1090,307,433,77,25,862
10/1/2014,VA,Virginia,King William,51101,2893,2481,412,2463,15,2448,430,22,408,2660,2248,412,2037,1677,360,371,79,21,1566
10/1/2014,VA,Virginia,Lancaster,51103,4105,3570,535,3752,15,3737,353,14,339,3924,3389,535,2630,2212,418,475,78,31,2046
10/1/2014,VA,Virginia,Lee,51105,6264,4329,1935,4082,13,4069,2182,16,2166,5946,4014,1932,4676,2871,1805,1957,243,76,2400
10/1/2014,VA,Virginia,Lexington City,51678,1584,1414,170,1440,12,1428,144,*,*,1482,1312,170,1099,957,142,214,31,11,843
10/1/2014,VA,Virginia,Loudoun,51107,29192,25674,3518,26982,81,26901,2210,101,2109,24157,20643,3514,14365,11160,3205,2547,523,119,11176
10/1/2014,VA,Virginia,Louisa,51109,6872,5669,1203,5674,33,5641,1198,33,1165,6307,5104,1203,4432,3309,1123,1045,241,66,3080
10/1/2014,VA,Virginia,Lunenburg,51111,2875,2438,437,2309,15,2294,566,22,544,2663,2226,437,1939,1525,414,682,120,37,1100
10/1/2014,VA,Virginia,Lynchburg City,51680,14184,12292,1892,11053,79,10974,3131,106,3025,13227,11336,1891,10435,8697,1738,3363,426,142,6504
10/1/2014,VA,Virginia,Madison,51113,2727,2345,382,2379,*,*,348,*,*,2549,2167,382,1796,1438,358,397,75,24,1300
10/1/2014,VA,Virginia,Manassas City,51683,3899,3369,530,3352,21,3331,547,33,514,3326,2797,529,2201,1696,505,515,99,29,1558
10/1/2014,VA,Virginia,Manassas Park City,51685,1073,912,161,917,*,*,156,11,145,901,740,161,585,436,149,151,*,*,385
10/1/2014,VA,Virginia,Martinsville City,51690,3915,3071,844,2902,19,2883,1013,35,978,3733,2889,844,3187,2539,648,1317,162,59,1649
10/1/2014,VA,Virginia,Mathews,51115,2664,2310,354,2415,*,*,249,*,*,2528,2174,354,1592,1273,319,250,47,19,1276
10/1/2014,VA,Virginia,Mecklenburg,51117,8826,7373,1453,7171,45,7126,1655,53,1602,8326,6875,1451,6388,5220,1168,1923,367,103,3995
10/1/2014,VA,Virginia,Middlesex,51119,3365,2836,529,2995,16,2979,370,*,*,3174,2646,528,2279,1849,430,416,92,22,1749
10/1/2014,VA,Virginia,Montgomery,51121,12640,10433,2207,10279,27,10252,2361,28,2333,11508,9301,2207,9033,6931,2102,1825,284,109,6815
10/1/2014,VA,Virginia,Nelson,51125,4107,3545,562,3553,14,3539,554,17,537,3797,3235,562,2690,2167,523,614,99,39,1938
10/1/2014,VA,Virginia,New Kent,51127,3599,2969,630,3139,14,3125,460,12,448,3289,2659,630,2180,1665,515,283,69,22,1806
10/1/2014,VA,Virginia,Newport News City,51700,25770,19840,5930,20993,156,20837,4777,230,4547,23635,17707,5928,14700,9060,5640,4390,741,217,9352
10/1/2014,VA,Virginia,Norfolk City,51710,30371,23365,7006,23832,221,23611,6539,343,6196,27432,20426,7006,17408,10863,6545,6852,1183,283,9090
10/1/2014,VA,Virginia,Northampton,51131,3329,2780,549,2799,30,2769,530,31,499,3132,2583,549,2437,1928,509,901,103,35,1398
10/1/2014,VA,Virginia,Northumberland,51133,4498,3981,517,4136,*,*,362,*,*,4231,3714,517,2612,2220,392,442,87,33,2050
10/1/2014,VA,Virginia,Norton City,51720,1189,899,290,743,*,*,446,*,*,1106,816,290,854,580,274,365,49,19,421
10/1/2014,VA,Virginia,Nottoway,51135,3522,2869,653,2840,25,2815,682,15,667,3262,2609,653,2468,1968,500,932,116,43,1377
10/1/2014,VA,Virginia,Orange,51137,8027,7006,1021,6991,40,6951,1036,29,1007,7399,6379,1020,4572,3686,886,936,234,61,3341
10/1/2014,VA,Virginia,Page,51139,5746,5086,660,4623,19,4604,1123,15,1108,5388,4728,660,3807,3216,591,1137,200,88,2382
10/1/2014,VA,Virginia,Patrick,51141,4974,3738,1236,4015,13,4002,959,13,946,4745,3510,1235,3769,2720,1049,1013,175,82,2499
10/1/2014,VA,Virginia,Petersburg City,51730,7033,5432,1601,5061,71,4990,1972,90,1882,6431,4830,1601,4489,2957,1532,2055,326,79,2029
10/1/2014,VA,Virginia,Pittsylvania,51143,15142,12583,2559,12095,87,12008,3047,85,2962,14365,11806,2559,11545,9273,2272,3157,562,213,7613
10/1/2014,VA,Virginia,Poquoson City,51735,2375,2120,255,2185,*,*,190,0,190,2167,1912,255,1002,774,228,102,*,*,865
10/1/2014,VA,Virginia,Portsmouth City,51740,17164,13135,4029,13170,163,13007,3994,207,3787,15343,11314,4029,9356,5573,3783,3679,658,153,4866
10/1/2014,VA,Virginia,Powhatan,51145,5131,4108,1023,4503,19,4484,628,19,609,4678,3655,1023,3497,2567,930,385,95,34,2983
10/1/2014,VA,Virginia,Prince Edward,51147,4366,3539,827,3411,23,3388,955,32,923,4071,3244,827,3064,2369,695,1052,167,47,1798
10/1/2014,VA,Virginia,Prince George,51149,5200,4533,667,4322,24,4298,878,25,853,4825,4158,667,2733,2105,628,547,111,23,2052
10/1/2014,VA,Virginia,Prince William,51153,39912,34431,5481,35091,187,34904,4821,301,4520,34066,28591,5475,18209,13126,5083,4359,883,189,12778
10/1/2014,VA,Virginia,Pulaski,51155,8640,7063,1577,6654,27,6627,1986,28,1958,8108,6531,1577,6111,4609,1502,1685,308,116,4002
10/1/2014,VA,Virginia,Radford City,51750,1975,1650,325,1583,*,*,392,*,*,1822,1497,325,1467,1156,311,323,43,30,1071
10/1/2014,VA,Virginia,Rappahannock,51157,1833,1697,136,1674,*,*,159,*,*,1668,1532,136,1025,912,113,156,39,11,819
10/1/2014,VA,Virginia,Richmond,51159,1808,1480,328,1560,16,1544,248,*,*,1706,1378,328,1193,907,286,277,83,23,810
10/1/2014,VA,Virginia,Richmond City,51760,31371,22012,9359,23855,266,23589,7516,354,7162,28252,18893,9359,22409,13376,9033,8323,1360,309,12417
10/1/2014,VA,Virginia,Roanoke,51161,21525,17518,4007,18776,81,18695,2749,51,2698,19949,15942,4007,15105,11334,3771,1948,388,129,12640
10/1/2014,VA,Virginia,Roanoke City,51770,19409,14378,5031,14195,110,14085,5214,143,5071,17817,12787,5030,13967,9108,4859,4689,752,233,8293
10/1/2014,VA,Virginia,Rockbridge,51163,5557,4578,979,4639,18,4621,918,11,907,5206,4227,979,3735,3083,652,841,164,59,2671
10/1/2014,VA,Virginia,Rockingham,51165,15645,13229,2416,13559,47,13512,2086,53,2033,14488,12073,2415,10677,8932,1745,1762,448,141,8326
10/1/2014,VA,Virginia,Russell,51167,7652,5470,2182,4946,12,4934,2706,*,*,7295,5113,2182,6024,4254,1770,1717,285,122,3900
10/1/2014,VA,Virginia,Salem City,51775,5754,4695,1059,4797,22,4775,957,22,935,5283,4224,1059,4034,3027,1007,803,133,45,3053
10/1/2014,VA,Virginia,Scott,51169,6457,3404,3053,4732,*,*,1725,12,1713,6180,3127,3053,5252,2260,2992,1558,243,110,3341
10/1/2014,VA,Virginia,Shenandoah,51171,9668,8603,1065,8409,17,8392,1259,26,1233,9056,7991,1065,5988,5091,897,1260,240,94,4394
10/1/2014,VA,Virginia,Smyth,51173,8593,6901,1692,6216,16,6200,2377,21,2356,8130,6438,1692,6392,4854,1538,2147,378,151,3716
10/1/2014,VA,Virginia,Southampton,51175,3806,3192,614,3124,22,3102,682,23,659,3547,2933,614,2689,2133,556,721,130,38,1800
10/1/2014,VA,Virginia,Spotsylvania,51177,17481,15447,2034,14949,84,14865,2532,88,2444,15577,13544,2033,8905,7089,1816,1788,485,115,6517
10/1/2014,VA,Virginia,Stafford,51179,14135,12869,1266,12253,66,12187,1882,93,1789,12385,11121,1264,5948,4826,1122,1217,318,75,4338
10/1/2014,VA,Virginia,Staunton City,51790,5757,5102,655,4659,25,4634,1098,28,1070,5412,4757,655,4135,3588,547,1060,147,53,2875
10/1/2014,VA,Virginia,Suffolk City,51800,13971,11231,2740,11222,75,11147,2749,80,2669,12748,10010,2738,8365,5926,2439,2621,386,102,5256
10/1/2014,VA,Virginia,Surry,51181,1438,1101,337,1199,*,*,239,11,228,1326,989,337,938,618,320,212,64,11,651
10/1/2014,VA,Virginia,Sussex,51183,2302,1816,486,1833,33,1800,469,*,*,2143,1657,486,1608,1142,466,494,138,25,951
10/1/2014,VA,Virginia,Tazewell,51185,11538,8523,3015,8196,32,8164,3342,38,3304,10940,7927,3013,8352,6430,1922,2243,418,158,5533
10/1/2014,VA,Virginia,Unknown,51999,*,*,*,*,*,*,*,*,*,*,*,*,*,*,*,*,*,*,*
10/1/2014,VA,Virginia,Virginia Beach City,51810,62252,52795,9457,54299,283,54016,7953,321,7632,56854,47402,9452,30190,21604,8586,6202,1239,335,22414
10/1/2014,VA,Virginia,Warren,51187,6593,5995,598,5556,19,5537,1037,25,1012,6037,5439,598,3824,3305,519,834,219,68,2703
10/1/2014,VA,Virginia,Washington,51191,14277,10029,4248,11060,44,11016,3217,14,3203,13432,9186,4246,10490,6573,3917,2545,483,177,7285
10/1/2014,VA,Virginia,Waynesboro City,51820,4684,4005,679,3784,18,3766,900,22,878,4400,3721,679,3386,2788,598,908,97,43,2338
10/1/2014,VA,Virginia,Westmoreland,51193,4561,3969,592,3973,21,3952,588,15,573,4200,3608,592,2526,1989,537,752,124,44,1606
10/1/2014,VA,Virginia,Williamsburg City,51830,2321,1991,330,2122,*,*,199,*,*,2107,1777,330,1377,1090,287,190,*,*,1150
10/1/2014,VA,Virginia,Winchester City,51840,4861,4373,488,4118,15,4103,743,17,726,4448,3960,488,3057,2628,429,802,122,47,2086
10/1/2014,VA,Virginia,Wise,51195,10236,7119,3117,6529,11,6518,3707,17,3690,9649,6533,3116,7354,4448,2906,2412,476,154,4312
10/1/2014,VA,Virginia,Wythe,51197,7245,5871,1374,5506,20,5486,1739,22,1717,6856,5482,1374,5214,4022,1192,1532,268,94,3320
10/1/2014,VA,Virginia,York,51199,10485,9270,1215,9562,36,9526,923,31,892,9587,8375,1212,4758,3624,1134,618,162,51,3927
9/1/2014,VA,Virginia,Accomack,51001,8209,7105,1104,6898,45,6853,1311,42,1269,7671,6567,1104,5425,4467,958,1545,354,88,3438
9/1/2014,VA,Virginia,Albemarle,51003,17420,15872,1548,15829,60,15769,1591,55,1536,15718,14170,1548,11339,9960,1379,1500,251,80,9508
9/1/2014,VA,Virginia,Alexandria City,51510,15675,14141,1534,14275,82,14193,1400,88,1312,12653,11122,1531,6790,5349,1441,1915,344,64,4467
9/1/2014,VA,Virginia,Alleghany,51005,4403,3914,489,3494,20,3474,909,*,*,4178,3689,489,3231,2874,357,836,93,44,2258
9/1/2014,VA,Virginia,Amelia,51007,2788,2139,649,2303,*,*,485,*,*,2579,1930,649,1924,1319,605,478,73,36,1337
9/1/2014,VA,Virginia,Amherst,51009,7253,6183,1070,5924,42,5882,1329,35,1294,6766,5696,1070,5285,4291,994,1191,216,74,3804
9/1/2014,VA,Virginia,Appomattox,51011,3618,3095,523,2902,22,2880,716,14,702,3403,2880,523,2660,2178,482,694,99,52,1815
9/1/2014,VA,Virginia,Arlington,51013,21697,19532,2165,20025,68,19957,1672,81,1591,17396,15232,2164,9399,7388,2011,2829,314,113,6143
9/1/2014,VA,Virginia,Augusta,51015,16371,14299,2072,13892,51,13841,2479,43,2436,15358,13286,2072,11186,9503,1683,1857,368,135,8826
9/1/2014,VA,Virginia,Bath,51017,1255,1176,79,1087,*,*,168,*,*,1177,1098,79,904,839,65,203,32,25,644
9/1/2014,VA,Virginia,Bedford,51019,17635,14847,2788,14841,59,14782,2794,48,2746,16468,13683,2785,12334,10028,2306,2009,432,145,9748
9/1/2014,VA,Virginia,Bland,51021,1713,1383,330,1314,*,*,399,*,*,1623,1293,330,1178,926,252,243,58,18,859
9/1/2014,VA,Virginia,Botetourt,51023,7721,6153,1568,6587,28,6559,1134,13,1121,7122,5554,1568,5407,4007,1400,821,154,60,4372
9/1/2014,VA,Virginia,Bristol City,51520,4450,2750,1700,3395,11,3384,1055,*,*,4192,2492,1700,3412,1759,1653,1037,144,54,2177
9/1/2014,VA,Virginia,Brunswick,51025,3776,2995,781,3031,20,3011,745,30,715,3563,2782,781,2752,2030,722,1087,110,37,1518
9/1/2014,VA,Virginia,Buchanan,51027,7375,4720,2655,4361,15,4346,3014,14,3000,7073,4419,2654,5691,3854,1837,1621,437,116,3517
9/1/2014,VA,Virginia,Buckingham,51029,3245,2804,441,2579,13,2566,666,14,652,3021,2580,441,2253,1877,376,715,144,48,1346
9/1/2014,VA,Virginia,Buena Vista City,51530,1411,1180,231,1116,*,*,295,*,*,1318,1087,231,1010,828,182,335,53,17,605
9/1/2014,VA,Virginia,Campbell,51031,11846,10080,1766,9628,65,9563,2218,65,2153,11115,9349,1766,8666,7046,1620,2016,362,170,6118
9/1/2014,VA,Virginia,Caroline,51033,5170,4283,887,4264,35,4229,906,36,870,4695,3808,887,3041,2212,829,759,229,51,2002
9/1/2014,VA,Virginia,Carroll,51035,7647,6616,1031,6014,18,5996,1633,17,1616,7262,6231,1031,5525,4731,794,1696,280,112,3437
9/1/2014,VA,Virginia,Charles City,51036,1680,1264,416,1397,14,1383,283,14,269,1563,1147,416,1139,811,328,254,75,17,793
9/1/2014,VA,Virginia,Charlotte,51037,3219,2755,464,2587,19,2568,632,11,621,3040,2576,464,2322,1907,415,778,127,52,1365
9/1/2014,VA,Virginia,Charlottesville City,51540,5823,5352,471,4650,20,4630,1173,48,1125,5225,4755,470,4083,3637,446,1248,147,59,2629
9/1/2014,VA,Virginia,Chesapeake City,51550,32625,26722,5903,27586,214,27372,5039,235,4804,29424,23522,5902,16963,11625,5338,3784,821,218,12140
9/1/2014,VA,Virginia,Chesterfield,51041,49919,39121,10798,42824,163,42661,7095,212,6883,44820,34023,10797,32092,22070,10022,4655,890,268,26279
9/1/2014,VA,Virginia,Clarke,51043,2780,2511,269,2524,*,*,256,*,*,2513,2244,269,1599,1369,230,262,69,28,1240
9/1/2014,VA,Virginia,Colonial Heights City,51570,4031,3491,540,3486,*,*,545,15,530,3694,3154,540,2183,1678,505,421,94,17,1651
9/1/2014,VA,Virginia,Covington City,51580,1694,1532,162,1292,*,*,402,*,*,1580,1418,162,1209,1059,150,362,54,15,778
9/1/2014,VA,Virginia,Craig,51045,1253,1025,228,944,*,*,309,*,*,1143,915,228,876,651,225,204,39,16,617
9/1/2014,VA,Virginia,Culpeper,51047,8135,7156,979,6904,44,6860,1231,40,1191,7425,6446,979,4849,4002,847,1114,224,74,3437
9/1/2014,VA,Virginia,Cumberland,51049,2104,1636,468,1725,11,1714,379,*,*,1958,1492,466,1469,1034,435,418,76,28,947
9/1/2014,VA,Virginia,Danville City,51590,11009,9294,1715,8565,71,8494,2444,110,2334,10444,8729,1715,8448,7236,1212,3138,419,172,4719
9/1/2014,VA,Virginia,Dickenson,51051,4714,3267,1447,2793,*,*,1921,*,*,4494,3047,1447,3551,2293,1258,1124,216,96,2115
9/1/2014,VA,Virginia,Dinwiddie,51053,5341,4298,1043,4205,36,4169,1136,29,1107,4899,3856,1043,3446,2439,1007,903,169,53,2321
9/1/2014,VA,Virginia,Emporia City,51595,1187,858,329,881,12,869,306,12,294,1115,786,329,897,602,295,443,61,16,377
9/1/2014,VA,Virginia,Essex,51057,2645,2193,452,2238,12,2226,407,11,396,2471,2019,452,1813,1404,409,428,90,25,1270
9/1/2014,VA,Virginia,Fairfax,51059,131369,115833,15536,123104,452,122652,8265,406,7859,106311,90800,15511,55172,40747,14425,12506,2386,433,39847
9/1/2014,VA,Virginia,Fairfax City,51600,3483,3044,439,3196,13,3183,287,*,*,2942,2503,439,1583,1170,413,373,52,15,1143
9/1/2014,VA,Virginia,Falls Church City,51610,1669,1485,184,1574,*,*,95,*,*,1319,1136,183,708,542,166,138,*,*,547
9/1/2014,VA,Virginia,Fauquier,51061,10815,9814,1001,9702,45,9657,1113,39,1074,9557,8557,1000,5542,4700,842,856,182,51,4453
9/1/2014,VA,Virginia,Floyd,51063,3686,3055,631,3117,*,*,569,*,*,3424,2793,631,2602,2026,576,535,88,44,1935
9/1/2014,VA,Virginia,Fluvanna,51065,5187,4617,570,4618,20,4598,569,25,544,4773,4203,570,3315,2821,494,460,114,21,2720
9/1/2014,VA,Virginia,Franklin,51067,13395,10242,3153,10884,42,10842,2511,24,2487,12586,9433,3153,9878,6987,2891,1978,430,153,7317
9/1/2014,VA,Virginia,Franklin City,51620,1866,1542,324,1418,*,*,448,20,428,1752,1428,324,1384,1085,299,521,78,16,769
9/1/2014,VA,Virginia,Frederick,51069,13858,12336,1522,12118,39,12079,1740,42,1698,12636,11116,1520,8176,6850,1326,1397,328,130,6321
9/1/2014,VA,Virginia,Fredericksburg City,51630,3655,3222,433,2953,15,2938,702,28,674,3305,2872,433,2137,1725,412,746,83,40,1268
9/1/2014,VA,Virginia,Galax City,51640,1950,1829,121,1488,*,*,462,11,451,1858,1737,121,1443,1347,96,669,69,31,674
9/1/2014,VA,Virginia,Giles,51071,4398,3457,941,3406,18,3388,992,11,981,4134,3194,940,3287,2421,866,783,131,35,2338
9/1/2014,VA,Virginia,Gloucester,51073,7571,6399,1172,6445,28,6417,1126,17,1109,6960,5788,1172,4200,3158,1042,896,171,60,3073
9/1/2014,VA,Virginia,Goochland,51075,4793,3892,901,4307,19,4288,486,17,469,4344,3443,901,3298,2487,811,402,95,32,2769
9/1/2014,VA,Virginia,Grayson,51077,4415,3930,485,3554,15,3539,861,*,*,4248,3763,485,3083,2663,420,1000,176,79,1828
9/1/2014,VA,Virginia,Greene,51079,3274,2910,364,2829,13,2816,445,12,433,3005,2641,364,2076,1740,336,425,75,20,1556
9/1/2014,VA,Virginia,Greensville,51081,2318,1661,657,1831,18,1813,487,18,469,2158,1501,657,1759,1161,598,546,128,22,1063
9/1/2014,VA,Virginia,Halifax,51083,9207,8001,1206,7313,53,7260,1894,60,1834,8651,7446,1205,6837,5727,1110,2218,422,133,4064
9/1/2014,VA,Virginia,Hampton City,51650,22973,18138,4835,18618,187,18431,4355,209,4146,21056,16221,4835,11919,7404,4515,3414,744,191,7570
9/1/2014,VA,Virginia,Hanover,51085,17877,14133,3744,15992,60,15932,1885,43,1842,16308,12564,3744,12098,8783,3315,1374,325,99,10300
9/1/2014,VA,Virginia,Harrisonburg City,51660,4950,4469,481,4124,17,4107,826,20,806,4526,4045,481,3433,3081,352,922,115,45,2351
9/1/2014,VA,Virginia,Henrico,51087,49436,37700,11736,42582,296,42286,6854,297,6557,44870,33136,11734,33535,22803,10732,5638,1210,363,26324
9/1/2014,VA,Virginia,Henry,51089,14781,10749,4032,11477,62,11415,3304,66,3238,14106,10074,4032,11750,8655,3095,3145,647,230,7728
9/1/2014,VA,Virginia,Highland,51091,699,637,62,634,*,*,65,0,65,658,596,62,469,413,56,68,*,*,373
9/1/2014,VA,Virginia,Hopewell City,51670,4300,3462,838,3320,23,3297,980,34,946,4016,3178,838,2631,1811,820,906,134,35,1556
9/1/2014,VA,Virginia,Isle of Wight,51093,7126,5595,1531,6150,36,6114,976,32,944,6610,5079,1531,4531,3075,1456,862,184,77,3408
9/1/2014,VA,Virginia,James City,51095,17520,15569,1951,16383,46,16337,1137,40,1097,16214,14266,1948,9329,7622,1707,825,176,41,8287
9/1/2014,VA,Virginia,King and Queen,51097,1600,1331,269,1324,*,*,276,*,*,1502,1233,269,1103,853,250,275,75,11,742
9/1/2014,VA,Virginia,King George,51099,3309,2973,336,2810,16,2794,499,21,478,2883,2547,336,1394,1076,318,433,77,25,859
9/1/2014,VA,Virginia,King William,51101,2879,2452,427,2453,15,2438,426,22,404,2650,2223,427,2031,1656,375,370,78,22,1561
9/1/2014,VA,Virginia,Lancaster,51103,4108,3552,556,3756,15,3741,352,14,338,3923,3367,556,2625,2187,438,473,79,30,2043
9/1/2014,VA,Virginia,Lee,51105,6264,4323,1941,4091,13,4078,2173,16,2157,5942,4004,1938,4668,2863,1805,1950,243,77,2398
9/1/2014,VA,Virginia,Lexington City,51678,1581,1456,125,1437,12,1425,144,*,*,1478,1353,125,1097,1001,96,214,32,12,839
9/1/2014,VA,Virginia,Loudoun,51107,29021,25524,3497,26830,83,26747,2191,100,2091,24045,20552,3493,14289,11110,3179,2512,523,119,11135
9/1/2014,VA,Virginia,Louisa,51109,6843,5841,1002,5650,36,5614,1193,34,1159,6284,5282,1002,4411,3486,925,1041,245,68,3057
9/1/2014,VA,Virginia,Lunenburg,51111,2858,2392,466,2296,15,2281,562,22,540,2648,2182,466,1935,1492,443,680,122,35,1098
9/1/2014,VA,Virginia,Lynchburg City,51680,14170,12286,1884,11049,79,10970,3121,106,3015,13217,11334,1883,10434,8705,1729,3352,432,144,6506
9/1/2014,VA,Virginia,Madison,51113,2726,2435,291,2382,*,*,344,*,*,2547,2256,291,1793,1525,268,401,74,24,1294
9/1/2014,VA,Virginia,Manassas City,51683,3877,3354,523,3332,21,3311,545,34,511,3317,2795,522,2191,1693,498,514,97,28,1552
9/1/2014,VA,Virginia,Manassas Park City,51685,1067,907,160,911,*,*,156,11,145,899,739,160,582,435,147,149,*,*,386
9/1/2014,VA,Virginia,Martinsville City,51690,3913,3076,837,2905,20,2885,1008,35,973,3736,2899,837,3188,2547,641,1312,162,58,1656
9/1/2014,VA,Virginia,Mathews,51115,2657,2302,355,2408,*,*,249,*,*,2521,2166,355,1580,1260,320,249,47,19,1265
9/1/2014,VA,Virginia,Mecklenburg,51117,8815,7364,1451,7160,46,7114,1655,53,1602,8316,6867,1449,6373,5198,1175,1918,371,103,3981
9/1/2014,VA,Virginia,Middlesex,51119,3362,2824,538,2995,16,2979,367,*,*,3169,2632,537,2275,1835,440,416,92,20,1747
9/1/2014,VA,Virginia,Montgomery,51121,12598,10774,1824,10243,28,10215,2355,28,2327,11484,9660,1824,9002,7285,1717,1813,284,107,6798
9/1/2014,VA,Virginia,Nelson,51125,4097,3656,441,3544,14,3530,553,17,536,3788,3347,441,2686,2284,402,612,99,38,1937
9/1/2014,VA,Virginia,New Kent,51127,3594,2965,629,3135,14,3121,459,12,447,3285,2656,629,2173,1656,517,278,71,21,1803
9/1/2014,VA,Virginia,Newport News City,51700,25699,19749,5950,20940,160,20780,4759,232,4527,23563,17615,5948,14635,8977,5658,4345,747,217,9326
9/1/2014,VA,Virginia,Norfolk City,51710,30248,23227,7021,23755,224,23531,6493,338,6155,27355,20334,7021,17318,10761,6557,6789,1183,281,9065
9/1/2014,VA,Virginia,Northampton,51131,3330,2754,576,2804,30,2774,526,31,495,3133,2557,576,2432,1897,535,896,103,34,1399
9/1/2014,VA,Virginia,Northumberland,51133,4492,3959,533,4134,*,*,358,*,*,4221,3688,533,2601,2193,408,439,85,33,2044
9/1/2014,VA,Virginia,Norton City,51720,1185,895,290,741,*,*,444,*,*,1100,810,290,855,581,274,365,49,20,421
9/1/2014,VA,Virginia,Nottoway,51135,3514,2838,676,2835,25,2810,679,15,664,3250,2574,676,2462,1939,523,923,117,44,1378
9/1/2014,VA,Virginia,Orange,51137,8001,7199,802,6971,40,6931,1030,29,1001,7369,6568,801,4544,3876,668,927,238,61,3318
9/1/2014,VA,Virginia,Page,51139,5731,5083,648,4617,19,4598,1114,15,1099,5374,4726,648,3794,3216,578,1123,201,89,2381
9/1/2014,VA,Virginia,Patrick,51141,4965,3841,1124,4011,13,3998,954,13,941,4741,3618,1123,3762,2827,935,1008,181,80,2493
9/1/2014,VA,Virginia,Petersburg City,51730,7026,5382,1644,5065,72,4993,1961,90,1871,6412,4768,1644,4477,2902,1575,2041,329,81,2026
9/1/2014,VA,Virginia,Pittsylvania,51143,15102,12556,2546,12065,87,11978,3037,86,2951,14327,11781,2546,11516,9256,2260,3138,557,214,7607
9/1/2014,VA,Virginia,Poquoson City,51735,2366,2108,258,2176,*,*,190,0,190,2159,1901,258,1002,771,231,103,*,*,864
9/1/2014,VA,Virginia,Portsmouth City,51740,17122,13088,4034,13147,167,12980,3975,205,3770,15313,11279,4034,9294,5507,3787,3630,659,150,4855
9/1/2014,VA,Virginia,Powhatan,51145,5112,4085,1027,4487,19,4468,625,19,606,4654,3627,1027,3469,2534,935,383,96,34,2956
9/1/2014,VA,Virginia,Prince Edward,51147,4360,3520,840,3406,23,3383,954,32,922,4065,3225,840,3065,2358,707,1050,168,46,1801
9/1/2014,VA,Virginia,Prince George,51149,5179,4507,672,4311,24,4287,868,25,843,4804,4132,672,2719,2086,633,540,111,23,2045
9/1/2014,VA,Virginia,Prince William,51153,39707,34278,5429,34924,188,34736,4783,302,4481,33921,28498,5423,18125,13092,5033,4328,874,191,12732
9/1/2014,VA,Virginia,Pulaski,51155,8625,7322,1303,6646,29,6617,1979,29,1950,8085,6782,1303,6094,4867,1227,1671,309,114,4000
9/1/2014,VA,Virginia,Radford City,51750,1977,1661,316,1587,*,*,390,*,*,1826,1510,316,1474,1172,302,327,42,30,1075
9/1/2014,VA,Virginia,Rappahannock,51157,1817,1683,134,1661,*,*,156,*,*,1652,1518,134,1018,907,111,155,39,11,813
9/1/2014,VA,Virginia,Richmond,51159,1803,1468,335,1557,16,1541,246,*,*,1700,1365,335,1191,898,293,279,84,22,806
9/1/2014,VA,Virginia,Richmond City,51760,31275,21853,9422,23796,266,23530,7479,354,7125,28180,18758,9422,22360,13266,9094,8293,1358,309,12400
9/1/2014,VA,Virginia,Roanoke,51161,21475,17793,3682,18742,83,18659,2733,49,2684,19919,16237,3682,15069,11627,3442,1941,388,127,12613
9/1/2014,VA,Virginia,Roanoke City,51770,19354,15419,3935,14162,113,14049,5192,144,5048,17768,13834,3934,13921,10161,3760,4653,747,235,8286
9/1/2014,VA,Virginia,Rockbridge,51163,5543,4710,833,4629,19,4610,914,11,903,5195,4362,833,3729,3224,505,842,160,59,2668
9/1/2014,VA,Virginia,Rockingham,51165,15591,13429,2162,13514,49,13465,2077,54,2023,14441,12280,2161,10624,9138,1486,1753,445,138,8288
9/1/2014,VA,Virginia,Russell,51167,7649,5469,2180,4945,12,4933,2704,*,*,7296,5116,2180,6022,4255,1767,1719,285,121,3897
9/1/2014,VA,Virginia,Salem City,51775,5743,4883,860,4794,22,4772,949,22,927,5274,4414,860,4020,3212,808,798,129,44,3049
9/1/2014,VA,Virginia,Scott,51169,6438,3398,3040,4720,*,*,1718,12,1706,6164,3124,3040,5231,2252,2979,1557,238,106,3330
9/1/2014,VA,Virginia,Shenandoah,51171,9636,8572,1064,8382,17,8365,1254,26,1228,9029,7965,1064,5973,5078,895,1256,237,94,4386
9/1/2014,VA,Virginia,Smyth,51173,8579,6900,1679,6208,16,6192,2371,21,2350,8124,6445,1679,6385,4860,1525,2133,379,151,3722
9/1/2014,VA,Virginia,Southampton,51175,3798,3159,639,3124,23,3101,674,23,651,3544,2905,639,2689,2106,583,723,127,38,1801
9/1/2014,VA,Virginia,Spotsylvania,51177,17399,15365,2034,14889,86,14803,2510,88,2422,15516,13483,2033,8863,7049,1814,1762,484,117,6500
9/1/2014,VA,Virginia,Stafford,51179,14068,12789,1279,12199,68,12131,1869,94,1775,12334,11057,1277,5925,4790,1135,1218,318,75,4314
9/1/2014,VA,Virginia,Staunton City,51790,5754,5161,593,4663,25,4638,1091,28,1063,5412,4819,593,4133,3648,485,1055,149,53,2876
9/1/2014,VA,Virginia,Suffolk City,51800,13942,11172,2770,11208,76,11132,2734,81,2653,12721,9953,2768,8324,5858,2466,2581,389,99,5255
9/1/2014,VA,Virginia,Surry,51181,1438,1094,344,1199,*,*,239,11,228,1325,981,344,940,613,327,212,65,11,652
9/1/2014,VA,Virginia,Sussex,51183,2297,1795,502,1830,33,1797,467,*,*,2136,1634,502,1598,1116,482,487,138,25,948
9/1/2014,VA,Virginia,Tazewell,51185,11519,8506,3013,8185,32,8153,3334,38,3296,10923,7912,3011,8336,6418,1918,2235,416,159,5526
9/1/2014,VA,Virginia,Unknown,51999,*,*,*,*,*,*,*,*,*,*,*,*,*,*,*,*,*,*,*
9/1/2014,VA,Virginia,Virginia Beach City,51810,61992,52512,9480,54100,288,53812,7892,321,7571,56672,47198,9474,30042,21441,8601,6128,1230,331,22353
9/1/2014,VA,Virginia,Warren,51187,6581,5977,604,5546,19,5527,1035,25,1010,6030,5426,604,3810,3287,523,825,221,68,2696
9/1/2014,VA,Virginia,Washington,51191,14248,10002,4246,11052,47,11005,3196,15,3181,13424,9180,4244,10487,6573,3914,2533,484,176,7294
9/1/2014,VA,Virginia,Waynesboro City,51820,4670,4147,523,3777,18,3759,893,21,872,4388,3865,523,3367,2925,442,900,96,43,2328
9/1/2014,VA,Virginia,Westmoreland,51193,4556,3951,605,3967,21,3946,589,15,574,4196,3591,605,2513,1962,551,747,126,42,1598
9/1/2014,VA,Virginia,Williamsburg City,51830,2308,1995,313,2112,*,*,196,*,*,2097,1784,313,1375,1104,271,188,*,*,1150
9/1/2014,VA,Virginia,Winchester City,51840,4840,4351,489,4103,15,4088,737,17,720,4439,3950,489,3049,2619,430,801,120,47,2081
9/1/2014,VA,Virginia,Wise,51195,10223,7104,3119,6538,11,6527,3685,17,3668,9648,6530,3118,7355,4451,2904,2411,477,149,4318
9/1/2014,VA,Virginia,Wythe,51197,7220,5851,1369,5489,21,5468,1731,21,1710,6838,5469,1369,5206,4021,1185,1525,265,94,3322
9/1/2014,VA,Virginia,York,51199,10454,9236,1218,9534,36,9498,920,31,889,9543,8328,1215,4725,3587,1138,613,165,51,3896
4/1/2015,VA,Virginia,Accomack,51001,8267,7108,1159,7025,44,6981,1242,43,1199,7739,6580,1159,5563,4569,994,1512,364,85,3602
4/1/2015,VA,Virginia,Albemarle,51003,17902,15980,1922,16344,63,16281,1558,56,1502,16063,14141,1922,11820,10095,1725,1460,273,86,10001
4/1/2015,VA,Virginia,Alexandria City,51510,15883,14176,1707,14482,77,14405,1401,95,1306,12822,11117,1705,7220,5639,1581,1941,329,70,4880
4/1/2015,VA,Virginia,Alleghany,51005,4430,3785,645,3544,20,3524,886,13,873,4188,3543,645,3317,2803,514,827,108,49,2333
4/1/2015,VA,Virginia,Amelia,51007,2865,2221,644,2377,11,2366,488,13,475,2647,2003,644,2015,1422,593,474,87,26,1428
4/1/2015,VA,Virginia,Amherst,51009,7288,6165,1123,5975,46,5929,1313,38,1275,6772,5649,1123,5367,4330,1037,1147,233,78,3909
4/1/2015,VA,Virginia,Appomattox,51011,3675,3124,551,2962,23,2939,713,20,693,3457,2906,551,2740,2239,501,683,101,49,1907
4/1/2015,VA,Virginia,Arlington,51013,21882,19572,2310,20254,83,20171,1628,84,1544,17448,15138,2310,9766,7633,2133,2813,321,122,6510
4/1/2015,VA,Virginia,Augusta,51015,16606,14265,2341,14193,55,14138,2413,38,2375,15555,13214,2341,11603,9647,1956,1793,376,154,9280
4/1/2015,VA,Virginia,Bath,51017,1262,1140,122,1106,*,*,156,*,*,1181,1059,122,919,813,106,201,33,21,664
4/1/2015,VA,Virginia,Bedford,51019,18016,14777,3239,15210,71,15139,2806,50,2756,16817,13581,3236,12766,10110,2656,1948,461,155,10202
4/1/2015,VA,Virginia,Bland,51021,1701,1350,351,1330,*,*,371,*,*,1602,1251,351,1188,924,264,243,55,18,872
4/1/2015,VA,Virginia,Botetourt,51023,7905,6163,1742,6776,36,6740,1129,16,1113,7309,5567,1742,5604,4016,1588,831,169,56,4548
4/1/2015,VA,Virginia,Bristol City,51520,4370,2673,1697,3389,*,*,981,11,970,4110,2413,1697,3387,1740,1647,973,168,55,2191
4/1/2015,VA,Virginia,Brunswick,51025,3813,3125,688,3086,30,3056,727,29,698,3592,2904,688,2793,2168,625,1076,111,39,1567
4/1/2015,VA,Virginia,Buchanan,51027,7318,4601,2717,4449,16,4433,2869,13,2856,7029,4313,2716,5725,3829,1896,1597,426,107,3595
4/1/2015,VA,Virginia,Buckingham,51029,3274,2634,640,2632,13,2619,642,12,630,3040,2400,640,2302,1753,549,700,144,43,1415
4/1/2015,VA,Virginia,Buena Vista City,51530,1413,1148,265,1129,*,*,284,*,*,1320,1055,265,1019,798,221,329,56,18,616
4/1/2015,VA,Virginia,Campbell,51031,12020,10130,1890,9822,73,9749,2198,66,2132,11281,9391,1890,8923,7199,1724,2033,365,181,6344
4/1/2015,VA,Virginia,Caroline,51033,5247,4332,915,4358,34,4324,889,37,852,4763,3848,915,3155,2335,820,740,237,54,2124
4/1/2015,VA,Virginia,Carroll,51035,7711,6646,1065,6122,23,6099,1589,21,1568,7323,6258,1065,5594,4743,851,1635,271,107,3581
4/1/2015,VA,Virginia,Charles City,51036,1719,1327,392,1440,18,1422,279,12,267,1593,1201,392,1186,862,324,261,82,15,828
4/1/2015,VA,Virginia,Charlotte,51037,3247,2751,496,2623,19,2604,624,12,612,3057,2561,496,2373,1930,443,771,130,52,1420
4/1/2015,VA,Virginia,Charlottesville City,51540,5818,5096,722,4680,23,4657,1138,46,1092,5230,4509,721,4107,3419,688,1186,154,53,2714
4/1/2015,VA,Virginia,Chesapeake City,51550,33303,27201,6102,28287,234,28053,5016,238,4778,29961,23859,6102,17744,12082,5662,3790,830,227,12897
4/1/2015,VA,Virginia,Chesterfield,51041,51422,40181,11241,44322,184,44138,7100,224,6876,46192,34953,11239,34074,23810,10264,4723,944,263,28144
4/1/2015,VA,Virginia,Clarke,51043,2853,2550,303,2600,15,2585,253,*,*,2577,2274,303,1677,1426,251,250,74,31,1322
4/1/2015,VA,Virginia,Colonial Heights City,51570,4097,3551,546,3530,*,*,567,13,554,3760,3214,546,2296,1795,501,442,101,24,1729
4/1/2015,VA,Virginia,Covington City,51580,1663,1429,234,1288,*,*,375,*,*,1551,1317,234,1203,981,222,346,55,19,783
4/1/2015,VA,Virginia,Craig,51045,1240,979,261,952,*,*,288,*,*,1137,876,261,883,625,258,200,38,14,631
4/1/2015,VA,Virginia,Culpeper,51047,8245,7182,1063,7056,52,7004,1189,39,1150,7510,6447,1063,5000,4052,948,1083,250,68,3599
4/1/2015,VA,Virginia,Cumberland,51049,2142,1670,472,1756,*,*,386,*,*,1990,1520,470,1511,1082,429,419,75,30,987
4/1/2015,VA,Virginia,Danville City,51590,11017,9258,1759,8593,81,8512,2424,118,2306,10445,8686,1759,8538,7252,1286,3144,443,164,4787
4/1/2015,VA,Virginia,Dickenson,51051,4675,3090,1585,2810,*,*,1865,13,1852,4451,2866,1585,3571,2166,1405,1083,220,88,2180
4/1/2015,VA,Virginia,Dinwiddie,51053,5405,4315,1090,4304,35,4269,1101,32,1069,4950,3860,1090,3571,2526,1045,883,180,50,2458
4/1/2015,VA,Virginia,Emporia City,51595,1142,852,290,876,13,863,266,15,251,1073,783,290,864,622,242,415,62,12,375
4/1/2015,VA,Virginia,Essex,51057,2691,2234,457,2292,17,2275,399,15,384,2503,2046,457,1835,1466,369,417,90,26,1302
4/1/2015,VA,Virginia,Fairfax,51059,133027,116374,16653,125037,529,124508,7990,395,7595,107540,90916,16624,57675,42386,15289,12562,2459,437,42217
4/1/2015,VA,Virginia,Fairfax City,51600,3517,3054,463,3227,13,3214,290,13,277,2966,2503,463,1632,1203,429,389,49,15,1179
4/1/2015,VA,Virginia,Falls Church City,51610,1689,1479,210,1602,*,*,87,*,*,1338,1129,209,748,560,188,129,*,*,597
4/1/2015,VA,Virginia,Fauquier,51061,10987,9986,1001,9915,42,9873,1072,36,1036,9709,8709,1000,5808,4956,852,858,194,53,4703
4/1/2015,VA,Virginia,Floyd,51063,3710,2994,716,3174,13,3161,536,*,*,3467,2751,716,2672,2016,656,525,92,46,2009
4/1/2015,VA,Virginia,Fluvanna,51065,5299,4581,718,4745,27,4718,554,22,532,4842,4124,718,3426,2789,637,461,116,21,2828
4/1/2015,VA,Virginia,Franklin,51067,13519,10053,3466,11097,40,11057,2422,22,2400,12693,9227,3466,10099,6796,3303,1906,467,154,7572
4/1/2015,VA,Virginia,Franklin City,51620,1848,1563,285,1431,18,1413,417,17,400,1741,1456,285,1414,1155,259,524,80,18,792
4/1/2015,VA,Virginia,Frederick,51069,14279,12647,1632,12566,46,12520,1713,45,1668,13047,11417,1630,8652,7265,1387,1381,341,123,6807
4/1/2015,VA,Virginia,Fredericksburg City,51630,3693,3272,421,3012,15,2997,681,29,652,3320,2899,421,2174,1779,395,717,81,44,1332
4/1/2015,VA,Virginia,Galax City,51640,1935,1809,126,1483,*,*,452,*,*,1833,1707,126,1439,1338,101,672,65,33,669
4/1/2015,VA,Virginia,Giles,51071,4405,3261,1144,3457,20,3437,948,13,935,4143,3000,1143,3356,2334,1022,764,136,37,2419
4/1/2015,VA,Virginia,Gloucester,51073,7666,6455,1211,6539,31,6508,1127,21,1106,7032,5821,1211,4370,3271,1099,896,176,50,3248
4/1/2015,VA,Virginia,Goochland,51075,4959,4024,935,4476,22,4454,483,17,466,4511,3576,935,3526,2724,802,406,101,35,2984
4/1/2015,VA,Virginia,Grayson,51077,4475,3953,522,3618,*,*,857,*,*,4292,3770,522,3159,2729,430,1003,181,84,1891
4/1/2015,VA,Virginia,Greene,51079,3304,2868,436,2872,13,2859,432,11,421,3021,2585,436,2131,1728,403,404,74,22,1631
4/1/2015,VA,Virginia,Greensville,51081,2377,1766,611,1865,23,1842,512,22,490,2208,1597,611,1805,1259,546,558,123,24,1100
4/1/2015,VA,Virginia,Halifax,51083,9261,8066,1195,7462,59,7403,1799,71,1728,8705,7511,1194,6949,5863,1086,2159,441,125,4224
4/1/2015,VA,Virginia,Hampton City,51650,23177,18001,5176,18878,197,18681,4299,211,4088,21183,16007,5176,12545,7581,4964,3416,752,177,8200
4/1/2015,VA,Virginia,Hanover,51085,18425,14581,3844,16559,72,16487,1866,51,1815,16764,12920,3844,12801,9512,3289,1340,363,98,11000
4/1/2015,VA,Virginia,Harrisonburg City,51660,4981,4408,573,4167,20,4147,814,23,791,4543,3970,573,3487,3060,427,929,124,37,2397
4/1/2015,VA,Virginia,Henrico,51087,50454,38861,11593,43638,332,43306,6816,298,6518,45670,34078,11592,35133,25009,10124,5709,1304,387,27733
4/1/2015,VA,Virginia,Henry,51089,14829,10792,4037,11624,72,11552,3205,62,3143,14128,10091,4037,11852,8671,3181,3090,672,231,7859
4/1/2015,VA,Virginia,Highland,51091,708,639,69,651,*,*,57,*,*,668,599,69,482,418,64,66,*,*,395
4/1/2015,VA,Virginia,Hopewell City,51670,4346,3526,820,3342,29,3313,1004,32,972,4047,3227,820,2698,1901,797,923,158,38,1579
4/1/2015,VA,Virginia,Isle of Wight,51093,7274,5700,1574,6311,38,6273,963,30,933,6750,5176,1574,4730,3240,1490,887,184,75,3584
4/1/2015,VA,Virginia,James City,51095,18044,15915,2129,16926,53,16873,1118,39,1079,16650,14525,2125,10124,8320,1804,842,195,44,9043
4/1/2015,VA,Virginia,King and Queen,51097,1609,1357,252,1345,*,*,264,*,*,1500,1248,252,1115,888,227,266,*,*,765
4/1/2015,VA,Virginia,King George,51099,3371,3040,331,2888,19,2869,483,20,463,2925,2594,331,1441,1132,309,421,86,19,915
4/1/2015,VA,Virginia,King William,51101,2964,2547,417,2522,17,2505,442,25,417,2731,2314,417,2110,1748,362,368,85,21,1636
4/1/2015,VA,Virginia,Lancaster,51103,4148,3590,558,3807,17,3790,341,11,330,3967,3409,558,2734,2335,399,484,83,29,2138
4/1/2015,VA,Virginia,Lee,51105,6295,4188,2107,4201,14,4187,2094,15,2079,5975,3871,2104,4768,2793,1975,1925,249,80,2514
4/1/2015,VA,Virginia,Lexington City,51678,1585,1422,163,1438,15,1423,147,*,*,1482,1319,163,1109,970,139,220,*,*,851
4/1/2015,VA,Virginia,Loudoun,51107,30445,26462,3983,28247,98,28149,2198,103,2095,25253,21277,3976,15482,11939,3543,2550,581,136,12215
4/1/2015,VA,Virginia,Louisa,51109,7040,5848,1192,5853,38,5815,1187,34,1153,6468,5276,1192,4642,3552,1090,1011,251,65,3315
4/1/2015,VA,Virginia,Lunenburg,51111,2907,2482,425,2353,18,2335,554,21,533,2678,2253,425,1973,1577,396,665,122,43,1143
4/1/2015,VA,Virginia,Lynchburg City,51680,14193,12136,2057,11211,93,11118,2982,107,2875,13226,11170,2056,10566,8706,1860,3215,434,151,6766
4/1/2015,VA,Virginia,Madison,51113,2766,2387,379,2429,12,2417,337,*,*,2579,2200,379,1836,1490,346,378,87,25,1346
4/1/2015,VA,Virginia,Manassas City,51683,3979,3344,635,3432,29,3403,547,32,515,3357,2723,634,2224,1632,592,488,100,31,1605
4/1/2015,VA,Virginia,Manassas Park City,51685,1089,903,186,931,11,920,158,13,145,903,717,186,611,439,172,149,47,12,403
4/1/2015,VA,Virginia,Martinsville City,51690,3902,3057,845,2932,20,2912,970,39,931,3723,2878,845,3197,2512,685,1282,169,58,1688
4/1/2015,VA,Virginia,Mathews,51115,2712,2334,378,2483,*,*,229,*,*,2568,2190,378,1697,1369,328,259,46,19,1373
4/1/2015,VA,Virginia,Mecklenburg,51117,8867,7425,1442,7244,52,7192,1623,54,1569,8371,6931,1440,6452,5286,1166,1892,359,122,4079
4/1/2015,VA,Virginia,Middlesex,51119,3374,2857,517,3010,20,2990,364,*,*,3170,2653,517,2338,1936,402,410,85,26,1817
4/1/2015,VA,Virginia,Montgomery,51121,12759,10547,2212,10431,40,10391,2328,34,2294,11590,9378,2212,9164,7078,2086,1784,293,119,6968
4/1/2015,VA,Virginia,Nelson,51125,4150,3582,568,3611,17,3594,539,15,524,3835,3267,568,2753,2230,523,596,99,42,2016
4/1/2015,VA,Virginia,New Kent,51127,3744,3105,639,3303,16,3287,441,11,430,3420,2781,639,2318,1804,514,280,74,21,1943
4/1/2015,VA,Virginia,Newport News City,51700,26024,19875,6149,21310,172,21138,4714,237,4477,23849,17704,6145,15098,9188,5910,4327,769,219,9783
4/1/2015,VA,Virginia,Norfolk City,51710,30453,23411,7042,24056,259,23797,6397,354,6043,27444,20402,7042,17801,11031,6770,6628,1247,276,9650
4/1/2015,VA,Virginia,Northampton,51131,3361,2839,522,2839,29,2810,522,32,490,3152,2630,522,2473,1995,478,884,93,41,1455
4/1/2015,VA,Virginia,Northumberland,51133,4493,3926,567,4147,15,4132,346,*,*,4210,3643,567,2676,2309,367,418,95,34,2129
4/1/2015,VA,Virginia,Norton City,51720,1164,860,304,767,*,*,397,*,*,1077,774,303,845,561,284,353,50,19,423
4/1/2015,VA,Virginia,Nottoway,51135,3518,2862,656,2849,28,2821,669,19,650,3262,2606,656,2506,2006,500,907,128,45,1426
4/1/2015,VA,Virginia,Orange,51137,8114,7120,994,7112,42,7070,1002,38,964,7471,6478,993,4694,3861,833,917,231,64,3482
4/1/2015,VA,Virginia,Page,51139,5830,5127,703,4701,19,4682,1129,17,1112,5464,4761,703,3927,3312,615,1130,207,82,2508
4/1/2015,VA,Virginia,Patrick,51141,5014,3795,1219,4095,13,4082,919,15,904,4791,3573,1218,3815,2777,1038,970,193,76,2576
4/1/2015,VA,Virginia,Petersburg City,51730,6985,5375,1610,5101,99,5002,1884,91,1793,6386,4776,1610,4491,2932,1559,1927,365,71,2128
4/1/2015,VA,Virginia,Pittsylvania,51143,15199,12461,2738,12318,113,12205,2881,84,2797,14405,11667,2738,11662,9257,2405,3027,575,210,7850
4/1/2015,VA,Virginia,Poquoson City,51735,2396,2123,273,2212,*,*,184,0,184,2179,1906,273,1046,797,249,100,*,*,908
4/1/2015,VA,Virginia,Portsmouth City,51740,17311,13162,4149,13258,196,13062,4053,211,3842,15469,11320,4149,9895,5922,3973,3742,666,153,5334
4/1/2015,VA,Virginia,Powhatan,51145,5224,4184,1040,4618,24,4594,606,15,591,4778,3738,1040,3648,2715,933,374,101,32,3141
4/1/2015,VA,Virginia,Prince Edward,51147,4379,3601,778,3477,27,3450,902,32,870,4082,3305,777,3088,2456,632,1022,172,43,1851
4/1/2015,VA,Virginia,Prince George,51149,5273,4582,691,4420,28,4392,853,22,831,4882,4191,691,2777,2141,636,516,108,28,2125
4/1/2015,VA,Virginia,Prince William,51153,40737,34120,6617,36027,233,35794,4710,286,4424,34712,28099,6613,19036,12911,6125,4390,922,182,13542
4/1/2015,VA,Virginia,Pulaski,51155,8763,7171,1592,6824,26,6798,1939,32,1907,8188,6596,1592,6243,4740,1503,1643,329,121,4150
4/1/2015,VA,Virginia,Radford City,51750,1958,1595,363,1568,*,*,390,*,*,1798,1435,363,1474,1130,344,319,45,27,1083
4/1/2015,VA,Virginia,Rappahannock,51157,1884,1736,148,1722,*,*,162,*,*,1704,1556,148,1071,949,122,157,39,12,863
4/1/2015,VA,Virginia,Richmond,51159,1835,1480,355,1582,14,1568,253,12,241,1727,1372,355,1234,978,256,293,88,21,832
4/1/2015,VA,Virginia,Richmond City,51760,31503,22149,9354,24257,279,23978,7246,357,6889,28339,18985,9354,22947,13978,8969,8102,1400,321,13124
4/1/2015,VA,Virginia,Roanoke,51161,21792,17628,4164,19133,94,19039,2659,50,2609,20197,16033,4164,15519,11713,3806,1910,415,146,13048
4/1/2015,VA,Virginia,Roanoke City,51770,19532,14422,5110,14404,121,14283,5128,149,4979,17960,12851,5109,14218,9336,4882,4655,794,220,8549
4/1/2015,VA,Virginia,Rockbridge,51163,5592,4704,888,4701,20,4681,891,*,*,5214,4326,888,3825,3085,740,806,173,64,2782
4/1/2015,VA,Virginia,Rockingham,51165,15898,13416,2482,13842,50,13792,2056,47,2009,14703,12222,2481,11073,9264,1809,1728,489,141,8715
4/1/2015,VA,Virginia,Russell,51167,7659,5319,2340,5059,12,5047,2600,11,2589,7317,4977,2340,6116,4190,1926,1712,302,125,3977
4/1/2015,VA,Virginia,Salem City,51775,5811,4754,1057,4879,29,4850,932,19,913,5318,4261,1057,4116,3141,975,817,138,42,3119
4/1/2015,VA,Virginia,Scott,51169,6473,3359,3114,4799,17,4782,1674,12,1662,6197,3083,3114,5328,2272,3056,1542,247,111,3428
4/1/2015,VA,Virginia,Shenandoah,51171,9779,8673,1106,8563,19,8544,1216,29,1187,9156,8050,1106,6159,5247,912,1228,242,102,4587
4/1/2015,VA,Virginia,Smyth,51173,8647,6835,1812,6341,19,6322,2306,28,2278,8161,6349,1812,6514,4884,1630,2124,403,160,3827
4/1/2015,VA,Virginia,Southampton,51175,3872,3255,617,3196,26,3170,676,27,649,3613,2996,617,2764,2216,548,708,138,31,1887
4/1/2015,VA,Virginia,Spotsylvania,51177,17975,15800,2175,15447,111,15336,2528,93,2435,15998,13825,2173,9346,7450,1896,1764,481,115,6986
4/1/2015,VA,Virginia,Stafford,51179,14528,13143,1385,12652,76,12576,1876,96,1780,12727,11343,1384,6266,5059,1207,1189,335,78,4664
4/1/2015,VA,Virginia,Staunton City,51790,5798,5144,654,4699,23,4676,1099,27,1072,5441,4787,654,4179,3633,546,1042,163,50,2924
4/1/2015,VA,Virginia,Suffolk City,51800,14275,11612,2663,11534,85,11449,2741,93,2648,13012,10351,2661,8724,6294,2430,2577,402,105,5640
4/1/2015,VA,Virginia,Surry,51181,1455,1108,347,1213,14,1199,242,13,229,1346,999,347,959,632,327,215,66,14,664
4/1/2015,VA,Virginia,Sussex,51183,2292,1807,485,1838,36,1802,454,*,*,2132,1647,485,1615,1158,457,471,138,24,982
4/1/2015,VA,Virginia,Tazewell,51185,11507,8438,3069,8335,41,8294,3172,37,3135,10885,7818,3067,8442,6478,1964,2178,431,169,5664
4/1/2015,VA,Virginia,Unknown,51999,*,*,*,*,*,*,*,*,*,*,*,*,*,*,*,*,*,*,*
4/1/2015,VA,Virginia,Virginia Beach City,51810,63166,53227,9939,55349,310,55039,7817,328,7489,57682,47748,9934,31424,22188,9236,6210,1277,329,23608
4/1/2015,VA,Virginia,Warren,51187,6748,6095,653,5715,22,5693,1033,26,1007,6151,5498,653,3994,3439,555,830,229,65,2870
4/1/2015,VA,Virginia,Washington,51191,14438,9964,4474,11310,58,11252,3128,21,3107,13597,9124,4473,10741,6618,4123,2478,520,183,7560
4/1/2015,VA,Virginia,Waynesboro City,51820,4675,3988,687,3807,20,3787,868,23,845,4380,3693,687,3418,2814,604,862,102,46,2408
4/1/2015,VA,Virginia,Westmoreland,51193,4583,3989,594,3991,26,3965,592,*,*,4192,3598,594,2569,2064,505,729,124,42,1674
4/1/2015,VA,Virginia,Williamsburg City,51830,2370,2030,340,2174,*,*,196,*,*,2151,1812,339,1458,1162,296,200,*,*,1223
4/1/2015,VA,Virginia,Winchester City,51840,4839,4337,502,4120,18,4102,719,19,700,4408,3906,502,3083,2648,435,788,122,42,2131
4/1/2015,VA,Virginia,Wise,51195,10254,6916,3338,6667,15,6652,3587,19,3568,9657,6320,3337,7481,4351,3130,2356,483,160,4482
4/1/2015,VA,Virginia,Wythe,51197,7276,5869,1407,5594,29,5565,1682,25,1657,6876,5469,1407,5254,4050,1204,1451,282,100,3421
4/1/2015,VA,Virginia,York,51199,10678,9376,1302,9771,49,9722,907,30,877,9763,8463,1300,5066,3859,1207,639,161,38,4228
8/1/2015,VA,Virginia,Accomack,51001,8325,7173,1152,7055,41,7014,1270,43,1227,7799,6647,1152,5596,4608,988,1540,363,90,3603
8/1/2015,VA,Virginia,Albemarle,51003,18099,16173,1926,16514,59,16455,1585,52,1533,16264,14338,1926,11974,10245,1729,1472,268,87,10147
8/1/2015,VA,Virginia,Alexandria City,51510,16161,14023,2138,14740,74,14666,1421,92,1329,13086,10950,2136,7331,5321,2010,1987,330,73,4941
8/1/2015,VA,Virginia,Alleghany,51005,4449,3806,643,3547,17,3530,902,12,890,4220,3577,643,3341,2826,515,833,105,49,2354
8/1/2015,VA,Virginia,Amelia,51007,2885,2248,637,2393,*,*,492,12,480,2667,2030,637,2024,1438,586,478,86,27,1433
8/1/2015,VA,Virginia,Amherst,51009,7322,6184,1138,5994,41,5953,1328,37,1291,6825,5687,1138,5407,4355,1052,1167,227,76,3937
8/1/2015,VA,Virginia,Appomattox,51011,3696,3149,547,2973,21,2952,723,21,702,3478,2931,547,2740,2244,496,690,99,50,1901
8/1/2015,VA,Virginia,Arlington,51013,22263,19346,2917,20607,75,20532,1656,83,1573,17743,14826,2917,9874,7125,2749,2863,320,120,6571
8/1/2015,VA,Virginia,Augusta,51015,16723,14362,2361,14278,45,14233,2445,40,2405,15674,13313,2361,11704,9722,1982,1840,383,155,9326
8/1/2015,VA,Virginia,Bath,51017,1259,1143,116,1101,*,*,158,*,*,1180,1064,116,915,813,102,194,36,20,665
8/1/2015,VA,Virginia,Bedford,51019,18200,14968,3232,15344,65,15279,2856,51,2805,17005,13776,3229,12911,10253,2658,1993,461,160,10297
8/1/2015,VA,Virginia,Bland,51021,1710,1354,356,1331,*,*,379,*,*,1613,1257,356,1199,930,269,260,52,17,870
8/1/2015,VA,Virginia,Botetourt,51023,8013,6276,1737,6860,35,6825,1153,15,1138,7409,5672,1737,5691,4109,1582,856,169,56,4610
8/1/2015,VA,Virginia,Bristol City,51520,4380,2663,1717,3387,11,3376,993,11,982,4126,2409,1717,3403,1736,1667,994,168,56,2185
8/1/2015,VA,Virginia,Brunswick,51025,3838,3157,681,3088,28,3060,750,29,721,3621,2940,681,2811,2192,619,1102,111,37,1561
8/1/2015,VA,Virginia,Buchanan,51027,7335,4606,2729,4419,12,4407,2916,13,2903,7044,4315,2729,5786,3877,1909,1633,418,110,3625
8/1/2015,VA,Virginia,Buckingham,51029,3298,2670,628,2644,13,2631,654,13,641,3072,2444,628,2328,1792,536,711,145,44,1428
8/1/2015,VA,Virginia,Buena Vista City,51530,1411,1148,263,1122,*,*,289,*,*,1324,1061,263,1013,794,219,330,56,18,609
8/1/2015,VA,Virginia,Campbell,51031,12106,10205,1901,9875,72,9803,2231,61,2170,11378,9477,1901,8985,7251,1734,2062,362,178,6383
8/1/2015,VA,Virginia,Caroline,51033,5322,4405,917,4406,31,4375,916,38,878,4842,3925,917,3197,2372,825,773,240,54,2130
8/1/2015,VA,Virginia,Carroll,51035,7760,6688,1072,6149,22,6127,1611,19,1592,7374,6302,1072,5630,4766,864,1664,269,105,3592
8/1/2015,VA,Virginia,Charles City,51036,1742,1347,395,1462,17,1445,280,12,268,1619,1224,395,1195,868,327,268,78,17,832
8/1/2015,VA,Virginia,Charlotte,51037,3278,2773,505,2640,18,2622,638,12,626,3094,2589,505,2384,1933,451,783,127,49,1425
8/1/2015,VA,Virginia,Charlottesville City,51540,5885,5148,737,4730,23,4707,1155,46,1109,5291,4555,736,4141,3438,703,1219,154,57,2711
8/1/2015,VA,Virginia,Chesapeake City,51550,33692,27520,6172,28570,222,28348,5122,237,4885,30446,24274,6172,17974,12230,5744,3875,837,222,13040
8/1/2015,VA,Virginia,Chesterfield,51041,52187,40853,11334,44909,169,44740,7278,222,7056,47018,35686,11332,34646,24290,10356,4850,948,268,28580
8/1/2015,VA,Virginia,Clarke,51043,2888,2587,301,2629,15,2614,259,*,*,2609,2308,301,1698,1444,254,254,76,32,1336
8/1/2015,VA,Virginia,Colonial Heights City,51570,4116,3565,551,3530,*,*,586,12,574,3784,3233,551,2306,1801,505,457,99,24,1726
8/1/2015,VA,Virginia,Covington City,51580,1672,1437,235,1289,*,*,383,*,*,1559,1324,235,1211,988,223,351,53,22,785
8/1/2015,VA,Virginia,Craig,51045,1251,986,265,959,*,*,292,*,*,1152,887,265,892,630,262,201,39,13,639
8/1/2015,VA,Virginia,Culpeper,51047,8326,7269,1057,7120,49,7071,1206,39,1167,7613,6556,1057,5073,4127,946,1114,254,64,3641
8/1/2015,VA,Virginia,Cumberland,51049,2157,1677,480,1766,*,*,391,*,*,2004,1525,479,1528,1091,437,431,75,30,992
8/1/2015,VA,Virginia,Danville City,51590,11051,9292,1759,8594,77,8517,2457,116,2341,10475,8716,1759,8542,7244,1298,3191,438,162,4751
8/1/2015,VA,Virginia,Dickenson,51051,4684,3069,1615,2803,*,*,1881,13,1868,4471,2856,1615,3583,2149,1434,1101,223,89,2170
8/1/2015,VA,Virginia,Dinwiddie,51053,5442,4348,1094,4329,33,4296,1113,32,1081,5004,3910,1094,3597,2548,1049,892,177,49,2479
8/1/2015,VA,Virginia,Emporia City,51595,1133,859,274,861,11,850,272,14,258,1060,786,274,853,625,228,420,60,12,361
8/1/2015,VA,Virginia,Essex,51057,2718,2258,460,2310,17,2293,408,16,392,2537,2077,460,1852,1483,369,426,91,27,1308
8/1/2015,VA,Virginia,Fairfax,51059,135490,118408,17082,127339,499,126840,8151,396,7755,109960,92905,17055,58946,43199,15747,12889,2487,446,43124
8/1/2015,VA,Virginia,Fairfax City,51600,3571,3098,473,3277,13,3264,294,12,282,3007,2534,473,1662,1220,442,393,51,14,1204
8/1/2015,VA,Virginia,Falls Church City,51610,1732,1510,222,1641,*,*,91,*,*,1367,1146,221,777,574,203,136,*,*,620
8/1/2015,VA,Virginia,Fauquier,51061,11136,10130,1006,10043,39,10004,1093,41,1052,9835,8830,1005,5908,5041,867,891,192,53,4772
8/1/2015,VA,Virginia,Floyd,51063,3735,3021,714,3190,13,3177,545,*,*,3500,2786,714,2687,2034,653,532,93,49,2013
8/1/2015,VA,Virginia,Fluvanna,51065,5355,4643,712,4799,26,4773,556,24,532,4892,4180,712,3458,2826,632,472,114,21,2851
8/1/2015,VA,Virginia,Franklin,51067,13641,10173,3468,11170,40,11130,2471,22,2449,12815,9347,3468,10177,6873,3304,1944,465,161,7607
8/1/2015,VA,Virginia,Franklin City,51620,1861,1566,295,1440,16,1424,421,19,402,1755,1460,295,1419,1149,270,542,73,17,787
8/1/2015,VA,Virginia,Frederick,51069,14435,12800,1635,12687,43,12644,1748,44,1704,13183,11550,1633,8756,7366,1390,1415,343,119,6879
8/1/2015,VA,Virginia,Fredericksburg City,51630,3743,3320,423,3050,14,3036,693,27,666,3375,2952,423,2217,1818,399,737,80,42,1358
8/1/2015,VA,Virginia,Galax City,51640,1930,1807,123,1472,*,*,458,*,*,1829,1706,123,1433,1336,97,679,61,33,660
8/1/2015,VA,Virginia,Giles,51071,4433,3293,1140,3468,16,3452,965,13,952,4175,3036,1139,3365,2351,1014,771,133,37,2424
8/1/2015,VA,Virginia,Gloucester,51073,7750,6537,1213,6592,29,6563,1158,23,1135,7133,5920,1213,4406,3303,1103,913,174,50,3269
8/1/2015,VA,Virginia,Goochland,51075,5048,4112,936,4553,18,4535,495,18,477,4587,3651,936,3582,2781,801,421,104,35,3022
8/1/2015,VA,Virginia,Grayson,51077,4500,3974,526,3624,*,*,876,*,*,4313,3787,526,3158,2720,438,1015,177,85,1881
8/1/2015,VA,Virginia,Greene,51079,3364,2928,436,2920,12,2908,444,11,433,3078,2642,436,2154,1751,403,413,72,23,1646
8/1/2015,VA,Virginia,Greensville,51081,2390,1787,603,1873,20,1853,517,21,496,2227,1624,603,1819,1283,536,579,120,22,1098
8/1/2015,VA,Virginia,Halifax,51083,9301,8103,1198,7477,56,7421,1824,69,1755,8764,7567,1197,6983,5894,1089,2176,434,127,4246
8/1/2015,VA,Virginia,Hampton City,51650,23359,18143,5216,18998,183,18815,4361,210,4151,21377,16161,5216,12619,7608,5011,3498,758,178,8185
8/1/2015,VA,Virginia,Hanover,51085,18587,14735,3852,16686,69,16617,1901,51,1850,16935,13083,3852,12947,9658,3289,1381,355,98,11113
8/1/2015,VA,Virginia,Harrisonburg City,51660,5016,4444,572,4192,18,4174,824,23,801,4562,3990,572,3506,3077,429,933,122,35,2416
8/1/2015,VA,Virginia,Henrico,51087,51034,39373,11661,44091,313,43778,6943,301,6642,46268,34608,11660,35541,25349,10192,5851,1314,384,27992
8/1/2015,VA,Virginia,Henry,51089,14883,10839,4044,11638,68,11570,3245,61,3184,14197,10153,4044,11879,8672,3207,3151,669,232,7827
8/1/2015,VA,Virginia,Highland,51091,708,644,64,651,*,*,57,*,*,670,606,64,484,424,60,70,*,*,392
8/1/2015,VA,Virginia,Hopewell City,51670,4369,3549,820,3345,27,3318,1024,33,991,4081,3261,820,2717,1920,797,943,153,37,1584
8/1/2015,VA,Virginia,Isle of Wight,51093,7331,5761,1570,6350,36,6314,981,30,951,6808,5238,1570,4754,3270,1484,896,184,75,3599
8/1/2015,VA,Virginia,James City,51095,18251,16121,2130,17103,51,17052,1148,42,1106,16876,14750,2126,10267,8461,1806,868,191,45,9163
8/1/2015,VA,Virginia,King and Queen,51097,1633,1384,249,1359,*,*,274,*,*,1530,1281,249,1130,908,222,269,73,11,777
8/1/2015,VA,Virginia,King George,51099,3416,3089,327,2920,19,2901,496,21,475,2982,2655,327,1470,1164,306,436,83,18,933
8/1/2015,VA,Virginia,King William,51101,3005,2586,419,2549,16,2533,456,25,431,2777,2358,419,2137,1774,363,380,89,22,1646
8/1/2015,VA,Virginia,Lancaster,51103,4167,3610,557,3813,15,3798,354,*,*,3993,3436,557,2748,2350,398,497,80,29,2142
8/1/2015,VA,Virginia,Lee,51105,6299,4182,2117,4172,11,4161,2127,13,2114,5991,3878,2113,4767,2777,1990,1939,245,80,2503
8/1/2015,VA,Virginia,Lexington City,51678,1596,1434,162,1447,14,1433,149,*,*,1491,1329,162,1113,974,139,222,*,*,853
8/1/2015,VA,Virginia,Loudoun,51107,31037,26480,4557,28777,96,28681,2260,109,2151,25840,21288,4552,15862,11740,4122,2663,572,137,12490
8/1/2015,VA,Virginia,Louisa,51109,7103,5935,1168,5891,37,5854,1212,34,1178,6538,5370,1168,4697,3626,1071,1040,244,66,3347
8/1/2015,VA,Virginia,Lunenburg,51111,2920,2506,414,2360,17,2343,560,21,539,2701,2287,414,1990,1604,386,690,122,41,1137
8/1/2015,VA,Virginia,Lynchburg City,51680,14260,12204,2056,11236,86,11150,3024,104,2920,13284,11229,2055,10585,8723,1862,3260,426,145,6754
8/1/2015,VA,Virginia,Madison,51113,2782,2409,373,2438,11,2427,344,*,*,2585,2212,373,1854,1514,340,386,85,25,1358
8/1/2015,VA,Virginia,Manassas City,51683,4046,3388,658,3483,29,3454,563,34,529,3430,2773,657,2271,1653,618,507,96,35,1633
8/1/2015,VA,Virginia,Manassas Park City,51685,1116,921,195,949,*,*,167,16,151,925,731,194,619,438,181,156,50,13,400
8/1/2015,VA,Virginia,Martinsville City,51690,3896,3049,847,2915,18,2897,981,38,943,3729,2882,847,3195,2506,689,1299,167,61,1668
8/1/2015,VA,Virginia,Mathews,51115,2728,2354,374,2497,*,*,231,*,*,2598,2224,374,1712,1388,324,254,48,17,1393
8/1/2015,VA,Virginia,Mecklenburg,51117,8896,7456,1440,7256,49,7207,1640,54,1586,8414,6976,1438,6487,5321,1166,1909,371,124,4083
8/1/2015,VA,Virginia,Middlesex,51119,3389,2881,508,3021,20,3001,368,*,*,3196,2688,508,2351,1958,393,407,85,29,1830
8/1/2015,VA,Virginia,Montgomery,51121,12848,10644,2204,10477,38,10439,2371,34,2337,11714,9510,2204,9268,7187,2081,1826,294,123,7025
8/1/2015,VA,Virginia,Nelson,51125,4196,3628,568,3647,16,3631,549,15,534,3874,3306,568,2782,2259,523,605,102,45,2030
8/1/2015,VA,Virginia,New Kent,51127,3793,3156,637,3343,16,3327,450,11,439,3473,2836,637,2356,1846,510,294,76,21,1965
8/1/2015,VA,Virginia,Newport News City,51700,26189,20060,6129,21391,163,21228,4798,241,4557,24073,17947,6126,15180,9286,5894,4424,763,224,9769
8/1/2015,VA,Virginia,Norfolk City,51710,30714,23591,7123,24176,249,23927,6538,358,6180,27777,20654,7123,17987,11133,6854,6807,1246,273,9661
8/1/2015,VA,Virginia,Northampton,51131,3400,2879,521,2863,28,2835,537,31,506,3184,2663,521,2502,2023,479,894,91,35,1482
8/1/2015,VA,Virginia,Northumberland,51133,4524,3966,558,4170,14,4156,354,*,*,4242,3684,558,2689,2328,361,426,97,34,2132
8/1/2015,VA,Virginia,Norton City,51720,1172,868,304,773,*,*,399,*,*,1084,780,304,854,569,285,359,48,19,428
8/1/2015,VA,Virginia,Nottoway,51135,3535,2893,642,2857,28,2829,678,20,658,3288,2646,642,2519,2032,487,907,128,42,1442
8/1/2015,VA,Virginia,Orange,51137,8185,7206,979,7164,40,7124,1021,36,985,7531,6553,978,4734,3913,821,938,226,68,3502
8/1/2015,VA,Virginia,Page,51139,5870,5171,699,4716,19,4697,1154,17,1137,5499,4800,699,3956,3347,609,1154,211,81,2510
8/1/2015,VA,Virginia,Patrick,51141,5005,3807,1198,4084,12,4072,921,16,905,4781,3584,1197,3804,2784,1020,984,193,80,2547
8/1/2015,VA,Virginia,Petersburg City,51730,7050,5411,1639,5139,96,5043,1911,88,1823,6463,4824,1639,4554,2966,1588,1977,359,77,2141
8/1/2015,VA,Virginia,Pittsylvania,51143,15298,12567,2731,12375,104,12271,2923,81,2842,14521,11790,2731,11715,9314,2401,3069,550,213,7883
8/1/2015,VA,Virginia,Poquoson City,51735,2410,2139,271,2227,*,*,183,0,183,2203,1932,271,1060,812,248,100,*,*,921
8/1/2015,VA,Virginia,Portsmouth City,51740,17443,13269,4174,13321,185,13136,4122,210,3912,15671,11497,4174,10006,6003,4003,3844,655,158,5349
8/1/2015,VA,Virginia,Powhatan,51145,5288,4255,1033,4670,22,4648,618,15,603,4854,3821,1033,3708,2781,927,383,102,35,3188
8/1/2015,VA,Virginia,Prince Edward,51147,4416,3644,772,3490,26,3464,926,33,893,4121,3349,772,3118,2496,622,1053,168,44,1853
8/1/2015,VA,Virginia,Prince George,51149,5349,4667,682,4475,25,4450,874,23,851,4939,4257,682,2811,2182,629,533,108,26,2144
8/1/2015,VA,Virginia,Prince William,51153,41588,34859,6729,36764,225,36539,4824,288,4536,35604,28879,6725,19477,13244,6233,4597,929,187,13764
8/1/2015,VA,Virginia,Pulaski,51155,8810,7221,1589,6838,23,6815,1972,31,1941,8230,6641,1589,6248,4745,1503,1676,331,121,4120
8/1/2015,VA,Virginia,Radford City,51750,1977,1613,364,1581,*,*,396,*,*,1818,1454,364,1478,1133,345,321,43,26,1088
8/1/2015,VA,Virginia,Rappahannock,51157,1903,1754,149,1739,*,*,164,*,*,1724,1575,149,1086,963,123,158,*,*,880
8/1/2015,VA,Virginia,Richmond,51159,1837,1488,349,1581,13,1568,256,12,244,1732,1383,349,1233,983,250,293,90,22,828
8/1/2015,VA,Virginia,Richmond City,51760,31762,22331,9431,24412,252,24160,7350,353,6997,28654,19223,9431,23181,14139,9042,8324,1408,318,13131
8/1/2015,VA,Virginia,Roanoke,51161,21967,17825,4142,19256,85,19171,2711,49,2662,20357,16215,4142,15644,11863,3781,1930,420,148,13146
8/1/2015,VA,Virginia,Roanoke City,51770,19724,14580,5144,14502,114,14388,5222,150,5072,18113,12972,5141,14332,9413,4919,4766,799,217,8550
8/1/2015,VA,Virginia,Rockbridge,51163,5622,4738,884,4718,18,4700,904,*,*,5234,4350,884,3828,3089,739,827,167,61,2773
8/1/2015,VA,Virginia,Rockingham,51165,16042,13579,2463,13940,45,13895,2102,47,2055,14849,12387,2462,11191,9398,1793,1774,490,144,8783
8/1/2015,VA,Virginia,Russell,51167,7681,5332,2349,5057,12,5045,2624,*,*,7353,5004,2349,6163,4227,1936,1738,304,131,3990
8/1/2015,VA,Virginia,Salem City,51775,5810,4783,1027,4854,26,4828,956,18,938,5315,4288,1027,4107,3158,949,812,141,40,3114
8/1/2015,VA,Virginia,Scott,51169,6472,3371,3101,4775,13,4762,1697,11,1686,6205,3104,3101,5316,2271,3045,1543,251,109,3413
8/1/2015,VA,Virginia,Shenandoah,51171,9804,8702,1102,8572,16,8556,1232,27,1205,9208,8106,1102,6189,5279,910,1258,235,100,4596
8/1/2015,VA,Virginia,Smyth,51173,8658,6829,1829,6322,18,6304,2336,28,2308,8183,6354,1829,6517,4872,1645,2153,400,155,3809
8/1/2015,VA,Virginia,Southampton,51175,3919,3304,615,3229,24,3205,690,27,663,3663,3048,615,2804,2259,545,738,135,34,1897
8/1/2015,VA,Virginia,Spotsylvania,51177,18234,16078,2156,15656,106,15550,2578,94,2484,16282,14127,2155,9534,7652,1882,1821,478,118,7117
8/1/2015,VA,Virginia,Stafford,51179,14774,13412,1362,12859,72,12787,1915,94,1821,13001,11640,1361,6323,5140,1183,1217,340,82,4684
8/1/2015,VA,Virginia,Staunton City,51790,5804,4999,805,4692,21,4671,1112,28,1084,5457,4652,805,4177,3476,701,1074,155,49,2899
8/1/2015,VA,Virginia,Suffolk City,51800,14418,11764,2654,11620,77,11543,2798,93,2705,13197,10544,2653,8800,6373,2427,2611,393,111,5685
8/1/2015,VA,Virginia,Surry,51181,1462,1114,348,1215,11,1204,247,13,234,1355,1007,348,974,646,328,221,66,14,673
8/1/2015,VA,Virginia,Sussex,51183,2296,1811,485,1839,32,1807,457,*,*,2144,1659,485,1616,1160,456,483,137,25,971
8/1/2015,VA,Virginia,Tazewell,51185,11555,8451,3104,8336,37,8299,3219,37,3182,10941,7839,3102,8531,6524,2007,2210,433,169,5719
8/1/2015,VA,Virginia,Unknown,51999,*,*,*,*,*,*,*,*,*,*,*,*,*,*,*,*,*,*,*
8/1/2015,VA,Virginia,Virginia Beach City,51810,63964,53909,10055,55984,303,55681,7980,323,7657,58564,48516,10048,31846,22477,9369,6385,1271,339,23851
8/1/2015,VA,Virginia,Warren,51187,6838,6180,658,5780,19,5761,1058,27,1031,6226,5568,658,4049,3497,552,854,226,70,2899
8/1/2015,VA,Virginia,Washington,51191,14461,9983,4478,11305,56,11249,3156,24,3132,13641,9164,4477,10772,6648,4124,2525,511,178,7558
8/1/2015,VA,Virginia,Waynesboro City,51820,4683,3991,692,3814,20,3794,869,23,846,4398,3706,692,3421,2814,607,871,101,48,2401
8/1/2015,VA,Virginia,Westmoreland,51193,4616,4027,589,4017,25,3992,599,11,588,4226,3637,589,2562,2061,501,734,122,39,1667
8/1/2015,VA,Virginia,Williamsburg City,51830,2398,2062,336,2195,*,*,203,*,*,2177,1842,335,1472,1180,292,209,*,*,1230
8/1/2015,VA,Virginia,Winchester City,51840,4900,4398,502,4159,18,4141,741,18,723,4463,3961,502,3127,2691,436,805,124,40,2158
8/1/2015,VA,Virginia,Wise,51195,10321,6942,3379,6668,14,6654,3653,20,3633,9723,6345,3378,7543,4367,3176,2416,479,162,4486
8/1/2015,VA,Virginia,Wythe,51197,7315,5679,1636,5602,26,5576,1713,24,1689,6920,5284,1636,5277,3843,1434,1487,280,98,3412
8/1/2015,VA,Virginia,York,51199,10806,9510,1296,9873,47,9826,933,32,901,9899,8603,1296,5105,3902,1203,647,158,40,4260
12/1/2015,VA,Virginia,Accomack,51001,8387,7235,1152,7113,38,7075,1274,43,1231,7853,6701,1152,5648,4661,987,1565,372,95,3616
12/1/2015,VA,Virginia,Albemarle,51003,18264,16342,1922,16640,53,16587,1624,57,1567,16418,14496,1922,12110,10384,1726,1489,273,92,10256
12/1/2015,VA,Virginia,Alexandria City,51510,16412,14334,2078,14975,65,14910,1437,91,1346,13193,11117,2076,7391,5439,1952,2002,328,77,4984
12/1/2015,VA,Virginia,Alleghany,51005,4469,3818,651,3552,15,3537,917,12,905,4240,3589,651,3354,2832,522,835,101,48,2370
12/1/2015,VA,Virginia,Amelia,51007,2904,2263,641,2404,*,*,500,12,488,2684,2043,641,2032,1441,591,484,80,29,1439
12/1/2015,VA,Virginia,Amherst,51009,7398,6260,1138,6047,40,6007,1351,34,1317,6882,5744,1138,5432,4382,1050,1175,223,75,3959
12/1/2015,VA,Virginia,Appomattox,51011,3718,3170,548,2973,19,2954,745,21,724,3501,2953,548,2761,2264,497,694,96,51,1920
12/1/2015,VA,Virginia,Arlington,51013,22619,19799,2820,20933,68,20865,1686,84,1602,17963,15143,2820,9955,7301,2654,2905,321,126,6603
12/1/2015,VA,Virginia,Augusta,51015,16857,14525,2332,14371,42,14329,2486,42,2444,15793,13461,2332,11765,9806,1959,1850,379,155,9381
12/1/2015,VA,Virginia,Bath,51017,1257,1144,113,1097,*,*,160,*,*,1180,1067,113,906,809,97,191,36,21,658
12/1/2015,VA,Virginia,Bedford,51019,18329,15076,3253,15437,60,15377,2892,48,2844,17118,13868,3250,13017,10331,2686,2031,467,158,10361
12/1/2015,VA,Virginia,Bland,51021,1718,1367,351,1334,*,*,384,*,*,1615,1264,351,1199,934,265,266,50,18,865
12/1/2015,VA,Virginia,Botetourt,51023,8079,6340,1739,6902,34,6868,1177,15,1162,7467,5728,1739,5719,4130,1589,864,173,57,4625
12/1/2015,VA,Virginia,Bristol City,51520,4390,2683,1707,3379,11,3368,1011,12,999,4126,2419,1707,3402,1745,1657,1009,164,54,2175
12/1/2015,VA,Virginia,Brunswick,51025,3854,3167,687,3100,22,3078,754,28,726,3636,2949,687,2813,2189,624,1110,109,40,1554
12/1/2015,VA,Virginia,Buchanan,51027,7348,4627,2721,4406,12,4394,2942,12,2930,7042,4322,2720,5786,3869,1917,1656,409,120,3601
12/1/2015,VA,Virginia,Buckingham,51029,3333,2715,618,2667,12,2655,666,14,652,3114,2496,618,2346,1818,528,723,147,44,1432
12/1/2015,VA,Virginia,Buena Vista City,51530,1425,1157,268,1135,*,*,290,*,*,1332,1064,268,1020,796,224,328,57,18,617
12/1/2015,VA,Virginia,Campbell,51031,12189,10288,1901,9916,71,9845,2273,57,2216,11438,9537,1901,9063,7324,1739,2102,367,182,6412
12/1/2015,VA,Virginia,Caroline,51033,5357,4439,918,4429,29,4400,928,37,891,4868,3950,918,3235,2410,825,788,238,54,2155
12/1/2015,VA,Virginia,Carroll,51035,7783,6718,1065,6150,21,6129,1633,19,1614,7392,6327,1065,5628,4772,856,1681,262,101,3584
12/1/2015,VA,Virginia,Charles City,51036,1762,1371,391,1477,16,1461,285,13,272,1634,1243,391,1195,873,322,273,74,18,830
12/1/2015,VA,Virginia,Charlotte,51037,3291,2797,494,2641,16,2625,650,13,637,3103,2609,494,2405,1964,441,804,132,52,1417
12/1/2015,VA,Virginia,Charlottesville City,51540,5943,5204,739,4772,23,4749,1171,49,1122,5353,4615,738,4176,3471,705,1237,155,57,2727
12/1/2015,VA,Virginia,Chesapeake City,51550,34132,27941,6191,28892,211,28681,5240,236,5004,30833,24642,6191,18182,12410,5772,3992,838,224,13128
12/1/2015,VA,Virginia,Chesterfield,51041,52889,41440,11449,45451,162,45289,7438,231,7207,47626,36179,11447,35125,24657,10468,4980,936,272,28937
12/1/2015,VA,Virginia,Clarke,51043,2949,2649,300,2685,15,2670,264,*,*,2662,2362,300,1733,1480,253,259,75,33,1366
12/1/2015,VA,Virginia,Colonial Heights City,51570,4123,3571,552,3524,*,*,599,12,587,3779,3227,552,2310,1802,508,460,94,25,1731
12/1/2015,VA,Virginia,Covington City,51580,1674,1444,230,1286,*,*,388,*,*,1557,1327,230,1213,996,217,366,51,21,775
12/1/2015,VA,Virginia,Craig,51045,1249,989,260,954,*,*,295,*,*,1153,893,260,893,636,257,205,40,11,637
12/1/2015,VA,Virginia,Culpeper,51047,8428,7375,1053,7198,47,7151,1230,35,1195,7672,6619,1053,5112,4175,937,1136,253,65,3658
12/1/2015,VA,Virginia,Cumberland,51049,2171,1699,472,1777,*,*,394,*,*,2019,1547,472,1540,1109,431,435,75,26,1004
12/1/2015,VA,Virginia,Danville City,51590,11056,9310,1746,8570,69,8501,2486,117,2369,10492,8746,1746,8573,7275,1298,3234,444,159,4736
12/1/2015,VA,Virginia,Dickenson,51051,4707,3088,1619,2793,*,*,1914,12,1902,4486,2867,1619,3593,2148,1445,1121,213,87,2172
12/1/2015,VA,Virginia,Dinwiddie,51053,5512,4419,1093,4371,32,4339,1141,34,1107,5066,3973,1093,3652,2602,1050,917,182,51,2502
12/1/2015,VA,Virginia,Emporia City,51595,1124,850,274,849,11,838,275,14,261,1053,779,274,848,620,228,422,57,12,357
12/1/2015,VA,Virginia,Essex,51057,2724,2269,455,2305,16,2289,419,16,403,2548,2093,455,1854,1494,360,424,93,28,1309
12/1/2015,VA,Virginia,Fairfax,51059,137843,120446,17397,129455,464,128991,8388,416,7972,111482,94112,17370,59778,43714,16064,13113,2532,461,43672
12/1/2015,VA,Virginia,Fairfax City,51600,3624,3135,489,3327,13,3314,297,12,285,3042,2553,489,1678,1221,457,400,50,15,1213
12/1/2015,VA,Virginia,Falls Church City,51610,1763,1539,224,1669,*,*,94,*,*,1392,1168,224,784,578,206,135,*,*,628
12/1/2015,VA,Virginia,Fauquier,51061,11305,10306,999,10180,37,10143,1125,42,1083,9970,8972,998,5958,5098,860,912,192,54,4800
12/1/2015,VA,Virginia,Floyd,51063,3762,3045,717,3211,12,3199,551,*,*,3513,2796,717,2698,2042,656,537,98,49,2014
12/1/2015,VA,Virginia,Fluvanna,51065,5391,4682,709,4820,23,4797,571,23,548,4927,4218,709,3489,2857,632,478,117,20,2874
12/1/2015,VA,Virginia,Franklin,51067,13767,10284,3483,11258,37,11221,2509,22,2487,12940,9457,3483,10284,6964,3320,1980,455,167,7682
12/1/2015,VA,Virginia,Franklin City,51620,1874,1582,292,1448,16,1432,426,20,406,1762,1470,292,1422,1154,268,552,69,16,785
12/1/2015,VA,Virginia,Frederick,51069,14555,12925,1630,12776,41,12735,1779,42,1737,13288,11660,1628,8832,7448,1384,1449,336,124,6923
12/1/2015,VA,Virginia,Fredericksburg City,51630,3771,3348,423,3058,13,3045,713,26,687,3397,2974,423,2237,1838,399,760,80,40,1357
12/1/2015,VA,Virginia,Galax City,51640,1939,1814,125,1471,*,*,468,*,*,1836,1711,125,1434,1334,100,682,59,32,661
12/1/2015,VA,Virginia,Giles,51071,4448,3322,1126,3465,15,3450,983,13,970,4185,3060,1125,3369,2369,1000,786,132,35,2416
12/1/2015,VA,Virginia,Gloucester,51073,7837,6608,1229,6644,28,6616,1193,23,1170,7215,5986,1229,4463,3345,1118,934,179,50,3300
12/1/2015,VA,Virginia,Goochland,51075,5106,4168,938,4605,18,4587,501,19,482,4630,3692,938,3615,2809,806,425,107,34,3049
12/1/2015,VA,Virginia,Grayson,51077,4538,4005,533,3646,*,*,892,*,*,4338,3805,533,3170,2728,442,1020,171,86,1893
12/1/2015,VA,Virginia,Greene,51079,3403,2968,435,2953,*,*,450,*,*,3127,2692,435,2189,1788,401,430,75,24,1660
12/1/2015,VA,Virginia,Greensville,51081,2418,1815,603,1890,19,1871,528,21,507,2258,1655,603,1839,1305,534,587,128,22,1102
12/1/2015,VA,Virginia,Halifax,51083,9359,8172,1187,7507,54,7453,1852,69,1783,8826,7640,1186,7020,5939,1081,2195,444,135,4246
12/1/2015,VA,Virginia,Hampton City,51650,23588,18346,5242,19148,170,18978,4440,204,4236,21564,16322,5242,12707,7665,5042,3573,753,183,8198
12/1/2015,VA,Virginia,Hanover,51085,18819,14935,3884,16862,65,16797,1957,52,1905,17132,13248,3884,13080,9759,3321,1407,345,97,11231
12/1/2015,VA,Virginia,Harrisonburg City,51660,5028,4468,560,4189,17,4172,839,23,816,4570,4010,560,3516,3100,416,945,124,36,2411
12/1/2015,VA,Virginia,Henrico,51087,51489,39817,11672,44415,297,44118,7074,297,6777,46544,34873,11671,35798,25567,10231,5936,1313,393,28156
12/1/2015,VA,Virginia,Henry,51089,14927,10908,4019,11644,66,11578,3283,61,3222,14218,10199,4019,11896,8700,3196,3201,670,228,7797
12/1/2015,VA,Virginia,Highland,51091,707,644,63,651,*,*,56,*,*,669,606,63,484,426,58,68,*,*,393
12/1/2015,VA,Virginia,Hopewell City,51670,4372,3556,816,3332,25,3307,1040,32,1008,4081,3265,816,2728,1935,793,950,152,36,1590
12/1/2015,VA,Virginia,Isle of Wight,51093,7418,5848,1570,6423,34,6389,995,29,966,6890,5320,1570,4795,3311,1484,904,182,78,3631
12/1/2015,VA,Virginia,James City,51095,18440,16313,2127,17261,48,17213,1179,42,1137,17037,14913,2124,10388,8582,1806,882,186,45,9275
12/1/2015,VA,Virginia,King and Queen,51097,1657,1409,248,1378,*,*,279,*,*,1549,1301,248,1145,923,222,276,74,11,784
12/1/2015,VA,Virginia,King George,51099,3460,3133,327,2957,18,2939,503,20,483,3005,2678,327,1474,1168,306,432,84,16,942
12/1/2015,VA,Virginia,King William,51101,3046,2615,431,2583,13,2570,463,25,438,2815,2384,431,2173,1799,374,384,89,22,1678
12/1/2015,VA,Virginia,Lancaster,51103,4183,3638,545,3826,13,3813,357,*,*,4002,3457,545,2750,2362,388,492,82,28,2148
12/1/2015,VA,Virginia,Lee,51105,6303,4162,2141,4162,11,4151,2141,13,2128,5995,3858,2137,4782,2768,2014,1956,245,79,2502
12/1/2015,VA,Virginia,Lexington City,51678,1593,1430,163,1442,13,1429,151,*,*,1491,1328,163,1112,971,141,226,*,*,845
12/1/2015,VA,Virginia,Loudoun,51107,31623,27076,4547,29293,90,29203,2330,113,2217,26204,21662,4542,16144,12026,4118,2737,578,146,12683
12/1/2015,VA,Virginia,Louisa,51109,7171,5995,1176,5929,34,5895,1242,34,1208,6599,5423,1176,4747,3668,1079,1065,242,68,3372
12/1/2015,VA,Virginia,Lunenburg,51111,2942,2535,407,2370,15,2355,572,21,551,2723,2316,407,2007,1629,378,700,129,43,1135
12/1/2015,VA,Virginia,Lynchburg City,51680,14308,12242,2066,11246,79,11167,3062,103,2959,13329,11264,2065,10664,8786,1878,3291,425,150,6798
12/1/2015,VA,Virginia,Madison,51113,2810,2447,363,2462,*,*,348,*,*,2610,2247,363,1861,1530,331,390,82,25,1364
12/1/2015,VA,Virginia,Manassas City,51683,4109,3442,667,3527,27,3500,582,42,540,3478,2812,666,2300,1672,628,528,95,34,1643
12/1/2015,VA,Virginia,Manassas Park City,51685,1139,943,196,967,*,*,172,16,156,955,760,195,637,455,182,171,53,14,399
12/1/2015,VA,Virginia,Martinsville City,51690,3898,3059,839,2905,15,2890,993,37,956,3712,2873,839,3176,2488,688,1294,165,59,1658
12/1/2015,VA,Virginia,Mathews,51115,2743,2375,368,2505,*,*,238,*,*,2607,2239,368,1719,1402,317,258,46,16,1399
12/1/2015,VA,Virginia,Mecklenburg,51117,8946,7503,1443,7278,44,7234,1668,52,1616,8460,7019,1441,6521,5352,1169,1948,369,119,4085
12/1/2015,VA,Virginia,Middlesex,51119,3423,2922,501,3047,19,3028,376,*,*,3229,2728,501,2368,1982,386,424,84,30,1830
12/1/2015,VA,Virginia,Montgomery,51121,12919,10713,2206,10517,36,10481,2402,33,2369,11782,9576,2206,9304,7218,2086,1847,296,127,7034
12/1/2015,VA,Virginia,Nelson,51125,4258,3694,564,3697,15,3682,561,14,547,3942,3378,564,2824,2306,518,616,100,45,2063
12/1/2015,VA,Virginia,New Kent,51127,3852,3219,633,3396,15,3381,456,*,*,3522,2889,633,2380,1871,509,300,74,21,1985
12/1/2015,VA,Virginia,Newport News City,51700,26423,20247,6176,21523,155,21368,4900,247,4653,24265,18092,6173,15315,9363,5952,4524,785,221,9785
12/1/2015,VA,Virginia,Norfolk City,51710,31001,23821,7180,24355,234,24121,6646,351,6295,27955,20775,7180,18115,11196,6919,6924,1229,275,9687
12/1/2015,VA,Virginia,Northampton,51131,3433,2909,524,2885,27,2858,548,29,519,3212,2688,524,2521,2038,483,905,91,37,1488
12/1/2015,VA,Virginia,Northumberland,51133,4534,3977,557,4169,14,4155,365,*,*,4243,3686,557,2684,2322,362,432,94,34,2124
12/1/2015,VA,Virginia,Norton City,51720,1191,883,308,781,*,*,410,*,*,1106,798,308,870,580,290,371,46,20,433
12/1/2015,VA,Virginia,Nottoway,51135,3559,2919,640,2864,27,2837,695,20,675,3304,2664,640,2535,2049,486,920,128,40,1447
12/1/2015,VA,Virginia,Orange,51137,8252,7272,980,7218,38,7180,1034,37,997,7607,6627,980,4782,3964,818,963,221,68,3530
12/1/2015,VA,Virginia,Page,51139,5899,5210,689,4719,16,4703,1180,17,1163,5521,4832,689,3962,3365,597,1162,217,79,2504
12/1/2015,VA,Virginia,Patrick,51141,5014,3820,1194,4078,11,4067,936,15,921,4777,3584,1193,3812,2795,1017,1000,190,85,2537
12/1/2015,VA,Virginia,Petersburg City,51730,7099,5462,1637,5169,85,5084,1930,87,1843,6487,4850,1637,4577,2992,1585,2011,355,75,2136
12/1/2015,VA,Virginia,Pittsylvania,51143,15448,12716,2732,12458,98,12360,2990,80,2910,14631,11899,2732,11773,9365,2408,3101,540,214,7918
12/1/2015,VA,Virginia,Poquoson City,51735,2431,2159,272,2243,*,*,188,0,188,2234,1962,272,1076,828,248,100,30,12,934
12/1/2015,VA,Virginia,Portsmouth City,51740,17573,13354,4219,13371,171,13200,4202,205,3997,15757,11540,4217,10088,6033,4055,3917,657,164,5350
12/1/2015,VA,Virginia,Powhatan,51145,5383,4344,1039,4742,20,4722,641,14,627,4948,3909,1039,3761,2831,930,396,100,35,3230
12/1/2015,VA,Virginia,Prince Edward,51147,4445,3670,775,3507,25,3482,938,33,905,4144,3369,775,3131,2506,625,1066,167,41,1857
12/1/2015,VA,Virginia,Prince George,51149,5411,4734,677,4520,24,4496,891,20,871,4990,4313,677,2837,2214,623,549,108,25,2155
12/1/2015,VA,Virginia,Prince William,51153,42376,35497,6879,37410,215,37195,4966,290,4676,36180,29305,6875,19801,13417,6384,4723,928,196,13954
12/1/2015,VA,Virginia,Pulaski,51155,8858,7281,1577,6867,22,6845,1991,30,1961,8269,6692,1577,6245,4755,1490,1690,320,121,4114
12/1/2015,VA,Virginia,Radford City,51750,1982,1620,362,1579,*,*,403,*,*,1818,1456,362,1474,1131,343,330,39,25,1080
12/1/2015,VA,Virginia,Rappahannock,51157,1930,1778,152,1763,*,*,167,*,*,1745,1593,152,1105,977,128,158,39,11,897
12/1/2015,VA,Virginia,Richmond,51159,1849,1513,336,1586,13,1573,263,11,252,1741,1405,336,1237,997,240,294,91,22,830
12/1/2015,VA,Virginia,Richmond City,51760,32072,22589,9483,24601,235,24366,7471,358,7113,28875,19392,9483,23348,14253,9095,8529,1383,318,13118
12/1/2015,VA,Virginia,Roanoke,51161,22113,17956,4157,19363,76,19287,2750,47,2703,20489,16332,4157,15728,11939,3789,1938,423,157,13210
12/1/2015,VA,Virginia,Roanoke City,51770,19851,14683,5168,14565,104,14461,5286,144,5142,18229,13063,5166,14404,9458,4946,4837,803,216,8548
12/1/2015,VA,Virginia,Rockbridge,51163,5648,4765,883,4730,16,4714,918,11,907,5267,4384,883,3836,3098,738,838,170,60,2768
12/1/2015,VA,Virginia,Rockingham,51165,16174,13749,2425,14019,41,13978,2155,51,2104,14943,12519,2424,11267,9514,1753,1801,499,152,8815
12/1/2015,VA,Virginia,Russell,51167,7670,5304,2366,5022,11,5011,2648,*,*,7342,4976,2366,6159,4205,1954,1751,306,131,3971
12/1/2015,VA,Virginia,Salem City,51775,5821,4802,1019,4851,26,4825,970,18,952,5335,4316,1019,4116,3174,942,813,142,41,3120
12/1/2015,VA,Virginia,Scott,51169,6473,3365,3108,4757,13,4744,1716,11,1705,6203,3095,3108,5310,2258,3052,1559,245,107,3399
12/1/2015,VA,Virginia,Shenandoah,51171,9870,8774,1096,8608,15,8593,1262,26,1236,9245,8149,1096,6231,5325,906,1270,244,102,4615
12/1/2015,VA,Virginia,Smyth,51173,8661,6824,1837,6305,16,6289,2356,27,2329,8176,6339,1837,6525,4872,1653,2172,391,150,3812
12/1/2015,VA,Virginia,Southampton,51175,3959,3333,626,3252,22,3230,707,28,679,3700,3074,626,2824,2267,557,748,135,35,1906
12/1/2015,VA,Virginia,Spotsylvania,51177,18475,16324,2151,15833,101,15732,2642,92,2550,16470,14320,2150,9618,7749,1869,1863,464,117,7174
12/1/2015,VA,Virginia,Stafford,51179,14992,13682,1310,13040,69,12971,1952,94,1858,13172,11863,1309,6389,5256,1133,1267,342,83,4697
12/1/2015,VA,Virginia,Staunton City,51790,5813,5035,778,4681,18,4663,1132,30,1102,5457,4679,778,4183,3511,672,1085,152,49,2897
12/1/2015,VA,Virginia,Suffolk City,51800,14530,11861,2669,11691,72,11619,2839,94,2745,13302,10634,2668,8835,6392,2443,2627,397,110,5701
12/1/2015,VA,Virginia,Surry,51181,1478,1138,340,1227,11,1216,251,13,238,1364,1024,340,979,659,320,219,68,14,678
12/1/2015,VA,Virginia,Sussex,51183,2309,1832,477,1848,30,1818,461,*,*,2149,1672,477,1623,1173,450,488,141,23,971
12/1/2015,VA,Virginia,Tazewell,51185,11611,8526,3085,8340,35,8305,3271,37,3234,10982,7899,3083,8568,6575,1993,2245,430,178,5715
12/1/2015,VA,Virginia,Unknown,51999,*,*,*,*,*,*,*,*,*,*,*,*,*,*,*,*,*,*,*
12/1/2015,VA,Virginia,Virginia Beach City,51810,64800,54633,10167,56636,284,56352,8164,326,7838,59281,49121,10160,32205,22727,9478,6485,1267,360,24093
12/1/2015,VA,Virginia,Warren,51187,6922,6275,647,5833,19,5814,1089,28,1061,6314,5667,647,4096,3551,545,881,226,68,2921
12/1/2015,VA,Virginia,Washington,51191,14508,10027,4481,11301,49,11252,3207,24,3183,13672,9192,4480,10789,6656,4133,2547,513,177,7552
12/1/2015,VA,Virginia,Waynesboro City,51820,4690,3998,692,3809,17,3792,881,22,859,4402,3710,692,3425,2816,609,882,101,48,2394
12/1/2015,VA,Virginia,Westmoreland,51193,4633,4052,581,4022,24,3998,611,*,*,4244,3663,581,2566,2071,495,742,123,43,1658
12/1/2015,VA,Virginia,Williamsburg City,51830,2407,2075,332,2198,*,*,209,*,*,2188,1857,331,1473,1187,286,210,*,*,1235
12/1/2015,VA,Virginia,Winchester City,51840,4949,4446,503,4195,15,4180,754,18,736,4505,4002,503,3151,2714,437,810,125,42,2174
12/1/2015,VA,Virginia,Wise,51195,10358,6973,3385,6653,14,6639,3705,19,3686,9783,6399,3384,7585,4388,3197,2448,472,161,4504
12/1/2015,VA,Virginia,Wythe,51197,7315,5721,1594,5579,24,5555,1736,24,1712,6914,5320,1594,5272,3874,1398,1504,278,98,3392
12/1/2015,VA,Virginia,York,51199,10920,9617,1303,9968,43,9925,952,33,919,9999,8696,1303,5133,3924,1209,647,159,42,4285
2/1/2015,VA,Virginia,Accomack,51001,8259,7103,1156,7025,47,6978,1234,44,1190,7734,6578,1156,5572,4579,993,1502,375,87,3608
2/1/2015,VA,Virginia,Albemarle,51003,17854,15914,1940,16307,67,16240,1547,57,1490,16064,14124,1940,11820,10082,1738,1441,286,86,10007
2/1/2015,VA,Virginia,Alexandria City,51510,15769,14077,1692,14382,82,14300,1387,93,1294,12764,11075,1689,7191,5623,1568,1916,332,74,4869
2/1/2015,VA,Virginia,Alleghany,51005,4436,3780,656,3562,22,3540,874,13,861,4202,3546,656,3312,2788,524,830,109,50,2323
2/1/2015,VA,Virginia,Amelia,51007,2855,2203,652,2372,11,2361,483,13,470,2645,1993,652,2012,1412,600,472,86,32,1422
2/1/2015,VA,Virginia,Amherst,51009,7284,6160,1124,5975,47,5928,1309,38,1271,6766,5642,1124,5368,4331,1037,1144,237,76,3911
2/1/2015,VA,Virginia,Appomattox,51011,3659,3110,549,2953,23,2930,706,19,687,3445,2896,549,2736,2237,499,674,104,54,1904
2/1/2015,VA,Virginia,Arlington,51013,21761,19452,2309,20148,85,20063,1613,83,1530,17404,15095,2309,9770,7637,2133,2796,334,128,6512
2/1/2015,VA,Virginia,Augusta,51015,16557,14177,2380,14163,57,14106,2394,36,2358,15522,13142,2380,11600,9611,1989,1793,389,151,9267
2/1/2015,VA,Virginia,Bath,51017,1262,1140,122,1106,*,*,156,*,*,1182,1060,122,918,811,107,200,33,20,665
2/1/2015,VA,Virginia,Bedford,51019,17942,14673,3269,15169,75,15094,2773,49,2724,16766,13500,3266,12761,10074,2687,1938,472,160,10191
2/1/2015,VA,Virginia,Bland,51021,1699,1346,353,1328,*,*,371,*,*,1603,1250,353,1188,923,265,238,57,18,875
2/1/2015,VA,Virginia,Botetourt,51023,7871,6127,1744,6760,38,6722,1111,15,1096,7278,5534,1744,5596,4007,1589,824,168,59,4545
2/1/2015,VA,Virginia,Bristol City,51520,4365,2666,1699,3390,*,*,975,11,964,4103,2404,1699,3388,1738,1650,971,166,56,2195
2/1/2015,VA,Virginia,Brunswick,51025,3803,3099,704,3078,31,3047,725,29,696,3581,2877,704,2800,2164,636,1074,114,45,1567
2/1/2015,VA,Virginia,Buchanan,51027,7323,4629,2694,4468,17,4451,2855,13,2842,7026,4333,2693,5725,3852,1873,1590,433,115,3587
2/1/2015,VA,Virginia,Buckingham,51029,3270,2633,637,2632,14,2618,638,14,624,3035,2398,637,2301,1756,545,690,151,47,1413
2/1/2015,VA,Virginia,Buena Vista City,51530,1415,1147,268,1134,*,*,281,*,*,1321,1053,268,1020,796,224,323,58,18,621
2/1/2015,VA,Virginia,Campbell,51031,11989,10111,1878,9810,76,9734,2179,65,2114,11249,9371,1878,8912,7202,1710,2010,378,188,6336
2/1/2015,VA,Virginia,Caroline,51033,5233,4305,928,4358,38,4320,875,36,839,4754,3826,928,3145,2315,830,730,240,53,2122
2/1/2015,VA,Virginia,Carroll,51035,7697,6623,1074,6120,24,6096,1577,21,1556,7312,6238,1074,5613,4758,855,1630,277,118,3588
2/1/2015,VA,Virginia,Charles City,51036,1711,1322,389,1437,18,1419,274,12,262,1590,1201,389,1192,869,323,254,83,17,838
2/1/2015,VA,Virginia,Charlotte,51037,3237,2743,494,2619,19,2600,618,12,606,3052,2558,494,2367,1925,442,764,128,56,1419
2/1/2015,VA,Virginia,Charlottesville City,51540,5802,5083,719,4673,24,4649,1129,45,1084,5212,4494,718,4111,3426,685,1175,162,52,2722
2/1/2015,VA,Virginia,Chesapeake City,51550,33202,27106,6096,28229,246,27983,4973,235,4738,29908,23812,6096,17680,12029,5651,3747,845,238,12850
2/1/2015,VA,Virginia,Chesterfield,51041,51073,39840,11233,44057,188,43869,7016,220,6796,45923,34692,11231,33923,23661,10262,4637,971,268,28047
2/1/2015,VA,Virginia,Clarke,51043,2841,2533,308,2590,15,2575,251,*,*,2572,2264,308,1681,1427,254,251,75,30,1325
2/1/2015,VA,Virginia,Colonial Heights City,51570,4111,3560,551,3545,*,*,566,15,551,3773,3222,551,2300,1796,504,440,101,24,1735
2/1/2015,VA,Virginia,Covington City,51580,1664,1425,239,1295,*,*,369,*,*,1546,1307,239,1205,980,225,345,56,19,785
2/1/2015,VA,Virginia,Craig,51045,1247,988,259,959,*,*,288,*,*,1143,884,259,887,631,256,192,40,15,640
2/1/2015,VA,Virginia,Culpeper,51047,8210,7122,1088,7028,54,6974,1182,37,1145,7482,6394,1088,4985,4011,974,1068,256,69,3592
2/1/2015,VA,Virginia,Cumberland,51049,2138,1661,477,1755,12,1743,383,*,*,1988,1513,475,1513,1079,434,412,78,29,994
2/1/2015,VA,Virginia,Danville City,51590,11001,9232,1769,8606,83,8523,2395,117,2278,10437,8668,1769,8561,7271,1290,3125,452,177,4807
2/1/2015,VA,Virginia,Dickenson,51051,4682,3124,1558,2819,*,*,1863,13,1850,4457,2899,1558,3562,2189,1373,1074,226,91,2171
2/1/2015,VA,Virginia,Dinwiddie,51053,5384,4305,1079,4291,35,4256,1093,33,1060,4930,3851,1079,3552,2518,1034,873,182,53,2444
2/1/2015,VA,Virginia,Emporia City,51595,1154,852,302,886,14,872,268,15,253,1086,784,302,876,626,250,419,65,12,380
2/1/2015,VA,Virginia,Essex,51057,2682,2208,474,2287,17,2270,395,15,380,2507,2033,474,1856,1470,386,421,92,25,1318
2/1/2015,VA,Virginia,Fairfax,51059,131907,115420,16487,124014,554,123460,7893,401,7492,106861,90403,16458,57251,42116,15135,12342,2532,460,41917
2/1/2015,VA,Virginia,Fairfax City,51600,3516,3052,464,3230,14,3216,286,11,275,2971,2507,464,1637,1208,429,387,53,17,1180
2/1/2015,VA,Virginia,Falls Church City,51610,1684,1470,214,1597,*,*,87,*,*,1338,1125,213,753,560,193,131,*,*,600
2/1/2015,VA,Virginia,Fauquier,51061,10926,9927,999,9865,46,9819,1061,37,1024,9680,8682,998,5792,4942,850,845,193,56,4698
2/1/2015,VA,Virginia,Floyd,51063,3696,2974,722,3160,13,3147,536,*,*,3455,2733,722,2660,1998,662,521,94,50,1995
2/1/2015,VA,Virginia,Fluvanna,51065,5278,4560,718,4729,28,4701,549,22,527,4830,4112,718,3415,2778,637,452,122,21,2820
2/1/2015,VA,Virginia,Franklin,51067,13500,10018,3482,11089,42,11047,2411,22,2389,12687,9205,3482,10101,6779,3322,1902,464,159,7576
2/1/2015,VA,Virginia,Franklin City,51620,1847,1561,286,1433,18,1415,414,16,398,1740,1454,286,1400,1140,260,515,82,18,785
2/1/2015,VA,Virginia,Frederick,51069,14230,12592,1638,12541,48,12493,1689,47,1642,12992,11356,1636,8639,7249,1390,1355,356,126,6802
2/1/2015,VA,Virginia,Fredericksburg City,51630,3686,3255,431,3009,15,2994,677,29,648,3314,2883,431,2175,1771,404,707,85,43,1340
2/1/2015,VA,Virginia,Galax City,51640,1946,1819,127,1491,*,*,455,*,*,1848,1721,127,1448,1347,101,673,69,33,673
2/1/2015,VA,Virginia,Giles,51071,4390,3249,1141,3449,20,3429,941,13,928,4126,2986,1140,3350,2330,1020,755,141,38,2416
2/1/2015,VA,Virginia,Gloucester,51073,7637,6429,1208,6523,31,6492,1114,19,1095,7010,5802,1208,4357,3261,1096,889,187,55,3226
2/1/2015,VA,Virginia,Goochland,51075,4937,4005,932,4454,22,4432,483,17,466,4488,3556,932,3506,2704,802,400,103,37,2966
2/1/2015,VA,Virginia,Grayson,51077,4465,3939,526,3617,13,3604,848,*,*,4284,3758,526,3155,2721,434,995,180,82,1898
2/1/2015,VA,Virginia,Greene,51079,3295,2858,437,2865,15,2850,430,12,418,3014,2577,437,2122,1719,403,399,76,22,1625
2/1/2015,VA,Virginia,Greensville,51081,2377,1759,618,1871,24,1847,506,21,485,2211,1593,618,1816,1266,550,554,126,27,1109
2/1/2015,VA,Virginia,Halifax,51083,9233,8034,1199,7449,62,7387,1784,69,1715,8681,7483,1198,6947,5858,1089,2144,446,132,4225
2/1/2015,VA,Virginia,Hampton City,51650,23103,17934,5169,18864,209,18655,4239,206,4033,21142,15973,5169,12547,7590,4957,3366,775,193,8213
2/1/2015,VA,Virginia,Hanover,51085,18321,14486,3835,16483,74,16409,1838,51,1787,16686,12851,3835,12755,9473,3282,1334,362,99,10960
2/1/2015,VA,Virginia,Harrisonburg City,51660,4956,4376,580,4154,20,4134,802,23,779,4525,3945,580,3473,3038,435,912,116,39,2406
2/1/2015,VA,Virginia,Henrico,51087,50328,38720,11608,43574,350,43224,6754,291,6463,45619,34012,11607,35110,24984,10126,5649,1350,401,27710
2/1/2015,VA,Virginia,Henry,51089,14824,10770,4054,11636,76,11560,3188,64,3124,14139,10085,4054,11875,8689,3186,3054,684,247,7890
2/1/2015,VA,Virginia,Highland,51091,708,641,67,652,*,*,56,*,*,669,602,67,486,424,62,66,*,*,397
2/1/2015,VA,Virginia,Hopewell City,51670,4347,3526,821,3347,30,3317,1000,32,968,4048,3227,821,2701,1903,798,928,152,40,1581
2/1/2015,VA,Virginia,Isle of Wight,51093,7227,5642,1585,6280,38,6242,947,28,919,6713,5128,1585,4700,3202,1498,881,188,78,3553
2/1/2015,VA,Virginia,James City,51095,17982,15852,2130,16872,55,16817,1110,38,1072,16625,14499,2126,10102,8295,1807,828,195,45,9034
2/1/2015,VA,Virginia,King and Queen,51097,1597,1348,249,1335,*,*,262,*,*,1492,1243,249,1114,889,225,266,*,*,763
2/1/2015,VA,Virginia,King George,51099,3356,3018,338,2881,19,2862,475,20,455,2919,2581,338,1441,1125,316,420,84,21,916
2/1/2015,VA,Virginia,King William,51101,2951,2535,416,2522,17,2505,429,24,405,2719,2303,416,2108,1746,362,363,87,22,1636
2/1/2015,VA,Virginia,Lancaster,51103,4142,3579,563,3803,18,3785,339,11,328,3963,3400,563,2741,2336,405,483,85,31,2142
2/1/2015,VA,Virginia,Lee,51105,6276,4177,2099,4198,15,4183,2078,14,2064,5963,3867,2096,4767,2804,1963,1908,254,78,2527
2/1/2015,VA,Virginia,Lexington City,51678,1592,1425,167,1447,16,1431,145,*,*,1493,1326,167,1116,971,145,219,*,*,856
2/1/2015,VA,Virginia,Loudoun,51107,30221,26261,3960,28065,103,27962,2156,103,2053,25125,21170,3955,15411,11891,3520,2505,584,137,12185
2/1/2015,VA,Virginia,Louisa,51109,6994,5789,1205,5823,38,5785,1171,35,1136,6431,5226,1205,4622,3521,1101,1010,255,69,3288
2/1/2015,VA,Virginia,Lunenburg,51111,2895,2470,425,2352,18,2334,543,21,522,2666,2241,425,1973,1575,398,658,120,41,1154
2/1/2015,VA,Virginia,Lynchburg City,51680,14188,12130,2058,11235,94,11141,2953,107,2846,13231,11174,2057,10567,8708,1859,3189,451,154,6773
2/1/2015,VA,Virginia,Madison,51113,2751,2370,381,2415,12,2403,336,*,*,2569,2188,381,1822,1472,350,371,88,26,1337
2/1/2015,VA,Virginia,Manassas City,51683,3963,3329,634,3417,30,3387,546,31,515,3349,2716,633,2222,1630,592,485,102,31,1604
2/1/2015,VA,Virginia,Manassas Park City,51685,1075,891,184,919,11,908,156,12,144,901,717,184,605,435,170,144,47,11,403
2/1/2015,VA,Virginia,Martinsville City,51690,3909,3060,849,2948,22,2926,961,40,921,3730,2881,849,3206,2521,685,1273,175,60,1698
2/1/2015,VA,Virginia,Mathews,51115,2708,2328,380,2480,*,*,228,*,*,2560,2180,380,1693,1363,330,257,44,19,1373
2/1/2015,VA,Virginia,Mecklenburg,51117,8859,7396,1463,7241,52,7189,1618,51,1567,8366,6905,1461,6466,5286,1180,1887,368,122,4089
2/1/2015,VA,Virginia,Middlesex,51119,3361,2845,516,3000,21,2979,361,*,*,3158,2642,516,2331,1929,402,402,91,27,1811
2/1/2015,VA,Virginia,Montgomery,51121,12731,10498,2233,10420,44,10376,2311,35,2276,11583,9350,2233,9163,7059,2104,1766,298,120,6979
2/1/2015,VA,Virginia,Nelson,51125,4144,3577,567,3612,18,3594,532,15,517,3820,3253,567,2749,2227,522,592,106,38,2013
2/1/2015,VA,Virginia,New Kent,51127,3720,3077,643,3283,17,3266,437,11,426,3396,2753,643,2300,1783,517,279,74,21,1926
2/1/2015,VA,Virginia,Newport News City,51700,25934,19790,6144,21272,182,21090,4662,237,4425,23789,17648,6141,15121,9217,5904,4266,793,221,9841
2/1/2015,VA,Virginia,Norfolk City,51710,30324,23292,7032,24011,264,23747,6313,353,5960,27352,20320,7032,17774,11014,6760,6540,1283,289,9662
2/1/2015,VA,Virginia,Northampton,51131,3348,2814,534,2834,30,2804,514,32,482,3138,2604,534,2478,1988,490,884,97,42,1455
2/1/2015,VA,Virginia,Northumberland,51133,4489,3915,574,4144,15,4129,345,*,*,4208,3634,574,2661,2288,373,416,92,35,2118
2/1/2015,VA,Virginia,Norton City,51720,1164,858,306,766,*,*,398,*,*,1077,772,305,843,557,286,352,49,20,422
2/1/2015,VA,Virginia,Nottoway,51135,3504,2845,659,2844,28,2816,660,18,642,3256,2597,659,2511,2011,500,904,126,46,1435
2/1/2015,VA,Virginia,Orange,51137,8096,7079,1017,7104,45,7059,992,36,956,7462,6446,1016,4693,3837,856,903,240,70,3480
2/1/2015,VA,Virginia,Page,51139,5802,5098,704,4692,19,4673,1110,16,1094,5447,4743,704,3922,3306,616,1109,219,90,2504
2/1/2015,VA,Virginia,Patrick,51141,5011,3792,1219,4100,14,4086,911,15,896,4791,3573,1218,3826,2792,1034,970,194,82,2580
2/1/2015,VA,Virginia,Petersburg City,51730,6974,5334,1640,5111,100,5011,1863,90,1773,6380,4740,1640,4506,2917,1589,1923,365,88,2130
2/1/2015,VA,Virginia,Pittsylvania,51143,15168,12421,2747,12306,115,12191,2862,83,2779,14382,11635,2747,11671,9257,2414,3017,582,216,7856
2/1/2015,VA,Virginia,Poquoson City,51735,2393,2119,274,2208,*,*,185,0,185,2181,1907,274,1052,802,250,104,27,11,910
2/1/2015,VA,Virginia,Portsmouth City,51740,17260,13138,4122,13255,198,13057,4005,212,3793,15434,11312,4122,9671,5724,3947,3695,689,159,5128
2/1/2015,VA,Virginia,Powhatan,51145,5206,4167,1039,4603,26,4577,603,16,587,4768,3729,1039,3638,2705,933,373,105,34,3126
2/1/2015,VA,Virginia,Prince Edward,51147,4371,3580,791,3477,27,3450,894,31,863,4082,3292,790,3097,2452,645,1017,172,45,1863
2/1/2015,VA,Virginia,Prince George,51149,5241,4545,696,4395,31,4364,846,23,823,4856,4160,696,2772,2132,640,514,110,25,2123
2/1/2015,VA,Virginia,Prince William,51153,40383,33758,6625,35722,245,35477,4661,286,4375,34439,27819,6620,18971,12842,6129,4309,938,187,13537
2/1/2015,VA,Virginia,Pulaski,51155,8744,7143,1601,6815,30,6785,1929,31,1898,8184,6583,1601,6259,4743,1516,1639,332,125,4163
2/1/2015,VA,Virginia,Radford City,51750,1955,1589,366,1569,*,*,386,*,*,1795,1429,366,1467,1120,347,314,46,29,1078
2/1/2015,VA,Virginia,Rappahannock,51157,1869,1722,147,1711,*,*,158,*,*,1691,1544,147,1068,947,121,153,42,12,861
2/1/2015,VA,Virginia,Richmond,51159,1836,1474,362,1589,14,1575,247,11,236,1728,1366,362,1239,976,263,293,91,21,834
2/1/2015,VA,Virginia,Richmond City,51760,31400,21959,9441,24197,288,23909,7203,356,6847,28267,18826,9441,22903,13851,9052,8038,1437,330,13098
2/1/2015,VA,Virginia,Roanoke,51161,21721,17537,4184,19086,101,18985,2635,52,2583,20152,15968,4184,15480,11659,3821,1884,426,150,13020
2/1/2015,VA,Virginia,Roanoke City,51770,19497,14361,5136,14408,124,14284,5089,153,4936,17931,12796,5135,14249,9342,4907,4613,803,233,8600
2/1/2015,VA,Virginia,Rockbridge,51163,5589,4702,887,4706,20,4686,883,*,*,5214,4327,887,3826,3086,740,799,181,64,2782
2/1/2015,VA,Virginia,Rockingham,51165,15848,13325,2523,13812,51,13761,2036,46,1990,14676,12154,2522,11063,9230,1833,1710,498,146,8709
2/1/2015,VA,Virginia,Russell,51167,7646,5319,2327,5068,12,5056,2578,*,*,7297,4970,2327,6107,4195,1912,1698,310,129,3970
2/1/2015,VA,Virginia,Salem City,51775,5796,4725,1071,4867,30,4837,929,20,909,5316,4245,1071,4118,3129,989,814,140,44,3120
2/1/2015,VA,Virginia,Scott,51169,6457,3342,3115,4802,17,4785,1655,12,1643,6185,3070,3115,5310,2253,3057,1526,246,112,3426
2/1/2015,VA,Virginia,Shenandoah,51171,9760,8649,1111,8554,20,8534,1206,28,1178,9153,8042,1111,6172,5254,918,1216,252,102,4602
2/1/2015,VA,Virginia,Smyth,51173,8644,6836,1808,6345,18,6327,2299,30,2269,8167,6359,1808,6516,4892,1624,2107,405,162,3842
2/1/2015,VA,Virginia,Southampton,51175,3848,3225,623,3187,28,3159,661,25,636,3591,2968,623,2759,2204,555,698,147,33,1881
2/1/2015,VA,Virginia,Spotsylvania,51177,17852,15665,2187,15361,118,15243,2491,93,2398,15915,13730,2185,9325,7419,1906,1741,492,123,6969
2/1/2015,VA,Virginia,Stafford,51179,14455,13065,1390,12594,78,12516,1861,94,1767,12677,11288,1389,6267,5056,1211,1176,343,82,4666
2/1/2015,VA,Virginia,Staunton City,51790,5798,5130,668,4706,25,4681,1092,28,1064,5451,4783,668,4197,3642,555,1033,163,57,2944
2/1/2015,VA,Virginia,Suffolk City,51800,14239,11558,2681,11518,89,11429,2721,86,2635,12985,10306,2679,8675,6222,2453,2558,402,113,5602
2/1/2015,VA,Virginia,Surry,51181,1451,1098,353,1212,14,1198,239,13,226,1343,990,353,962,631,331,215,70,13,664
2/1/2015,VA,Virginia,Sussex,51183,2301,1817,484,1851,36,1815,450,*,*,2138,1654,484,1618,1160,458,472,143,22,981
2/1/2015,VA,Virginia,Tazewell,51185,11505,8428,3077,8357,42,8315,3148,36,3112,10886,7811,3075,8457,6490,1967,2154,449,169,5685
2/1/2015,VA,Virginia,Unknown,51999,*,*,*,*,*,*,*,*,*,*,*,*,*,*,*,*,*,*,*
2/1/2015,VA,Virginia,Virginia Beach City,51810,62909,52992,9917,55171,324,54847,7738,326,7412,57528,47616,9912,31377,22168,9209,6137,1307,340,23593
2/1/2015,VA,Virginia,Warren,51187,6701,6053,648,5678,22,5656,1023,25,998,6115,5467,648,3988,3437,551,822,231,64,2871
2/1/2015,VA,Virginia,Washington,51191,14407,9936,4471,11307,58,11249,3100,21,3079,13581,9111,4470,10757,6640,4117,2463,530,185,7579
2/1/2015,VA,Virginia,Waynesboro City,51820,4665,3974,691,3802,20,3782,863,25,838,4381,3690,691,3424,2819,605,859,104,48,2413
2/1/2015,VA,Virginia,Westmoreland,51193,4586,3988,598,3995,29,3966,591,12,579,4202,3604,598,2584,2076,508,718,129,43,1694
2/1/2015,VA,Virginia,Williamsburg City,51830,2373,2035,338,2178,12,2166,195,*,*,2151,1814,337,1457,1162,295,199,*,*,1222
2/1/2015,VA,Virginia,Winchester City,51840,4832,4324,508,4125,19,4106,707,20,687,4409,3901,508,3079,2639,440,780,125,42,2132
2/1/2015,VA,Virginia,Wise,51195,10259,6925,3334,6684,15,6669,3575,19,3556,9659,6326,3333,7513,4390,3123,2345,497,161,4510
2/1/2015,VA,Virginia,Wythe,51197,7263,5848,1415,5599,30,5569,1664,25,1639,6878,5463,1415,5268,4054,1214,1456,287,106,3419
2/1/2015,VA,Virginia,York,51199,10627,9328,1299,9734,49,9685,893,30,863,9730,8433,1297,5039,3837,1202,621,161,46,4211
1/1/2015,VA,Virginia,Accomack,51001,8250,7089,1161,7015,48,6967,1235,45,1190,7726,6565,1161,5555,4556,999,1493,368,89,3605
1/1/2015,VA,Virginia,Albemarle,51003,17839,15883,1956,16304,71,16233,1535,56,1479,16056,14100,1956,11794,10041,1753,1440,286,87,9981
1/1/2015,VA,Virginia,Alexandria City,51510,15741,14044,1697,14365,87,14278,1376,93,1283,12753,11059,1694,7156,5586,1570,1899,337,75,4845
1/1/2015,VA,Virginia,Alleghany,51005,4445,3776,669,3578,23,3555,867,13,854,4213,3544,669,3316,2783,533,822,110,50,2334
1/1/2015,VA,Virginia,Amelia,51007,2845,2189,656,2370,11,2359,475,13,462,2640,1984,656,2006,1402,604,469,88,33,1416
1/1/2015,VA,Virginia,Amherst,51009,7280,6147,1133,5979,47,5932,1301,38,1263,6771,5638,1133,5367,4321,1046,1137,239,76,3915
1/1/2015,VA,Virginia,Appomattox,51011,3661,3108,553,2956,25,2931,705,19,686,3450,2897,553,2731,2230,501,672,106,55,1898
1/1/2015,VA,Virginia,Arlington,51013,21718,19402,2316,20115,85,20030,1603,83,1520,17381,15065,2316,9755,7619,2136,2796,337,130,6492
1/1/2015,VA,Virginia,Augusta,51015,16551,14146,2405,14165,58,14107,2386,36,2350,15532,13127,2405,11600,9590,2010,1784,392,151,9273
1/1/2015,VA,Virginia,Bath,51017,1267,1145,122,1109,*,*,158,*,*,1186,1064,122,922,815,107,202,32,21,667
1/1/2015,VA,Virginia,Bedford,51019,17900,14600,3300,15143,76,15067,2757,51,2706,16736,13439,3297,12735,10025,2710,1928,480,160,10167
1/1/2015,VA,Virginia,Bland,51021,1702,1346,356,1330,*,*,372,*,*,1607,1251,356,1192,924,268,240,57,18,877
1/1/2015,VA,Virginia,Botetourt,51023,7862,6111,1751,6758,38,6720,1104,15,1089,7277,5526,1751,5595,4000,1595,824,166,61,4544
1/1/2015,VA,Virginia,Bristol City,51520,4370,2666,1704,3396,11,3385,974,11,963,4113,2409,1704,3392,1737,1655,966,164,57,2205
1/1/2015,VA,Virginia,Brunswick,51025,3799,3094,705,3076,31,3045,723,29,694,3577,2872,705,2792,2156,636,1073,112,45,1562
1/1/2015,VA,Virginia,Buchanan,51027,7332,4632,2700,4488,18,4470,2844,13,2831,7036,4337,2699,5731,3854,1877,1586,436,113,3596
1/1/2015,VA,Virginia,Buckingham,51029,3262,2617,645,2627,14,2613,635,14,621,3026,2381,645,2291,1741,550,682,149,48,1412
1/1/2015,VA,Virginia,Buena Vista City,51530,1414,1145,269,1134,*,*,280,*,*,1321,1052,269,1019,793,226,322,59,18,620
1/1/2015,VA,Virginia,Campbell,51031,11986,10102,1884,9816,80,9736,2170,65,2105,11256,9372,1884,8901,7188,1713,2004,377,187,6333
1/1/2015,VA,Virginia,Caroline,51033,5224,4291,933,4352,40,4312,872,36,836,4746,3813,933,3134,2298,836,729,240,54,2111
1/1/2015,VA,Virginia,Carroll,51035,7701,6620,1081,6128,24,6104,1573,21,1552,7315,6234,1081,5622,4762,860,1634,277,119,3592
1/1/2015,VA,Virginia,Charles City,51036,1712,1319,393,1439,19,1420,273,12,261,1593,1200,393,1196,870,326,253,83,17,843
1/1/2015,VA,Virginia,Charlotte,51037,3235,2745,490,2617,19,2598,618,12,606,3052,2562,490,2367,1929,438,768,128,55,1416
1/1/2015,VA,Virginia,Charlottesville City,51540,5796,5053,743,4670,25,4645,1126,45,1081,5209,4467,742,4096,3388,708,1168,160,52,2716
1/1/2015,VA,Virginia,Chesapeake City,51550,33131,27056,6075,28195,250,27945,4936,232,4704,29864,23789,6075,17601,11966,5635,3724,854,238,12785
1/1/2015,VA,Virginia,Chesterfield,51041,50993,39753,11240,43998,192,43806,6995,221,6774,45862,34624,11238,33816,23553,10263,4613,959,270,27974
1/1/2015,VA,Virginia,Clarke,51043,2834,2524,310,2585,17,2568,249,*,*,2572,2262,310,1682,1426,256,251,75,30,1326
1/1/2015,VA,Virginia,Colonial Heights City,51570,4109,3554,555,3551,*,*,558,15,543,3775,3220,555,2288,1782,506,439,102,23,1724
1/1/2015,VA,Virginia,Covington City,51580,1667,1425,242,1300,*,*,367,*,*,1550,1308,242,1208,980,228,341,57,19,791
1/1/2015,VA,Virginia,Craig,51045,1243,984,259,956,*,*,287,*,*,1140,881,259,884,629,255,189,40,15,640
1/1/2015,VA,Virginia,Culpeper,51047,8202,7107,1095,7025,55,6970,1177,38,1139,7472,6377,1095,4973,3994,979,1074,253,70,3576
1/1/2015,VA,Virginia,Cumberland,51049,2141,1660,481,1759,13,1746,382,*,*,1991,1512,479,1512,1073,439,409,77,30,996
1/1/2015,VA,Virginia,Danville City,51590,11033,9241,1792,8639,84,8555,2394,115,2279,10463,8671,1792,8576,7279,1297,3124,449,180,4823
1/1/2015,VA,Virginia,Dickenson,51051,4683,3142,1541,2828,*,*,1855,13,1842,4458,2917,1541,3564,2211,1353,1071,225,94,2174
1/1/2015,VA,Virginia,Dinwiddie,51053,5373,4285,1088,4284,38,4246,1089,33,1056,4928,3840,1088,3541,2500,1041,873,179,52,2437
1/1/2015,VA,Virginia,Emporia City,51595,1150,846,304,886,14,872,264,15,249,1081,777,304,872,617,255,417,65,12,378
1/1/2015,VA,Virginia,Essex,51057,2682,2206,476,2289,17,2272,393,15,378,2511,2035,476,1863,1476,387,419,93,26,1325
1/1/2015,VA,Virginia,Fairfax,51059,131545,115127,16418,123682,562,123120,7863,398,7465,106707,90319,16388,57042,41986,15056,12298,2528,458,41758
1/1/2015,VA,Virginia,Fairfax City,51600,3515,3054,461,3229,15,3214,286,11,275,2970,2509,461,1628,1203,425,384,55,17,1172
1/1/2015,VA,Virginia,Falls Church City,51610,1683,1470,213,1596,*,*,87,*,*,1337,1125,212,750,558,192,131,*,*,597
1/1/2015,VA,Virginia,Fauquier,51061,10905,9910,995,9849,46,9803,1056,36,1020,9663,8669,994,5762,4915,847,842,188,54,4678
1/1/2015,VA,Virginia,Floyd,51063,3695,2973,722,3161,13,3148,534,*,*,3450,2728,722,2651,1989,662,516,95,48,1992
1/1/2015,VA,Virginia,Fluvanna,51065,5274,4556,718,4730,28,4702,544,23,521,4830,4112,718,3409,2773,636,449,123,22,2815
1/1/2015,VA,Virginia,Franklin,51067,13498,10006,3492,11091,42,11049,2407,22,2385,12690,9198,3492,10091,6761,3330,1895,460,156,7580
1/1/2015,VA,Virginia,Franklin City,51620,1854,1561,293,1437,18,1419,417,17,400,1746,1453,293,1401,1134,267,517,82,18,784
1/1/2015,VA,Virginia,Frederick,51069,14212,12556,1656,12533,49,12484,1679,47,1632,12969,11315,1654,8613,7205,1408,1339,356,127,6791
1/1/2015,VA,Virginia,Fredericksburg City,51630,3684,3252,432,3009,15,2994,675,29,646,3316,2884,432,2176,1770,406,710,82,42,1342
1/1/2015,VA,Virginia,Galax City,51640,1950,1823,127,1493,*,*,457,*,*,1853,1726,127,1447,1347,100,669,70,33,675
1/1/2015,VA,Virginia,Giles,51071,4395,3243,1152,3455,20,3435,940,13,927,4130,2979,1151,3354,2324,1030,754,143,38,2419
1/1/2015,VA,Virginia,Gloucester,51073,7635,6432,1203,6526,32,6494,1109,19,1090,7007,5804,1203,4352,3261,1091,883,182,56,3231
1/1/2015,VA,Virginia,Goochland,51075,4927,3988,939,4444,22,4422,483,17,466,4483,3544,939,3500,2692,808,397,101,37,2965
1/1/2015,VA,Virginia,Grayson,51077,4453,3922,531,3609,13,3596,844,*,*,4274,3743,531,3157,2717,440,995,180,81,1901
1/1/2015,VA,Virginia,Greene,51079,3286,2836,450,2857,15,2842,429,12,417,3007,2557,450,2115,1699,416,394,78,21,1622
1/1/2015,VA,Virginia,Greensville,51081,2362,1741,621,1859,24,1835,503,21,482,2198,1577,621,1810,1259,551,548,129,26,1107
1/1/2015,VA,Virginia,Halifax,51083,9241,8036,1205,7457,62,7395,1784,69,1715,8688,7484,1204,6943,5851,1092,2140,443,133,4227
1/1/2015,VA,Virginia,Hampton City,51650,23078,17905,5173,18866,218,18648,4212,205,4007,21129,15956,5173,12512,7557,4955,3343,779,192,8198
1/1/2015,VA,Virginia,Hanover,51085,18301,14476,3825,16482,78,16404,1819,50,1769,16671,12846,3825,12716,9441,3275,1323,365,101,10927
1/1/2015,VA,Virginia,Harrisonburg City,51660,4954,4369,585,4154,22,4132,800,24,776,4533,3948,585,3470,3032,438,901,119,40,2410
1/1/2015,VA,Virginia,Henrico,51087,50304,38654,11650,43579,359,43220,6725,290,6435,45623,33975,11648,35080,24924,10156,5628,1346,402,27704
1/1/2015,VA,Virginia,Henry,51089,14825,10739,4086,11653,78,11575,3172,64,3108,14141,10055,4086,11875,8679,3196,3043,688,243,7901
1/1/2015,VA,Virginia,Highland,51091,706,637,69,650,*,*,56,*,*,667,598,69,485,422,63,66,*,*,395
1/1/2015,VA,Virginia,Hopewell City,51670,4346,3521,825,3349,31,3318,997,32,965,4049,3224,825,2702,1899,803,924,152,39,1587
1/1/2015,VA,Virginia,Isle of Wight,51093,7207,5616,1591,6265,39,6226,942,29,913,6692,5101,1591,4673,3171,1502,877,188,77,3531
1/1/2015,VA,Virginia,James City,51095,17967,15835,2132,16855,55,16800,1112,39,1073,16616,14488,2128,10077,8271,1806,824,196,44,9013
1/1/2015,VA,Virginia,King and Queen,51097,1603,1347,256,1340,*,*,263,*,*,1496,1240,256,1118,886,232,267,*,*,766
1/1/2015,VA,Virginia,King George,51099,3342,3007,335,2871,19,2852,471,19,452,2910,2575,335,1432,1120,312,415,84,22,911
1/1/2015,VA,Virginia,King William,51101,2947,2537,410,2522,17,2505,425,24,401,2716,2306,410,2103,1747,356,362,87,22,1632
1/1/2015,VA,Virginia,Lancaster,51103,4143,3572,571,3805,18,3787,338,11,327,3961,3390,571,2741,2331,410,480,86,31,2144
1/1/2015,VA,Virginia,Lee,51105,6270,4182,2088,4200,15,4185,2070,14,2056,5956,3871,2085,4751,2800,1951,1901,252,77,2521
1/1/2015,VA,Virginia,Lexington City,51678,1599,1430,169,1454,17,1437,145,*,*,1500,1331,169,1118,971,147,222,*,*,858
1/1/2015,VA,Virginia,Loudoun,51107,30114,26162,3952,27972,104,27868,2142,103,2039,25073,21126,3947,15355,11843,3512,2497,591,131,12136
1/1/2015,VA,Virginia,Louisa,51109,6984,5765,1219,5819,40,5779,1165,34,1131,6424,5205,1219,4607,3493,1114,1009,249,67,3282
1/1/2015,VA,Virginia,Lunenburg,51111,2895,2462,433,2351,18,2333,544,22,522,2667,2234,433,1978,1574,404,660,120,41,1157
1/1/2015,VA,Virginia,Lynchburg City,51680,14191,12120,2071,11240,97,11143,2951,109,2842,13237,11167,2070,10565,8697,1868,3197,450,151,6767
1/1/2015,VA,Virginia,Madison,51113,2748,2360,388,2418,12,2406,330,*,*,2564,2176,388,1823,1466,357,377,85,27,1334
1/1/2015,VA,Virginia,Manassas City,51683,3954,3318,636,3411,30,3381,543,31,512,3350,2715,635,2222,1629,593,482,103,32,1605
1/1/2015,VA,Virginia,Manassas Park City,51685,1072,888,184,915,11,904,157,12,145,896,712,184,603,433,170,143,*,*,405
1/1/2015,VA,Virginia,Martinsville City,51690,3916,3057,859,2954,22,2932,962,40,922,3734,2875,859,3207,2521,686,1277,171,59,1700
1/1/2015,VA,Virginia,Mathews,51115,2706,2322,384,2477,*,*,229,*,*,2559,2175,384,1688,1354,334,255,45,20,1368
1/1/2015,VA,Virginia,Mecklenburg,51117,8853,7368,1485,7246,52,7194,1607,51,1556,8364,6881,1483,6472,5273,1199,1875,375,121,4101
1/1/2015,VA,Virginia,Middlesex,51119,3354,2835,519,2996,21,2975,358,*,*,3157,2638,519,2332,1926,406,404,91,26,1811
1/1/2015,VA,Virginia,Montgomery,51121,12742,10487,2255,10442,46,10396,2300,34,2266,11593,9338,2255,9178,7054,2124,1760,302,120,6996
1/1/2015,VA,Virginia,Nelson,51125,4135,3552,583,3604,19,3585,531,15,516,3821,3238,583,2752,2216,536,596,108,38,2010
1/1/2015,VA,Virginia,New Kent,51127,3709,3069,640,3273,17,3256,436,12,424,3387,2747,640,2278,1763,515,276,75,21,1906
1/1/2015,VA,Virginia,Newport News City,51700,25904,19771,6133,21270,184,21086,4634,237,4397,23774,17644,6130,15105,9212,5893,4243,798,222,9842
1/1/2015,VA,Virginia,Norfolk City,51710,30282,23215,7067,23996,268,23728,6286,358,5928,27337,20270,7067,17727,10932,6795,6510,1286,292,9639
1/1/2015,VA,Virginia,Northampton,51131,3352,2811,541,2840,31,2809,512,33,479,3143,2602,541,2479,1982,497,888,98,40,1453
1/1/2015,VA,Virginia,Northumberland,51133,4486,3909,577,4140,15,4125,346,*,*,4207,3630,577,2663,2289,374,418,93,35,2117
1/1/2015,VA,Virginia,Norton City,51720,1164,859,305,765,*,*,399,*,*,1074,769,305,840,557,283,349,50,20,421
1/1/2015,VA,Virginia,Nottoway,51135,3499,2837,662,2842,28,2814,657,18,639,3248,2586,662,2504,1999,505,898,123,47,1436
1/1/2015,VA,Virginia,Orange,51137,8094,7062,1032,7106,46,7060,988,36,952,7464,6433,1031,4689,3818,871,904,243,70,3472
1/1/2015,VA,Virginia,Page,51139,5798,5089,709,4695,19,4676,1103,16,1087,5441,4732,709,3912,3291,621,1099,218,92,2503
1/1/2015,VA,Virginia,Patrick,51141,5016,3771,1245,4106,15,4091,910,15,895,4792,3548,1244,3838,2787,1051,982,196,82,2578
1/1/2015,VA,Virginia,Petersburg City,51730,6981,5330,1651,5122,101,5021,1859,89,1770,6391,4740,1651,4506,2906,1600,1927,362,88,2129
1/1/2015,VA,Virginia,Pittsylvania,51143,15159,12406,2753,12306,118,12188,2853,83,2770,14376,11623,2753,11668,9246,2422,3014,584,216,7854
1/1/2015,VA,Virginia,Poquoson City,51735,2394,2118,276,2210,*,*,184,0,184,2185,1909,276,1052,800,252,103,27,11,911
1/1/2015,VA,Virginia,Portsmouth City,51740,17262,13137,4125,13278,204,13074,3984,213,3771,15438,11313,4125,9631,5682,3949,3668,692,155,5116
1/1/2015,VA,Virginia,Powhatan,51145,5197,4162,1035,4596,26,4570,601,16,585,4760,3725,1035,3631,2702,929,374,103,34,3120
1/1/2015,VA,Virginia,Prince Edward,51147,4376,3563,813,3488,27,3461,888,30,858,4084,3272,812,3102,2433,669,1020,173,43,1866
1/1/2015,VA,Virginia,Prince George,51149,5238,4543,695,4392,32,4360,846,23,823,4857,4162,695,2773,2133,640,515,110,25,2123
1/1/2015,VA,Virginia,Prince William,51153,40252,33611,6641,35623,246,35377,4629,284,4345,34362,27726,6636,18869,12727,6142,4262,935,186,13486
1/1/2015,VA,Virginia,Pulaski,51155,8731,7115,1616,6810,31,6779,1921,31,1890,8174,6558,1616,6253,4722,1531,1637,332,124,4160
1/1/2015,VA,Virginia,Radford City,51750,1958,1591,367,1572,*,*,386,*,*,1794,1427,367,1462,1114,348,309,47,27,1079
1/1/2015,VA,Virginia,Rappahannock,51157,1860,1709,151,1702,*,*,158,*,*,1683,1532,151,1065,940,125,153,43,11,858
1/1/2015,VA,Virginia,Richmond,51159,1839,1470,369,1592,15,1577,247,11,236,1733,1364,369,1244,974,270,291,89,21,843
1/1/2015,VA,Virginia,Richmond City,51760,31389,21917,9472,24213,294,23919,7176,359,6817,28278,18806,9472,22883,13804,9079,7993,1438,332,13120
1/1/2015,VA,Virginia,Roanoke,51161,21688,17478,4210,19068,103,18965,2620,51,2569,20116,15906,4210,15437,11591,3846,1865,421,152,12999
1/1/2015,VA,Virginia,Roanoke City,51770,19483,14331,5152,14412,124,14288,5071,154,4917,17912,12761,5151,14220,9299,4921,4577,804,234,8605
1/1/2015,VA,Virginia,Rockbridge,51163,5584,4686,898,4704,20,4684,880,*,*,5212,4314,898,3827,3077,750,795,179,66,2787
1/1/2015,VA,Virginia,Rockingham,51165,15837,13286,2551,13801,53,13748,2036,48,1988,14672,12122,2550,11056,9211,1845,1699,492,146,8719
1/1/2015,VA,Virginia,Russell,51167,7642,5314,2328,5074,13,5061,2568,*,*,7290,4962,2328,6101,4190,1911,1695,304,130,3972
1/1/2015,VA,Virginia,Salem City,51775,5811,4728,1083,4887,31,4856,924,20,904,5333,4250,1083,4124,3124,1000,804,142,44,3134
1/1/2015,VA,Virginia,Scott,51169,6468,3351,3117,4816,17,4799,1652,12,1640,6200,3083,3117,5316,2260,3056,1527,245,115,3429
1/1/2015,VA,Virginia,Shenandoah,51171,9743,8628,1115,8538,20,8518,1205,28,1177,9143,8028,1115,6168,5245,923,1208,254,102,4604
1/1/2015,VA,Virginia,Smyth,51173,8644,6835,1809,6347,18,6329,2297,29,2268,8165,6356,1809,6506,4882,1624,2101,401,158,3846
1/1/2015,VA,Virginia,Southampton,51175,3838,3216,622,3177,28,3149,661,25,636,3581,2959,622,2746,2194,552,697,147,34,1868
1/1/2015,VA,Virginia,Spotsylvania,51177,17812,15619,2193,15330,120,15210,2482,91,2391,15889,13698,2191,9301,7396,1905,1732,491,121,6957
1/1/2015,VA,Virginia,Stafford,51179,14418,13024,1394,12567,78,12489,1851,93,1758,12631,11238,1393,6235,5021,1214,1170,337,82,4646
1/1/2015,VA,Virginia,Staunton City,51790,5794,5124,670,4708,25,4683,1086,28,1058,5448,4778,670,4190,3633,557,1029,160,56,2945
1/1/2015,VA,Virginia,Suffolk City,51800,14210,11515,2695,11503,89,11414,2707,85,2622,12964,10271,2693,8634,6164,2470,2547,405,112,5570
1/1/2015,VA,Virginia,Surry,51181,1449,1092,357,1213,15,1198,236,13,223,1341,984,357,962,627,335,214,71,12,665
1/1/2015,VA,Virginia,Sussex,51183,2300,1813,487,1852,36,1816,448,*,*,2138,1651,487,1622,1161,461,472,146,23,981
1/1/2015,VA,Virginia,Tazewell,51185,11515,8406,3109,8370,44,8326,3145,37,3108,10902,7795,3107,8456,6470,1986,2149,454,166,5687
1/1/2015,VA,Virginia,Unknown,51999,*,*,*,*,*,*,*,*,*,*,*,*,*,*,*,*,*,*,*
1/1/2015,VA,Virginia,Virginia Beach City,51810,62788,52872,9916,55089,331,54758,7699,328,7371,57427,47516,9911,31316,22112,9204,6115,1307,342,23552
1/1/2015,VA,Virginia,Warren,51187,6679,6036,643,5666,23,5643,1013,25,988,6108,5465,643,3982,3432,550,815,234,65,2868
1/1/2015,VA,Virginia,Washington,51191,14415,9933,4482,11321,60,11261,3094,21,3073,13590,9109,4481,10755,6629,4126,2466,529,188,7572
1/1/2015,VA,Virginia,Waynesboro City,51820,4668,3957,711,3810,20,3790,858,24,834,4391,3680,711,3435,2813,622,855,104,48,2428
1/1/2015,VA,Virginia,Westmoreland,51193,4582,3981,601,3990,29,3961,592,12,580,4198,3597,601,2582,2070,512,712,131,43,1696
1/1/2015,VA,Virginia,Williamsburg City,51830,2365,2029,336,2170,12,2158,195,*,*,2148,1813,335,1457,1164,293,200,*,*,1218
1/1/2015,VA,Virginia,Winchester City,51840,4828,4319,509,4127,19,4108,701,18,683,4405,3896,509,3062,2621,441,767,126,43,2126
1/1/2015,VA,Virginia,Wise,51195,10264,6945,3319,6699,15,6684,3565,19,3546,9667,6349,3318,7513,4408,3105,2352,498,160,4503
1/1/2015,VA,Virginia,Wythe,51197,7272,5845,1427,5614,31,5583,1658,24,1634,6885,5458,1427,5273,4050,1223,1463,280,105,3425
1/1/2015,VA,Virginia,York,51199,10598,9289,1309,9707,50,9657,891,30,861,9700,8393,1307,5030,3820,1210,622,160,43,4205
7/1/2015,VA,Virginia,Accomack,51001,8307,7157,1150,7045,42,7003,1262,43,1219,7787,6637,1150,5595,4610,985,1528,366,92,3609
7/1/2015,VA,Virginia,Albemarle,51003,18036,16103,1933,16462,59,16403,1574,53,1521,16194,14261,1933,11917,10181,1736,1471,272,88,10086
7/1/2015,VA,Virginia,Alexandria City,51510,16104,13934,2170,14680,74,14606,1424,95,1329,13049,10881,2168,7298,5252,2046,1967,336,73,4922
7/1/2015,VA,Virginia,Alleghany,51005,4446,3804,642,3550,18,3532,896,13,883,4215,3573,642,3342,2828,514,834,105,50,2353
7/1/2015,VA,Virginia,Amelia,51007,2874,2234,640,2386,*,*,488,13,475,2657,2017,640,2022,1433,589,479,85,26,1432
7/1/2015,VA,Virginia,Amherst,51009,7318,6183,1135,5993,43,5950,1325,39,1286,6816,5681,1135,5396,4347,1049,1161,227,77,3931
7/1/2015,VA,Virginia,Appomattox,51011,3689,3140,549,2967,22,2945,722,20,702,3473,2924,549,2741,2243,498,689,99,49,1904
7/1/2015,VA,Virginia,Arlington,51013,22160,19184,2976,20509,76,20433,1651,84,1567,17707,14731,2976,9846,7038,2808,2861,319,120,6546
7/1/2015,VA,Virginia,Augusta,51015,16696,14320,2376,14253,46,14207,2443,39,2404,15646,13270,2376,11681,9685,1996,1837,385,156,9303
7/1/2015,VA,Virginia,Bath,51017,1254,1139,115,1097,*,*,157,*,*,1178,1063,115,913,812,101,197,34,20,662
7/1/2015,VA,Virginia,Bedford,51019,18144,14907,3237,15304,66,15238,2840,50,2790,16970,13736,3234,12869,10205,2664,1980,463,159,10267
7/1/2015,VA,Virginia,Bland,51021,1704,1349,355,1328,*,*,376,*,*,1608,1253,355,1195,927,268,255,53,19,868
7/1/2015,VA,Virginia,Botetourt,51023,7982,6239,1743,6834,35,6799,1148,16,1132,7386,5643,1743,5672,4083,1589,851,170,56,4595
7/1/2015,VA,Virginia,Bristol City,51520,4374,2661,1713,3382,11,3371,992,11,981,4120,2407,1713,3389,1727,1662,982,164,56,2187
7/1/2015,VA,Virginia,Brunswick,51025,3835,3155,680,3087,28,3059,748,29,719,3620,2940,680,2809,2191,618,1093,113,38,1565
7/1/2015,VA,Virginia,Buchanan,51027,7333,4606,2727,4419,12,4407,2914,13,2901,7044,4317,2727,5783,3875,1908,1622,421,110,3630
7/1/2015,VA,Virginia,Buckingham,51029,3294,2662,632,2643,13,2630,651,13,638,3067,2435,632,2326,1788,538,709,145,44,1428
7/1/2015,VA,Virginia,Buena Vista City,51530,1413,1148,265,1122,*,*,291,*,*,1326,1061,265,1016,795,221,331,56,18,611
7/1/2015,VA,Virginia,Campbell,51031,12090,10187,1903,9865,72,9793,2225,61,2164,11360,9457,1903,8970,7235,1735,2060,362,175,6373
7/1/2015,VA,Virginia,Caroline,51033,5303,4395,908,4395,32,4363,908,38,870,4821,3913,908,3175,2359,816,760,236,54,2125
7/1/2015,VA,Virginia,Carroll,51035,7747,6676,1071,6146,23,6123,1601,19,1582,7370,6299,1071,5621,4758,863,1660,266,103,3592
7/1/2015,VA,Virginia,Charles City,51036,1730,1337,393,1450,17,1433,280,12,268,1609,1216,393,1189,863,326,266,80,17,826
7/1/2015,VA,Virginia,Charlotte,51037,3264,2758,506,2631,19,2612,633,12,621,3083,2577,506,2380,1929,451,777,128,51,1424
7/1/2015,VA,Virginia,Charlottesville City,51540,5874,5138,736,4725,23,4702,1149,46,1103,5280,4545,735,4137,3435,702,1214,153,55,2715
7/1/2015,VA,Virginia,Chesapeake City,51550,33571,27407,6164,28468,226,28242,5103,239,4864,30346,24182,6164,17919,12186,5733,3861,836,224,12998
7/1/2015,VA,Virginia,Chesterfield,51041,51990,40656,11334,44742,173,44569,7248,221,7027,46851,35519,11332,34518,24159,10359,4821,959,272,28466
7/1/2015,VA,Virginia,Clarke,51043,2889,2584,305,2631,15,2616,258,*,*,2615,2310,305,1695,1440,255,252,75,32,1336
7/1/2015,VA,Virginia,Colonial Heights City,51570,4106,3549,557,3523,*,*,583,12,571,3784,3227,557,2306,1795,511,457,101,25,1723
7/1/2015,VA,Virginia,Covington City,51580,1667,1433,234,1284,*,*,383,*,*,1553,1319,234,1208,986,222,349,53,20,786
7/1/2015,VA,Virginia,Craig,51045,1248,985,263,957,*,*,291,*,*,1149,886,263,890,630,260,200,38,14,638
7/1/2015,VA,Virginia,Culpeper,51047,8306,7250,1056,7105,51,7054,1201,39,1162,7592,6536,1056,5059,4114,945,1102,260,66,3631
7/1/2015,VA,Virginia,Cumberland,51049,2156,1676,480,1766,*,*,390,*,*,2003,1524,479,1526,1089,437,430,75,30,991
7/1/2015,VA,Virginia,Danville City,51590,11042,9286,1756,8597,79,8518,2445,116,2329,10480,8724,1756,8549,7260,1289,3195,434,163,4757
7/1/2015,VA,Virginia,Dickenson,51051,4676,3072,1604,2802,*,*,1874,13,1861,4462,2858,1604,3574,2151,1423,1093,222,88,2171
7/1/2015,VA,Virginia,Dinwiddie,51053,5432,4350,1082,4323,35,4288,1109,32,1077,4992,3910,1082,3591,2554,1037,887,182,49,2473
7/1/2015,VA,Virginia,Emporia City,51595,1139,861,278,867,12,855,272,14,258,1067,789,278,859,628,231,418,63,12,366
7/1/2015,VA,Virginia,Essex,51057,2706,2244,462,2299,17,2282,407,15,392,2530,2068,462,1851,1478,373,428,90,27,1306
7/1/2015,VA,Virginia,Fairfax,51059,134899,117907,16992,126770,505,126265,8129,397,7732,109603,92640,16963,58671,43013,15658,12823,2477,440,42931
7/1/2015,VA,Virginia,Fairfax City,51600,3558,3088,470,3267,13,3254,291,11,280,3001,2531,470,1652,1213,439,394,50,14,1194
7/1/2015,VA,Virginia,Falls Church City,51610,1719,1498,221,1629,*,*,90,*,*,1359,1139,220,771,571,200,133,*,*,617
7/1/2015,VA,Virginia,Fauquier,51061,11102,10096,1006,10014,40,9974,1088,41,1047,9825,8820,1005,5895,5029,866,888,188,53,4766
7/1/2015,VA,Virginia,Floyd,51063,3731,3020,711,3187,13,3174,544,*,*,3500,2789,711,2687,2035,652,532,92,50,2013
7/1/2015,VA,Virginia,Fluvanna,51065,5340,4621,719,4779,26,4753,561,24,537,4878,4159,719,3445,2806,639,473,116,21,2835
7/1/2015,VA,Virginia,Franklin,51067,13611,10138,3473,11150,41,11109,2461,22,2439,12783,9310,3473,10147,6838,3309,1936,462,159,7590
7/1/2015,VA,Virginia,Franklin City,51620,1857,1559,298,1438,16,1422,419,18,401,1754,1456,298,1420,1147,273,539,74,18,789
7/1/2015,VA,Virginia,Frederick,51069,14384,12755,1629,12644,43,12601,1740,44,1696,13155,11528,1627,8710,7326,1384,1400,345,119,6846
7/1/2015,VA,Virginia,Fredericksburg City,51630,3728,3312,416,3036,15,3021,692,28,664,3365,2949,416,2204,1812,392,733,81,43,1347
7/1/2015,VA,Virginia,Galax City,51640,1929,1804,125,1472,*,*,457,*,*,1828,1703,125,1432,1333,99,679,59,33,661
7/1/2015,VA,Virginia,Giles,51071,4426,3279,1147,3464,16,3448,962,13,949,4170,3024,1146,3365,2344,1021,772,134,37,2422
7/1/2015,VA,Virginia,Gloucester,51073,7722,6510,1212,6572,29,6543,1150,23,1127,7108,5896,1212,4397,3296,1101,911,174,49,3263
7/1/2015,VA,Virginia,Goochland,51075,5027,4093,934,4534,19,4515,493,17,476,4571,3637,934,3570,2770,800,419,105,35,3011
7/1/2015,VA,Virginia,Grayson,51077,4486,3959,527,3614,*,*,872,*,*,4304,3777,527,3159,2721,438,1008,180,87,1884
7/1/2015,VA,Virginia,Greene,51079,3345,2909,436,2903,13,2890,442,11,431,3066,2630,436,2145,1742,403,409,73,22,1641
7/1/2015,VA,Virginia,Greensville,51081,2379,1775,604,1868,21,1847,511,21,490,2219,1615,604,1810,1272,538,569,120,24,1097
7/1/2015,VA,Virginia,Halifax,51083,9291,8092,1199,7472,56,7416,1819,70,1749,8756,7558,1198,6978,5888,1090,2174,436,129,4239
7/1/2015,VA,Virginia,Hampton City,51650,23299,18093,5206,18955,187,18768,4344,211,4133,21336,16130,5206,12600,7601,4999,3490,751,178,8181
7/1/2015,VA,Virginia,Hanover,51085,18531,14690,3841,16638,69,16569,1893,50,1843,16890,13049,3841,12891,9613,3278,1362,359,98,11072
7/1/2015,VA,Virginia,Harrisonburg City,51660,5004,4429,575,4182,19,4163,822,23,799,4557,3982,575,3497,3065,432,926,122,35,2414
7/1/2015,VA,Virginia,Henrico,51087,50865,39200,11665,43942,316,43626,6923,302,6621,46138,34474,11664,35430,25232,10198,5826,1309,385,27910
7/1/2015,VA,Virginia,Henry,51089,14881,10836,4045,11640,71,11569,3241,62,3179,14201,10156,4045,11878,8673,3205,3135,669,234,7840
7/1/2015,VA,Virginia,Highland,51091,704,640,64,647,*,*,57,*,*,665,601,64,481,421,60,67,*,*,392
7/1/2015,VA,Virginia,Hopewell City,51670,4368,3544,824,3351,28,3323,1017,33,984,4081,3257,824,2722,1921,801,943,154,37,1588
7/1/2015,VA,Virginia,Isle of Wight,51093,7325,5746,1579,6348,36,6312,977,30,947,6806,5227,1579,4755,3261,1494,894,185,76,3600
7/1/2015,VA,Virginia,James City,51095,18203,16070,2133,17061,51,17010,1142,42,1100,16833,14704,2129,10238,8429,1809,861,194,44,9139
7/1/2015,VA,Virginia,King and Queen,51097,1630,1381,249,1359,*,*,271,*,*,1522,1273,249,1128,904,224,269,*,*,777
7/1/2015,VA,Virginia,King George,51099,3412,3085,327,2917,19,2898,495,20,475,2977,2650,327,1468,1162,306,435,84,18,931
7/1/2015,VA,Virginia,King William,51101,2993,2577,416,2540,17,2523,453,25,428,2768,2352,416,2132,1771,361,374,89,21,1648
7/1/2015,VA,Virginia,Lancaster,51103,4166,3605,561,3816,15,3801,350,*,*,3992,3431,561,2744,2342,402,493,80,30,2141
7/1/2015,VA,Virginia,Lee,51105,6289,4174,2115,4167,12,4155,2122,14,2108,5979,3868,2111,4761,2773,1988,1934,247,79,2501
7/1/2015,VA,Virginia,Lexington City,51678,1589,1430,159,1440,14,1426,149,*,*,1487,1328,159,1111,974,137,220,*,*,853
7/1/2015,VA,Virginia,Loudoun,51107,30890,26304,4586,28636,96,28540,2254,108,2146,25730,21149,4581,15778,11628,4150,2642,583,138,12415
7/1/2015,VA,Virginia,Louisa,51109,7102,5929,1173,5894,38,5856,1208,34,1174,6529,5356,1173,4685,3611,1074,1035,248,66,3336
7/1/2015,VA,Virginia,Lunenburg,51111,2920,2497,423,2362,17,2345,558,21,537,2702,2279,423,1992,1596,396,686,122,42,1142
7/1/2015,VA,Virginia,Lynchburg City,51680,14234,12179,2055,11220,87,11133,3014,108,2906,13272,11218,2054,10576,8716,1860,3247,426,146,6757
7/1/2015,VA,Virginia,Madison,51113,2788,2408,380,2445,11,2434,343,*,*,2597,2217,380,1855,1509,346,383,87,25,1360
7/1/2015,VA,Virginia,Manassas City,51683,4034,3382,652,3476,29,3447,558,33,525,3425,2774,651,2262,1651,611,504,94,35,1629
7/1/2015,VA,Virginia,Manassas Park City,51685,1108,913,195,944,11,933,164,13,151,924,730,194,614,433,181,153,48,13,400
7/1/2015,VA,Virginia,Martinsville City,51690,3899,3051,848,2921,18,2903,978,37,941,3731,2883,848,3199,2510,689,1296,167,61,1675
7/1/2015,VA,Virginia,Mathews,51115,2726,2350,376,2496,*,*,230,*,*,2593,2217,376,1709,1383,326,254,48,18,1389
7/1/2015,VA,Virginia,Mecklenburg,51117,8883,7442,1441,7250,49,7201,1633,55,1578,8403,6964,1439,6477,5310,1167,1904,372,123,4078
7/1/2015,VA,Virginia,Middlesex,51119,3386,2876,510,3018,20,2998,368,*,*,3194,2684,510,2349,1953,396,408,85,30,1826
7/1/2015,VA,Virginia,Montgomery,51121,12817,10614,2203,10456,38,10418,2361,33,2328,11692,9489,2203,9241,7162,2079,1808,295,122,7016
7/1/2015,VA,Virginia,Nelson,51125,4192,3626,566,3642,16,3626,550,15,535,3867,3301,566,2775,2254,521,606,100,43,2026
7/1/2015,VA,Virginia,New Kent,51127,3777,3137,640,3329,16,3313,448,11,437,3456,2816,640,2346,1833,513,293,75,21,1957
7/1/2015,VA,Virginia,Newport News City,51700,26156,20003,6153,21367,166,21201,4789,243,4546,24070,17920,6150,15183,9264,5919,4403,772,225,9783
7/1/2015,VA,Virginia,Norfolk City,51710,30634,23537,7097,24136,253,23883,6498,355,6143,27724,20628,7096,17928,11102,6826,6762,1250,274,9642
7/1/2015,VA,Virginia,Northampton,51131,3385,2864,521,2853,29,2824,532,31,501,3171,2650,521,2493,2015,478,889,92,38,1474
7/1/2015,VA,Virginia,Northumberland,51133,4521,3962,559,4168,14,4154,353,*,*,4244,3685,559,2686,2323,363,425,96,34,2131
7/1/2015,VA,Virginia,Norton City,51720,1172,869,303,772,*,*,400,*,*,1083,780,303,852,568,284,357,48,19,428
7/1/2015,VA,Virginia,Nottoway,51135,3535,2884,651,2857,28,2829,678,20,658,3287,2636,651,2513,2018,495,902,130,41,1440
7/1/2015,VA,Virginia,Orange,51137,8176,7189,987,7158,41,7117,1018,37,981,7529,6543,986,4713,3888,825,934,228,67,3484
7/1/2015,VA,Virginia,Page,51139,5866,5165,701,4718,19,4699,1148,17,1131,5497,4796,701,3952,3342,610,1146,207,84,2515
7/1/2015,VA,Virginia,Patrick,51141,5004,3804,1200,4082,13,4069,922,15,907,4784,3585,1199,3804,2785,1019,985,193,80,2546
7/1/2015,VA,Virginia,Petersburg City,51730,7042,5410,1632,5127,97,5030,1915,91,1824,6456,4824,1632,4542,2960,1582,1962,359,74,2147
7/1/2015,VA,Virginia,Pittsylvania,51143,15267,12537,2730,12352,105,12247,2915,83,2832,14485,11755,2730,11687,9290,2397,3062,555,212,7858
7/1/2015,VA,Virginia,Poquoson City,51735,2405,2133,272,2223,*,*,182,0,182,2199,1927,272,1058,809,249,101,*,*,918
7/1/2015,VA,Virginia,Portsmouth City,51740,17419,13230,4189,13309,189,13120,4110,209,3901,15653,11464,4189,9990,5974,4016,3820,656,159,5355
7/1/2015,VA,Virginia,Powhatan,51145,5275,4237,1038,4660,23,4637,615,15,600,4833,3795,1038,3696,2765,931,381,100,34,3181
7/1/2015,VA,Virginia,Prince Edward,51147,4399,3627,772,3481,27,3454,918,34,884,4110,3338,772,3107,2481,626,1049,166,43,1849
7/1/2015,VA,Virginia,Prince George,51149,5320,4635,685,4451,25,4426,869,22,847,4926,4241,685,2798,2168,630,528,108,25,2137
7/1/2015,VA,Virginia,Prince William,51153,41362,34676,6686,36565,227,36338,4797,289,4508,35405,28723,6682,19380,13181,6199,4557,926,185,13712
7/1/2015,VA,Virginia,Pulaski,51155,8801,7217,1584,6835,24,6811,1966,32,1934,8226,6642,1584,6247,4749,1498,1668,328,120,4131
7/1/2015,VA,Virginia,Radford City,51750,1974,1609,365,1579,*,*,395,*,*,1816,1451,365,1478,1132,346,320,44,27,1087
7/1/2015,VA,Virginia,Rappahannock,51157,1895,1747,148,1731,*,*,164,*,*,1711,1563,148,1079,957,122,158,*,*,873
7/1/2015,VA,Virginia,Richmond,51159,1833,1482,351,1577,14,1563,256,12,244,1729,1378,351,1230,980,250,291,90,21,828
7/1/2015,VA,Virginia,Richmond City,51760,31669,22239,9430,24357,257,24100,7312,353,6959,28576,19146,9430,23100,14058,9042,8267,1413,321,13099
7/1/2015,VA,Virginia,Roanoke,51161,21941,17785,4156,19246,86,19160,2695,51,2644,20353,16197,4156,15637,11839,3798,1927,418,148,13144
7/1/2015,VA,Virginia,Roanoke City,51770,19667,14540,5127,14467,116,14351,5200,149,5051,18073,12949,5124,14292,9393,4899,4736,805,217,8534
7/1/2015,VA,Virginia,Rockbridge,51163,5616,4730,886,4712,18,4694,904,*,*,5232,4346,886,3826,3086,740,821,170,62,2773
7/1/2015,VA,Virginia,Rockingham,51165,15995,13536,2459,13901,45,13856,2094,48,2046,14812,12354,2458,11153,9363,1790,1755,492,148,8758
7/1/2015,VA,Virginia,Russell,51167,7667,5322,2345,5052,12,5040,2615,*,*,7335,4990,2345,6144,4212,1932,1734,304,130,3976
7/1/2015,VA,Virginia,Salem City,51775,5811,4775,1036,4863,27,4836,948,18,930,5328,4292,1036,4113,3158,955,818,141,40,3114
7/1/2015,VA,Virginia,Scott,51169,6468,3364,3104,4777,13,4764,1691,11,1680,6205,3101,3104,5310,2264,3046,1538,246,110,3416
7/1/2015,VA,Virginia,Shenandoah,51171,9796,8694,1102,8567,17,8550,1229,27,1202,9196,8094,1102,6169,5261,908,1245,234,102,4588
7/1/2015,VA,Virginia,Smyth,51173,8666,6839,1827,6336,18,6318,2330,29,2301,8195,6368,1827,6534,4890,1644,2155,399,161,3819
7/1/2015,VA,Virginia,Southampton,51175,3899,3289,610,3212,24,3188,687,26,661,3646,3036,610,2793,2252,541,725,138,34,1896
7/1/2015,VA,Virginia,Spotsylvania,51177,18175,16021,2154,15604,106,15498,2571,94,2477,16223,14070,2153,9503,7622,1881,1812,477,120,7094
7/1/2015,VA,Virginia,Stafford,51179,14716,13342,1374,12813,72,12741,1903,94,1809,12949,11576,1373,6312,5117,1195,1209,344,81,4678
7/1/2015,VA,Virginia,Staunton City,51790,5786,4981,805,4675,21,4654,1111,28,1083,5442,4637,805,4166,3465,701,1062,158,49,2897
7/1/2015,VA,Virginia,Suffolk City,51800,14364,11695,2669,11579,78,11501,2785,90,2695,13152,10484,2668,8781,6340,2441,2594,396,111,5680
7/1/2015,VA,Virginia,Surry,51181,1457,1111,346,1211,11,1200,246,13,233,1352,1006,346,969,643,326,220,66,14,669
7/1/2015,VA,Virginia,Sussex,51183,2294,1816,478,1840,33,1807,454,*,*,2139,1661,478,1610,1161,449,476,137,25,972
7/1/2015,VA,Virginia,Tazewell,51185,11544,8455,3089,8334,40,8294,3210,37,3173,10940,7853,3087,8519,6526,1993,2198,431,169,5721
7/1/2015,VA,Virginia,Unknown,51999,*,*,*,*,*,*,*,*,*,*,*,*,*,*,*,*,*,*,*
7/1/2015,VA,Virginia,Virginia Beach City,51810,63732,53725,10007,55791,305,55486,7941,323,7618,58377,48377,10000,31693,22376,9317,6347,1274,340,23732
7/1/2015,VA,Virginia,Warren,51187,6812,6153,659,5762,19,5743,1050,27,1023,6211,5552,659,4036,3482,554,851,223,70,2892
7/1/2015,VA,Virginia,Washington,51191,14479,9993,4486,11331,56,11275,3148,23,3125,13653,9168,4485,10779,6647,4132,2519,510,180,7570
7/1/2015,VA,Virginia,Waynesboro City,51820,4680,3980,700,3810,20,3790,870,23,847,4391,3691,700,3412,2799,613,866,100,48,2398
7/1/2015,VA,Virginia,Westmoreland,51193,4605,4010,595,4008,25,3983,597,11,586,4217,3622,595,2567,2060,507,739,125,40,1663
7/1/2015,VA,Virginia,Williamsburg City,51830,2386,2051,335,2185,*,*,201,*,*,2169,1835,334,1467,1176,291,208,*,*,1226
7/1/2015,VA,Virginia,Winchester City,51840,4885,4381,504,4147,18,4129,738,18,720,4455,3951,504,3114,2676,438,802,127,41,2144
7/1/2015,VA,Virginia,Wise,51195,10292,6917,3375,6661,14,6647,3631,20,3611,9698,6324,3374,7522,4351,3171,2390,482,161,4489
7/1/2015,VA,Virginia,Wythe,51197,7304,5650,1654,5596,27,5569,1708,24,1684,6916,5262,1654,5279,3828,1451,1482,280,98,3419
7/1/2015,VA,Virginia,York,51199,10777,9486,1291,9846,48,9798,931,32,899,9875,8584,1291,5089,3892,1197,644,159,40,4246
6/1/2015,VA,Virginia,Accomack,51001,8282,7131,1151,7034,42,6992,1248,43,1205,7746,6595,1151,5570,4584,986,1515,363,91,3601
6/1/2015,VA,Virginia,Albemarle,51003,17974,16046,1928,16406,60,16346,1568,54,1514,16106,14178,1928,11865,10135,1730,1464,277,89,10035
6/1/2015,VA,Virginia,Alexandria City,51510,16035,14305,1730,14618,75,14543,1417,95,1322,12882,11154,1728,7253,5649,1604,1954,332,72,4895
6/1/2015,VA,Virginia,Alleghany,51005,4434,3792,642,3541,18,3523,893,13,880,4197,3555,642,3339,2825,514,833,108,50,2348
6/1/2015,VA,Virginia,Amelia,51007,2869,2228,641,2379,*,*,490,13,477,2646,2005,641,2017,1427,590,482,86,25,1424
6/1/2015,VA,Virginia,Amherst,51009,7301,6174,1127,5982,44,5938,1319,37,1282,6782,5655,1127,5382,4341,1041,1154,232,78,3918
6/1/2015,VA,Virginia,Appomattox,51011,3687,3136,551,2967,23,2944,720,20,700,3463,2912,551,2738,2238,500,688,101,51,1898
6/1/2015,VA,Virginia,Arlington,51013,22066,19731,2335,20421,78,20343,1645,83,1562,17523,15188,2335,9791,7621,2170,2836,319,120,6516
6/1/2015,VA,Virginia,Augusta,51015,16663,14325,2338,14229,47,14182,2434,38,2396,15589,13251,2338,11656,9697,1959,1821,379,156,9300
6/1/2015,VA,Virginia,Bath,51017,1258,1141,117,1101,*,*,157,*,*,1177,1060,117,917,814,103,200,34,21,662
6/1/2015,VA,Virginia,Bedford,51019,18120,14883,3237,15283,69,15214,2837,51,2786,16894,13660,3234,12814,10156,2658,1971,461,158,10224
6/1/2015,VA,Virginia,Bland,51021,1708,1355,353,1331,*,*,377,*,*,1609,1256,353,1196,929,267,252,54,18,872
6/1/2015,VA,Virginia,Botetourt,51023,7946,6208,1738,6800,35,6765,1146,16,1130,7337,5599,1738,5633,4049,1584,840,171,55,4567
6/1/2015,VA,Virginia,Bristol City,51520,4373,2667,1706,3384,11,3373,989,11,978,4113,2407,1706,3381,1726,1655,978,164,55,2184
6/1/2015,VA,Virginia,Brunswick,51025,3819,3135,684,3084,30,3054,735,29,706,3597,2913,684,2803,2181,622,1089,115,38,1561
6/1/2015,VA,Virginia,Buchanan,51027,7326,4608,2718,4426,13,4413,2900,13,2887,7029,4311,2718,5767,3867,1900,1615,423,109,3620
6/1/2015,VA,Virginia,Buckingham,51029,3282,2650,632,2634,13,2621,648,13,635,3048,2416,632,2315,1776,539,700,144,44,1427
6/1/2015,VA,Virginia,Buena Vista City,51530,1416,1151,265,1128,*,*,288,*,*,1322,1057,265,1013,792,221,329,57,18,609
6/1/2015,VA,Virginia,Campbell,51031,12074,10172,1902,9856,72,9784,2218,65,2153,11318,9416,1902,8959,7225,1734,2050,361,176,6372
6/1/2015,VA,Virginia,Caroline,51033,5287,4379,908,4382,33,4349,905,38,867,4792,3884,908,3166,2351,815,750,238,54,2124
6/1/2015,VA,Virginia,Carroll,51035,7725,6662,1063,6126,23,6103,1599,21,1578,7336,6273,1063,5600,4749,851,1647,269,106,3578
6/1/2015,VA,Virginia,Charles City,51036,1722,1327,395,1444,17,1427,278,12,266,1597,1202,395,1183,855,328,261,80,16,826
6/1/2015,VA,Virginia,Charlotte,51037,3254,2750,504,2628,19,2609,626,12,614,3068,2564,504,2369,1919,450,771,128,54,1416
6/1/2015,VA,Virginia,Charlottesville City,51540,5861,5126,735,4712,23,4689,1149,46,1103,5255,4521,734,4124,3423,701,1205,155,54,2710
6/1/2015,VA,Virginia,Chesapeake City,51550,33440,27325,6115,28366,229,28137,5074,239,4835,30072,23957,6115,17803,12121,5682,3832,831,224,12916
6/1/2015,VA,Virginia,Chesterfield,51041,51776,40504,11272,44581,174,44407,7195,225,6970,46464,35194,11270,34285,23984,10301,4795,955,264,28271
6/1/2015,VA,Virginia,Clarke,51043,2882,2582,300,2624,15,2609,258,*,*,2600,2300,300,1688,1438,250,252,74,32,1330
6/1/2015,VA,Virginia,Colonial Heights City,51570,4104,3551,553,3528,*,*,576,12,564,3766,3213,553,2301,1793,508,460,100,25,1716
6/1/2015,VA,Virginia,Covington City,51580,1664,1429,235,1282,*,*,382,*,*,1549,1314,235,1204,981,223,348,55,20,781
6/1/2015,VA,Virginia,Craig,51045,1245,979,266,955,*,*,290,*,*,1143,877,266,891,628,263,200,38,14,639
6/1/2015,VA,Virginia,Culpeper,51047,8278,7218,1060,7084,51,7033,1194,39,1155,7550,6490,1060,5041,4092,949,1101,258,66,3616
6/1/2015,VA,Virginia,Cumberland,51049,2149,1670,479,1760,*,*,389,*,*,1995,1517,478,1516,1080,436,423,75,30,988
6/1/2015,VA,Virginia,Danville City,51590,11036,9279,1757,8596,78,8518,2440,117,2323,10453,8696,1757,8541,7254,1287,3181,435,164,4761
6/1/2015,VA,Virginia,Dickenson,51051,4676,3076,1600,2804,*,*,1872,13,1859,4455,2855,1600,3573,2153,1420,1089,224,86,2174
6/1/2015,VA,Virginia,Dinwiddie,51053,5415,4330,1085,4313,35,4278,1102,32,1070,4967,3882,1085,3581,2541,1040,885,180,49,2467
6/1/2015,VA,Virginia,Emporia City,51595,1139,859,280,869,13,856,270,14,256,1070,790,280,864,632,232,419,63,12,370
6/1/2015,VA,Virginia,Essex,51057,2696,2234,462,2291,17,2274,405,15,390,2509,2047,462,1843,1468,375,428,89,28,1298
6/1/2015,VA,Virginia,Fairfax,51059,134115,117378,16737,126036,515,125521,8079,399,7680,108218,91510,16708,58158,42750,15408,12716,2480,436,42526
6/1/2015,VA,Virginia,Fairfax City,51600,3536,3076,460,3245,13,3232,291,11,280,2970,2510,460,1635,1206,429,391,50,14,1180
6/1/2015,VA,Virginia,Falls Church City,51610,1706,1491,215,1617,*,*,89,*,*,1345,1131,214,758,564,194,132,*,*,604
6/1/2015,VA,Virginia,Fauquier,51061,11061,10063,998,9973,41,9932,1088,40,1048,9746,8749,997,5865,5008,857,887,190,53,4735
6/1/2015,VA,Virginia,Floyd,51063,3719,3010,709,3178,13,3165,541,*,*,3477,2768,709,2681,2029,652,533,93,47,2008
6/1/2015,VA,Virginia,Fluvanna,51065,5339,4615,724,4776,27,4749,563,24,539,4863,4139,724,3438,2795,643,470,114,21,2833
6/1/2015,VA,Virginia,Franklin,51067,13591,10116,3475,11143,40,11103,2448,22,2426,12752,9277,3475,10132,6820,3312,1926,465,157,7584
6/1/2015,VA,Virginia,Franklin City,51620,1855,1561,294,1436,17,1419,419,18,401,1750,1456,294,1414,1146,268,535,74,18,787
6/1/2015,VA,Virginia,Frederick,51069,14332,12710,1622,12609,44,12565,1723,44,1679,13080,11460,1620,8668,7291,1377,1393,340,120,6815
6/1/2015,VA,Virginia,Fredericksburg City,51630,3717,3301,416,3029,16,3013,688,29,659,3336,2920,416,2196,1804,392,731,82,44,1339
6/1/2015,VA,Virginia,Galax City,51640,1929,1807,122,1476,*,*,453,*,*,1825,1703,122,1432,1335,97,673,63,33,663
6/1/2015,VA,Virginia,Giles,51071,4418,3276,1142,3460,17,3443,958,13,945,4150,3009,1141,3359,2343,1016,769,135,37,2418
6/1/2015,VA,Virginia,Gloucester,51073,7689,6482,1207,6546,29,6517,1143,22,1121,7052,5845,1207,4372,3276,1096,900,172,49,3251
6/1/2015,VA,Virginia,Goochland,51075,5002,4071,931,4516,20,4496,486,17,469,4547,3616,931,3556,2759,797,413,103,35,3005
6/1/2015,VA,Virginia,Grayson,51077,4472,3948,524,3607,*,*,865,*,*,4285,3761,524,3150,2716,434,1003,178,88,1881
6/1/2015,VA,Virginia,Greene,51079,3333,2895,438,2893,13,2880,440,11,429,3040,2602,438,2131,1726,405,409,73,22,1627
6/1/2015,VA,Virginia,Greensville,51081,2381,1771,610,1870,22,1848,511,21,490,2214,1604,610,1811,1267,544,570,121,24,1096
6/1/2015,VA,Virginia,Halifax,51083,9283,8082,1201,7469,56,7413,1814,71,1743,8731,7531,1200,6975,5883,1092,2179,437,127,4232
6/1/2015,VA,Virginia,Hampton City,51650,23252,18058,5194,18916,189,18727,4336,212,4124,21236,16042,5194,12554,7569,4985,3467,751,175,8161
6/1/2015,VA,Virginia,Hanover,51085,18474,14629,3845,16595,71,16524,1879,49,1830,16796,12951,3845,12837,9550,3287,1361,356,95,11025
6/1/2015,VA,Virginia,Harrisonburg City,51660,4991,4420,571,4172,20,4152,819,22,797,4544,3973,571,3494,3068,426,929,126,36,2403
6/1/2015,VA,Virginia,Henrico,51087,50709,39098,11611,43825,320,43505,6884,299,6585,45829,34219,11610,35237,25092,10145,5786,1307,384,27760
6/1/2015,VA,Virginia,Henry,51089,14874,10840,4034,11643,72,11571,3231,62,3169,14164,10130,4034,11858,8664,3194,3127,664,231,7836
6/1/2015,VA,Virginia,Highland,51091,705,638,67,648,*,*,57,*,*,665,598,67,481,419,62,66,*,*,393
6/1/2015,VA,Virginia,Hopewell City,51670,4362,3537,825,3351,28,3323,1011,32,979,4063,3238,825,2706,1904,802,930,158,37,1581
6/1/2015,VA,Virginia,Isle of Wight,51093,7305,5730,1575,6334,36,6298,971,30,941,6775,5200,1575,4743,3252,1491,897,182,76,3588
6/1/2015,VA,Virginia,James City,51095,18144,16023,2121,17012,51,16961,1132,42,1090,16734,14617,2117,10178,8381,1797,852,196,44,9086
6/1/2015,VA,Virginia,King and Queen,51097,1620,1371,249,1350,*,*,270,*,*,1507,1258,249,1118,894,224,267,*,*,768
6/1/2015,VA,Virginia,King George,51099,3401,3075,326,2910,19,2891,491,20,471,2948,2622,326,1450,1145,305,426,86,19,919
6/1/2015,VA,Virginia,King William,51101,2983,2567,416,2533,17,2516,450,25,425,2750,2334,416,2122,1761,361,369,88,21,1644
6/1/2015,VA,Virginia,Lancaster,51103,4163,3603,560,3816,17,3799,347,*,*,3975,3415,560,2736,2336,400,487,83,30,2136
6/1/2015,VA,Virginia,Lee,51105,6277,4167,2110,4164,12,4152,2113,14,2099,5963,3857,2106,4752,2771,1981,1924,250,79,2499
6/1/2015,VA,Virginia,Lexington City,51678,1586,1424,162,1438,15,1423,148,*,*,1481,1319,162,1107,967,140,219,*,*,850
6/1/2015,VA,Virginia,Loudoun,51107,30675,26663,4012,28447,99,28348,2228,105,2123,25417,21412,4005,15633,12049,3584,2608,581,137,12307
6/1/2015,VA,Virginia,Louisa,51109,7085,5907,1178,5885,39,5846,1200,35,1165,6501,5323,1178,4676,3598,1078,1032,252,66,3326
6/1/2015,VA,Virginia,Lunenburg,51111,2919,2500,419,2362,17,2345,557,21,536,2688,2269,419,1992,1600,392,684,124,43,1141
6/1/2015,VA,Virginia,Lynchburg City,51680,14230,12174,2056,11228,91,11137,3002,109,2893,13242,11187,2055,10555,8695,1860,3231,432,146,6746
6/1/2015,VA,Virginia,Madison,51113,2786,2409,377,2443,12,2431,343,*,*,2593,2216,377,1848,1505,343,383,90,25,1350
6/1/2015,VA,Virginia,Manassas City,51683,4013,3379,634,3459,29,3430,554,32,522,3384,2751,633,2245,1652,593,502,93,32,1618
6/1/2015,VA,Virginia,Manassas Park City,51685,1100,906,194,938,11,927,162,13,149,913,720,193,612,432,180,151,48,12,401
6/1/2015,VA,Virginia,Martinsville City,51690,3898,3052,846,2924,18,2906,974,37,937,3724,2878,846,3196,2509,687,1290,168,60,1678
6/1/2015,VA,Virginia,Mathews,51115,2726,2349,377,2500,*,*,226,*,*,2587,2210,377,1706,1380,326,255,48,18,1385
6/1/2015,VA,Virginia,Mecklenburg,51117,8882,7445,1437,7252,50,7202,1630,54,1576,8379,6944,1435,6474,5309,1165,1898,372,122,4082
6/1/2015,VA,Virginia,Middlesex,51119,3383,2866,517,3015,21,2994,368,*,*,3179,2662,517,2342,1939,403,408,85,26,1823
6/1/2015,VA,Virginia,Montgomery,51121,12789,10580,2209,10448,39,10409,2341,33,2308,11634,9425,2209,9206,7122,2084,1799,295,122,6990
6/1/2015,VA,Virginia,Nelson,51125,4175,3608,567,3629,17,3612,546,15,531,3852,3285,567,2766,2244,522,604,99,42,2021
6/1/2015,VA,Virginia,New Kent,51127,3755,3117,638,3311,16,3295,444,11,433,3434,2796,638,2335,1823,512,289,76,21,1949
6/1/2015,VA,Virginia,Newport News City,51700,26094,19966,6128,21333,167,21166,4761,242,4519,23932,17807,6125,15136,9243,5893,4356,769,224,9787
6/1/2015,VA,Virginia,Norfolk City,51710,30572,23495,7077,24110,255,23855,6462,353,6109,27538,20461,7077,17864,11060,6804,6737,1242,275,9610
6/1/2015,VA,Virginia,Northampton,51131,3381,2857,524,2852,29,2823,529,32,497,3163,2639,524,2485,2005,480,883,91,38,1473
6/1/2015,VA,Virginia,Northumberland,51133,4507,3948,559,4155,14,4141,352,*,*,4221,3662,559,2681,2319,362,423,97,34,2127
6/1/2015,VA,Virginia,Norton City,51720,1171,866,305,769,*,*,402,*,*,1079,775,304,846,561,285,356,49,19,422
6/1/2015,VA,Virginia,Nottoway,51135,3524,2881,643,2849,28,2821,675,20,655,3265,2622,643,2505,2018,487,904,129,43,1429
6/1/2015,VA,Virginia,Orange,51137,8158,7173,985,7146,41,7105,1012,37,975,7494,6510,984,4708,3882,826,935,232,63,3478
6/1/2015,VA,Virginia,Page,51139,5842,5143,699,4706,19,4687,1136,17,1119,5468,4769,699,3939,3329,610,1137,210,85,2507
6/1/2015,VA,Virginia,Patrick,51141,5016,3808,1208,4095,13,4082,921,16,905,4787,3580,1207,3816,2789,1027,985,197,79,2555
6/1/2015,VA,Virginia,Petersburg City,51730,7025,5398,1627,5124,98,5026,1901,90,1811,6427,4800,1627,4519,2944,1575,1958,357,73,2131
6/1/2015,VA,Virginia,Pittsylvania,51143,15227,12504,2723,12321,106,12215,2906,83,2823,14428,11705,2723,11662,9270,2392,3042,563,211,7846
6/1/2015,VA,Virginia,Poquoson City,51735,2400,2128,272,2219,*,*,181,0,181,2186,1914,272,1052,803,249,101,*,*,913
6/1/2015,VA,Virginia,Portsmouth City,51740,17384,13227,4157,13288,192,13096,4096,209,3887,15525,11368,4157,9940,5957,3983,3797,660,156,5327
6/1/2015,VA,Virginia,Powhatan,51145,5251,4211,1040,4640,23,4617,611,15,596,4806,3766,1040,3674,2740,934,377,100,34,3163
6/1/2015,VA,Virginia,Prince Edward,51147,4391,3612,779,3478,27,3451,913,33,880,4091,3312,779,3097,2465,632,1041,168,42,1846
6/1/2015,VA,Virginia,Prince George,51149,5295,4609,686,4435,26,4409,860,22,838,4901,4215,686,2779,2148,631,518,108,26,2127
6/1/2015,VA,Virginia,Prince William,51153,41104,34476,6628,36335,229,36106,4769,290,4479,34963,28339,6624,19225,13076,6149,4498,925,186,13616
6/1/2015,VA,Virginia,Pulaski,51155,8779,7188,1591,6819,24,6795,1960,32,1928,8188,6597,1591,6229,4726,1503,1655,334,119,4121
6/1/2015,VA,Virginia,Radford City,51750,1969,1606,363,1575,*,*,394,*,*,1804,1441,363,1474,1130,344,321,44,27,1082
6/1/2015,VA,Virginia,Rappahannock,51157,1885,1738,147,1723,*,*,162,*,*,1703,1556,147,1073,952,121,157,39,12,865
6/1/2015,VA,Virginia,Richmond,51159,1832,1479,353,1577,14,1563,255,13,242,1725,1372,353,1230,978,252,293,90,22,825
6/1/2015,VA,Virginia,Richmond City,51760,31608,22224,9384,24316,262,24054,7292,354,6938,28411,19027,9384,23007,14010,8997,8227,1396,320,13064
6/1/2015,VA,Virginia,Roanoke,51161,21898,17741,4157,19218,89,19129,2680,51,2629,20290,16133,4157,15582,11785,3797,1924,417,148,13093
6/1/2015,VA,Virginia,Roanoke City,51770,19616,14496,5120,14435,117,14318,5181,150,5031,17991,12873,5118,14247,9355,4892,4709,799,219,8520
6/1/2015,VA,Virginia,Rockbridge,51163,5608,4722,886,4705,20,4685,903,*,*,5221,4335,886,3821,3083,738,816,172,63,2770
6/1/2015,VA,Virginia,Rockingham,51165,15949,13479,2470,13872,47,13825,2077,48,2029,14739,12270,2469,11117,9316,1801,1753,484,147,8733
6/1/2015,VA,Virginia,Russell,51167,7671,5324,2347,5057,12,5045,2614,*,*,7325,4978,2347,6144,4210,1934,1730,304,127,3983
6/1/2015,VA,Virginia,Salem City,51775,5814,4767,1047,4872,27,4845,942,19,923,5319,4272,1047,4112,3146,966,816,140,40,3116
6/1/2015,VA,Virginia,Scott,51169,6464,3359,3105,4777,15,4762,1687,11,1676,6192,3087,3105,5310,2263,3047,1535,249,111,3415
6/1/2015,VA,Virginia,Shenandoah,51171,9777,8679,1098,8552,18,8534,1225,27,1198,9152,8054,1098,6144,5239,905,1238,239,103,4564
6/1/2015,VA,Virginia,Smyth,51173,8651,6843,1808,6333,19,6314,2318,27,2291,8160,6352,1808,6519,4893,1626,2145,398,160,3816
6/1/2015,VA,Virginia,Southampton,51175,3884,3275,609,3205,25,3180,679,27,652,3624,3015,609,2784,2244,540,721,138,33,1892
6/1/2015,VA,Virginia,Spotsylvania,51177,18102,15941,2161,15548,107,15441,2554,95,2459,16097,13937,2160,9440,7551,1889,1806,475,119,7040
6/1/2015,VA,Virginia,Stafford,51179,14643,13266,1377,12751,72,12679,1892,94,1798,12816,11440,1376,6288,5090,1198,1203,348,78,4659
6/1/2015,VA,Virginia,Staunton City,51790,5792,5138,654,4686,22,4664,1106,28,1078,5433,4779,654,4169,3620,549,1061,159,49,2900
6/1/2015,VA,Virginia,Suffolk City,51800,14335,11667,2668,11557,82,11475,2778,92,2686,13065,10398,2667,8747,6311,2436,2589,402,107,5649
6/1/2015,VA,Virginia,Surry,51181,1453,1109,344,1207,11,1196,246,13,233,1347,1003,344,962,638,324,217,67,14,664
6/1/2015,VA,Virginia,Sussex,51183,2298,1816,482,1844,34,1810,454,*,*,2138,1656,482,1616,1163,453,473,137,25,981
6/1/2015,VA,Virginia,Tazewell,51185,11513,8438,3075,8316,40,8276,3197,37,3160,10893,7820,3073,8500,6519,1981,2186,431,170,5713
6/1/2015,VA,Virginia,Unknown,51999,*,*,*,*,*,*,*,*,*,*,*,*,*,*,*,*,*,*,*
6/1/2015,VA,Virginia,Virginia Beach City,51810,63493,53516,9977,55596,308,55288,7897,327,7570,57933,47962,9971,31550,22266,9284,6312,1276,336,23626
6/1/2015,VA,Virginia,Warren,51187,6786,6128,658,5738,20,5718,1048,27,1021,6164,5506,658,4009,3453,556,849,222,66,2872
6/1/2015,VA,Virginia,Washington,51191,14453,9973,4480,11316,57,11259,3137,21,3116,13608,9129,4479,10760,6630,4130,2510,512,180,7558
6/1/2015,VA,Virginia,Waynesboro City,51820,4674,3983,691,3805,20,3785,869,23,846,4373,3682,691,3408,2803,605,864,101,47,2396
6/1/2015,VA,Virginia,Westmoreland,51193,4597,4003,594,4004,25,3979,593,*,*,4191,3597,594,2559,2054,505,738,125,41,1655
6/1/2015,VA,Virginia,Williamsburg City,51830,2381,2047,334,2183,*,*,198,*,*,2158,1825,333,1461,1171,290,205,*,*,1223
6/1/2015,VA,Virginia,Winchester City,51840,4863,4365,498,4132,18,4114,731,18,713,4419,3921,498,3100,2668,432,794,123,42,2141
6/1/2015,VA,Virginia,Wise,51195,10255,6904,3351,6644,14,6630,3611,19,3592,9651,6301,3350,7484,4338,3146,2376,483,161,4464
6/1/2015,VA,Virginia,Wythe,51197,7296,5880,1416,5596,28,5568,1700,24,1676,6894,5478,1416,5275,4061,1214,1476,281,99,3419
6/1/2015,VA,Virginia,York,51199,10726,9437,1289,9803,49,9754,923,32,891,9805,8516,1289,5064,3870,1194,644,159,39,4222
3/1/2015,VA,Virginia,Accomack,51001,8264,7104,1160,7027,46,6981,1237,43,1194,7735,6575,1160,5565,4568,997,1505,370,86,3604
3/1/2015,VA,Virginia,Albemarle,51003,17892,15956,1936,16336,65,16271,1556,57,1499,16063,14127,1936,11820,10084,1736,1445,287,85,10003
3/1/2015,VA,Virginia,Alexandria City,51510,15833,14138,1695,14437,80,14357,1396,94,1302,12801,11108,1693,7220,5650,1570,1930,332,75,4883
3/1/2015,VA,Virginia,Alleghany,51005,4438,3784,654,3556,20,3536,882,13,869,4200,3546,654,3313,2789,524,827,110,50,2326
3/1/2015,VA,Virginia,Amelia,51007,2866,2215,651,2377,11,2366,489,13,476,2652,2001,651,2014,1416,598,474,85,32,1423
3/1/2015,VA,Virginia,Amherst,51009,7289,6168,1121,5979,47,5932,1310,38,1272,6774,5653,1121,5374,4339,1035,1145,240,80,3909
3/1/2015,VA,Virginia,Appomattox,51011,3670,3121,549,2961,23,2938,709,19,690,3452,2903,549,2737,2238,499,680,104,53,1900
3/1/2015,VA,Virginia,Arlington,51013,21816,19512,2304,20188,84,20104,1628,84,1544,17420,15116,2304,9773,7646,2127,2803,334,131,6505
3/1/2015,VA,Virginia,Augusta,51015,16565,14207,2358,14163,56,14107,2402,37,2365,15519,13161,2358,11592,9622,1970,1789,384,151,9268
3/1/2015,VA,Virginia,Bath,51017,1261,1140,121,1105,*,*,156,*,*,1181,1060,121,916,810,106,200,33,19,664
3/1/2015,VA,Virginia,Bedford,51019,17995,14750,3245,15197,73,15124,2798,50,2748,16802,13560,3242,12773,10109,2664,1946,470,161,10196
3/1/2015,VA,Virginia,Bland,51021,1703,1350,353,1331,*,*,372,*,*,1608,1255,353,1196,930,266,242,58,18,878
3/1/2015,VA,Virginia,Botetourt,51023,7885,6146,1739,6765,37,6728,1120,15,1105,7283,5544,1739,5587,4001,1586,825,168,59,4535
3/1/2015,VA,Virginia,Bristol City,51520,4375,2684,1691,3395,*,*,980,11,969,4105,2414,1691,3389,1747,1642,975,168,55,2191
3/1/2015,VA,Virginia,Brunswick,51025,3805,3111,694,3079,30,3049,726,29,697,3585,2891,694,2800,2173,627,1077,112,45,1566
3/1/2015,VA,Virginia,Buchanan,51027,7317,4623,2694,4455,17,4438,2862,13,2849,7021,4328,2693,5716,3844,1872,1591,429,115,3581
3/1/2015,VA,Virginia,Buckingham,51029,3272,2628,644,2634,14,2620,638,13,625,3037,2393,644,2304,1753,551,696,148,46,1414
3/1/2015,VA,Virginia,Buena Vista City,51530,1414,1144,270,1133,*,*,281,*,*,1320,1050,270,1021,795,226,325,57,18,621
3/1/2015,VA,Virginia,Campbell,51031,12007,10119,1888,9822,75,9747,2185,66,2119,11267,9379,1888,8916,7194,1722,2015,375,187,6339
3/1/2015,VA,Virginia,Caroline,51033,5249,4335,914,4365,36,4329,884,37,847,4765,3851,914,3152,2334,818,729,239,55,2129
3/1/2015,VA,Virginia,Carroll,51035,7705,6637,1068,6119,23,6096,1586,21,1565,7318,6250,1068,5605,4752,853,1631,273,118,3583
3/1/2015,VA,Virginia,Charles City,51036,1715,1323,392,1440,18,1422,275,12,263,1592,1200,392,1191,866,325,260,83,17,831
3/1/2015,VA,Virginia,Charlotte,51037,3239,2747,492,2619,19,2600,620,12,608,3051,2559,492,2367,1928,439,770,128,54,1415
3/1/2015,VA,Virginia,Charlottesville City,51540,5812,5092,720,4680,23,4657,1132,45,1087,5227,4508,719,4118,3432,686,1183,159,52,2724
3/1/2015,VA,Virginia,Chesapeake City,51550,33274,27167,6107,28277,240,28037,4997,238,4759,29941,23834,6107,17724,12060,5664,3756,844,238,12886
3/1/2015,VA,Virginia,Chesterfield,51041,51265,40025,11240,44211,186,44025,7054,221,6833,46070,34832,11238,34000,23732,10268,4672,970,268,28090
3/1/2015,VA,Virginia,Clarke,51043,2849,2545,304,2596,15,2581,253,*,*,2575,2271,304,1682,1430,252,252,75,31,1324
3/1/2015,VA,Virginia,Colonial Heights City,51570,4106,3556,550,3537,*,*,569,14,555,3764,3214,550,2295,1791,504,440,101,24,1730
3/1/2015,VA,Virginia,Covington City,51580,1668,1433,235,1294,*,*,374,*,*,1550,1315,235,1205,983,222,347,56,19,783
3/1/2015,VA,Virginia,Craig,51045,1243,984,259,956,*,*,287,*,*,1141,882,259,887,631,256,195,39,14,639
3/1/2015,VA,Virginia,Culpeper,51047,8225,7150,1075,7040,54,6986,1185,37,1148,7494,6419,1075,4986,4026,960,1076,249,71,3590
3/1/2015,VA,Virginia,Cumberland,51049,2138,1663,475,1752,11,1741,386,*,*,1990,1517,473,1518,1086,432,417,80,30,991
3/1/2015,VA,Virginia,Danville City,51590,11009,9240,1769,8596,82,8514,2413,117,2296,10444,8675,1769,8561,7268,1293,3133,452,176,4800
3/1/2015,VA,Virginia,Dickenson,51051,4680,3116,1564,2818,*,*,1862,13,1849,4453,2889,1564,3568,2187,1381,1080,225,92,2171
3/1/2015,VA,Virginia,Dinwiddie,51053,5394,4311,1083,4298,35,4263,1096,32,1064,4942,3859,1083,3558,2519,1039,874,183,54,2447
3/1/2015,VA,Virginia,Emporia City,51595,1148,849,299,882,14,868,266,15,251,1080,781,299,869,621,248,418,62,12,377
3/1/2015,VA,Virginia,Essex,51057,2686,2221,465,2289,17,2272,397,15,382,2505,2040,465,1854,1477,377,419,93,25,1317
3/1/2015,VA,Virginia,Fairfax,51059,132508,115938,16570,124562,541,124021,7946,398,7548,107182,90642,16540,57509,42299,15210,12452,2507,464,42086
3/1/2015,VA,Virginia,Fairfax City,51600,3526,3063,463,3236,14,3222,290,12,278,2975,2512,463,1634,1204,430,389,52,17,1176
3/1/2015,VA,Virginia,Falls Church City,51610,1689,1475,214,1603,*,*,86,*,*,1338,1125,213,753,561,192,131,*,*,600
3/1/2015,VA,Virginia,Fauquier,51061,10962,9964,998,9896,43,9853,1066,36,1030,9700,8703,997,5817,4967,850,853,193,53,4718
3/1/2015,VA,Virginia,Floyd,51063,3706,2982,724,3170,13,3157,536,*,*,3465,2741,724,2666,2003,663,524,92,51,1999
3/1/2015,VA,Virginia,Fluvanna,51065,5286,4569,717,4734,27,4707,552,22,530,4834,4117,717,3419,2783,636,457,118,21,2823
3/1/2015,VA,Virginia,Franklin,51067,13516,10042,3474,11096,41,11055,2420,22,2398,12697,9223,3474,10107,6795,3312,1907,467,161,7572
3/1/2015,VA,Virginia,Franklin City,51620,1852,1565,287,1435,18,1417,417,16,401,1746,1459,287,1412,1150,262,521,81,20,790
3/1/2015,VA,Virginia,Frederick,51069,14269,12635,1634,12567,47,12520,1702,45,1657,13029,11397,1632,8655,7267,1388,1366,351,126,6812
3/1/2015,VA,Virginia,Fredericksburg City,51630,3697,3273,424,3016,15,3001,681,29,652,3320,2896,424,2179,1781,398,719,80,41,1339
3/1/2015,VA,Virginia,Galax City,51640,1937,1810,127,1486,*,*,451,*,*,1837,1710,127,1442,1341,101,670,69,34,669
3/1/2015,VA,Virginia,Giles,51071,4397,3257,1140,3451,20,3431,946,13,933,4133,2994,1139,3349,2330,1019,761,140,38,2410
3/1/2015,VA,Virginia,Gloucester,51073,7657,6442,1215,6531,31,6500,1126,20,1106,7023,5808,1215,4360,3257,1103,890,185,55,3230
3/1/2015,VA,Virginia,Goochland,51075,4955,4021,934,4470,22,4448,485,17,468,4499,3565,934,3520,2718,802,404,102,37,2977
3/1/2015,VA,Virginia,Grayson,51077,4469,3945,524,3619,11,3608,850,*,*,4290,3766,524,3158,2726,432,999,179,82,1898
3/1/2015,VA,Virginia,Greene,51079,3305,2868,437,2875,13,2862,430,11,419,3022,2585,437,2128,1725,403,404,76,22,1626
3/1/2015,VA,Virginia,Greensville,51081,2378,1760,618,1869,23,1846,509,21,488,2211,1593,618,1812,1260,552,556,124,27,1105
3/1/2015,VA,Virginia,Halifax,51083,9242,8045,1197,7449,60,7389,1793,69,1724,8687,7491,1196,6948,5860,1088,2160,444,134,4210
3/1/2015,VA,Virginia,Hampton City,51650,23137,17947,5190,18871,203,18668,4266,210,4056,21147,15957,5190,12546,7568,4978,3389,767,188,8202
3/1/2015,VA,Virginia,Hanover,51085,18373,14532,3841,16532,73,16459,1841,51,1790,16720,12879,3841,12779,9489,3290,1336,363,100,10980
3/1/2015,VA,Virginia,Harrisonburg City,51660,4972,4395,577,4162,20,4142,810,23,787,4541,3964,577,3487,3055,432,924,119,39,2405
3/1/2015,VA,Virginia,Henrico,51087,50429,38798,11631,43646,342,43304,6783,295,6488,45670,34040,11630,35151,24990,10161,5684,1338,401,27728
3/1/2015,VA,Virginia,Henry,51089,14821,10778,4043,11630,74,11556,3191,63,3128,14134,10091,4043,11864,8681,3183,3069,687,244,7864
3/1/2015,VA,Virginia,Highland,51091,708,641,67,652,*,*,56,*,*,668,601,67,484,422,62,67,*,*,395
3/1/2015,VA,Virginia,Hopewell City,51670,4343,3523,820,3342,29,3313,1001,32,969,4045,3225,820,2704,1907,797,924,156,40,1584
3/1/2015,VA,Virginia,Isle of Wight,51093,7258,5677,1581,6305,38,6267,953,28,925,6736,5155,1581,4716,3220,1496,882,187,79,3568
3/1/2015,VA,Virginia,James City,51095,18019,15887,2132,16905,54,16851,1114,39,1075,16643,14515,2128,10122,8314,1808,836,194,46,9046
3/1/2015,VA,Virginia,King and Queen,51097,1602,1352,250,1340,*,*,262,*,*,1495,1245,250,1113,887,226,266,*,*,762
3/1/2015,VA,Virginia,King George,51099,3367,3030,337,2889,19,2870,478,20,458,2928,2591,337,1445,1130,315,425,84,21,915
3/1/2015,VA,Virginia,King William,51101,2959,2541,418,2523,17,2506,436,25,411,2724,2306,418,2111,1747,364,367,85,22,1637
3/1/2015,VA,Virginia,Lancaster,51103,4152,3594,558,3811,18,3793,341,11,330,3970,3412,558,2737,2338,399,486,86,31,2134
3/1/2015,VA,Virginia,Lee,51105,6274,4175,2099,4191,15,4176,2083,15,2068,5961,3865,2096,4761,2793,1968,1914,251,81,2515
3/1/2015,VA,Virginia,Lexington City,51678,1591,1423,168,1444,16,1428,147,*,*,1490,1322,168,1115,969,146,222,*,*,854
3/1/2015,VA,Virginia,Loudoun,51107,30329,26362,3967,28155,100,28055,2174,103,2071,25180,21220,3960,15444,11917,3527,2518,588,139,12199
3/1/2015,VA,Virginia,Louisa,51109,7020,5817,1203,5841,38,5803,1179,34,1145,6453,5250,1203,4642,3541,1101,1009,256,68,3309
3/1/2015,VA,Virginia,Lunenburg,51111,2906,2478,428,2355,18,2337,551,21,530,2676,2248,428,1974,1575,399,665,120,42,1147
3/1/2015,VA,Virginia,Lynchburg City,51680,14180,12121,2059,11207,94,11113,2973,106,2867,13216,11158,2058,10555,8693,1862,3199,444,154,6758
3/1/2015,VA,Virginia,Madison,51113,2759,2377,382,2423,12,2411,336,*,*,2574,2192,382,1831,1480,351,370,88,26,1347
3/1/2015,VA,Virginia,Manassas City,51683,3974,3342,632,3430,29,3401,544,31,513,3358,2727,631,2224,1635,589,488,103,31,1602
3/1/2015,VA,Virginia,Manassas Park City,51685,1083,897,186,927,11,916,156,12,144,903,717,186,607,435,172,147,48,11,401
3/1/2015,VA,Virginia,Martinsville City,51690,3902,3055,847,2939,20,2919,963,39,924,3722,2875,847,3201,2515,686,1279,172,60,1690
3/1/2015,VA,Virginia,Mathews,51115,2712,2330,382,2481,*,*,231,*,*,2566,2184,382,1702,1370,332,257,45,19,1381
3/1/2015,VA,Virginia,Mecklenburg,51117,8865,7413,1452,7246,52,7194,1619,52,1567,8373,6923,1450,6468,5297,1171,1889,363,123,4093
3/1/2015,VA,Virginia,Middlesex,51119,3368,2854,514,3005,20,2985,363,*,*,3165,2651,514,2333,1932,401,405,90,27,1811
3/1/2015,VA,Virginia,Montgomery,51121,12751,10534,2217,10430,43,10387,2321,34,2287,11584,9367,2217,9164,7073,2091,1780,291,118,6975
3/1/2015,VA,Virginia,Nelson,51125,4141,3574,567,3609,18,3591,532,14,518,3823,3256,567,2751,2229,522,596,103,40,2012
3/1/2015,VA,Virginia,New Kent,51127,3737,3098,639,3298,16,3282,439,11,428,3408,2769,639,2300,1787,513,278,74,21,1927
3/1/2015,VA,Virginia,Newport News City,51700,26004,19842,6162,21309,175,21134,4695,236,4459,23832,17673,6159,15141,9218,5923,4303,789,225,9824
3/1/2015,VA,Virginia,Norfolk City,51710,30411,23340,7071,24053,261,23792,6358,355,6003,27433,20362,7071,17824,11025,6799,6585,1281,289,9669
3/1/2015,VA,Virginia,Northampton,51131,3354,2826,528,2841,30,2811,513,32,481,3144,2616,528,2476,1993,483,887,96,41,1452
3/1/2015,VA,Virginia,Northumberland,51133,4491,3919,572,4147,15,4132,344,*,*,4205,3633,572,2671,2300,371,416,96,35,2124
3/1/2015,VA,Virginia,Norton City,51720,1169,863,306,772,*,*,397,*,*,1083,778,305,850,564,286,354,50,20,426
3/1/2015,VA,Virginia,Nottoway,51135,3506,2854,652,2844,28,2816,662,18,644,3254,2602,652,2507,2013,494,904,129,46,1428
3/1/2015,VA,Virginia,Orange,51137,8105,7097,1008,7107,43,7064,998,37,961,7467,6460,1007,4699,3852,847,906,235,71,3487
3/1/2015,VA,Virginia,Page,51139,5820,5123,697,4706,19,4687,1114,16,1098,5453,4756,697,3926,3317,609,1118,217,87,2504
3/1/2015,VA,Virginia,Patrick,51141,5017,3799,1218,4103,13,4090,914,15,899,4793,3576,1217,3827,2791,1036,975,195,80,2577
3/1/2015,VA,Virginia,Petersburg City,51730,6978,5333,1645,5102,99,5003,1876,89,1787,6381,4736,1645,4499,2905,1594,1924,366,87,2122
3/1/2015,VA,Virginia,Pittsylvania,51143,15174,12437,2737,12302,113,12189,2872,83,2789,14391,11654,2737,11672,9268,2404,3024,588,216,7844
3/1/2015,VA,Virginia,Poquoson City,51735,2398,2126,272,2213,*,*,185,0,185,2182,1910,272,1050,802,248,101,27,11,911
3/1/2015,VA,Virginia,Portsmouth City,51740,17299,13164,4135,13267,196,13071,4032,211,3821,15459,11324,4135,9694,5734,3960,3729,689,159,5117
3/1/2015,VA,Virginia,Powhatan,51145,5217,4182,1035,4610,23,4587,607,15,592,4773,3738,1035,3638,2710,928,373,103,34,3128
3/1/2015,VA,Virginia,Prince Edward,51147,4386,3601,785,3485,27,3458,901,32,869,4092,3308,784,3102,2462,640,1027,174,44,1857
3/1/2015,VA,Virginia,Prince George,51149,5253,4561,692,4403,29,4374,850,22,828,4867,4175,692,2775,2139,636,513,110,26,2126
3/1/2015,VA,Virginia,Prince William,51153,40585,33965,6620,35896,239,35657,4689,287,4402,34612,27996,6616,19023,12898,6125,4358,941,189,13535
3/1/2015,VA,Virginia,Pulaski,51155,8754,7163,1591,6821,29,6792,1933,32,1901,8182,6591,1591,6250,4745,1505,1638,333,126,4153
3/1/2015,VA,Virginia,Radford City,51750,1956,1591,365,1565,*,*,391,*,*,1799,1434,365,1472,1126,346,314,46,29,1083
3/1/2015,VA,Virginia,Rappahannock,51157,1878,1729,149,1717,*,*,161,*,*,1698,1549,149,1071,948,123,154,41,12,864
3/1/2015,VA,Virginia,Richmond,51159,1837,1477,360,1586,14,1572,251,11,240,1728,1368,360,1236,975,261,294,91,21,830
3/1/2015,VA,Virginia,Richmond City,51760,31470,22033,9437,24241,285,23956,7229,355,6874,28321,18884,9437,22948,13902,9046,8074,1434,337,13103
3/1/2015,VA,Virginia,Roanoke,51161,21756,17580,4176,19104,99,19005,2652,53,2599,20170,15994,4176,15501,11684,3817,1896,423,148,13034
3/1/2015,VA,Virginia,Roanoke City,51770,19528,14396,5132,14421,122,14299,5107,150,4957,17953,12822,5131,14237,9334,4903,4634,799,231,8573
3/1/2015,VA,Virginia,Rockbridge,51163,5594,4704,890,4707,20,4687,887,*,*,5222,4332,890,3827,3083,744,803,178,65,2781
3/1/2015,VA,Virginia,Rockingham,51165,15875,13368,2507,13826,51,13775,2049,46,2003,14703,12197,2506,11076,9252,1824,1715,495,146,8720
3/1/2015,VA,Virginia,Russell,51167,7646,5318,2328,5056,12,5044,2590,*,*,7298,4970,2328,6106,4192,1914,1705,305,130,3966
3/1/2015,VA,Virginia,Salem City,51775,5803,4734,1069,4871,29,4842,932,20,912,5319,4250,1069,4118,3131,987,816,143,44,3115
3/1/2015,VA,Virginia,Scott,51169,6468,3352,3116,4805,17,4788,1663,12,1651,6192,3076,3116,5320,2262,3058,1530,248,112,3430
3/1/2015,VA,Virginia,Shenandoah,51171,9766,8660,1106,8555,19,8536,1211,29,1182,9155,8049,1106,6173,5259,914,1225,248,103,4597
3/1/2015,VA,Virginia,Smyth,51173,8644,6831,1813,6346,18,6328,2298,29,2269,8162,6349,1813,6514,4884,1630,2117,406,162,3829
3/1/2015,VA,Virginia,Southampton,51175,3869,3248,621,3199,27,3172,670,26,644,3606,2985,621,2767,2214,553,706,142,33,1886
3/1/2015,VA,Virginia,Spotsylvania,51177,17917,15730,2187,15410,114,15296,2507,93,2414,15956,13771,2185,9350,7445,1905,1749,488,125,6988
3/1/2015,VA,Virginia,Stafford,51179,14496,13105,1391,12624,77,12547,1872,95,1777,12700,11310,1390,6268,5054,1214,1180,342,83,4663
3/1/2015,VA,Virginia,Staunton City,51790,5786,5124,662,4693,25,4668,1093,27,1066,5436,4774,662,4174,3620,554,1029,162,56,2927
3/1/2015,VA,Virginia,Suffolk City,51800,14262,11582,2680,11534,87,11447,2728,91,2637,12999,10321,2678,8678,6229,2449,2560,412,114,5592
3/1/2015,VA,Virginia,Surry,51181,1450,1101,349,1209,14,1195,241,13,228,1339,990,349,958,630,328,214,70,13,661
3/1/2015,VA,Virginia,Sussex,51183,2298,1808,490,1844,36,1808,454,*,*,2134,1644,490,1618,1155,463,475,143,22,978
3/1/2015,VA,Virginia,Tazewell,51185,11521,8446,3075,8358,42,8316,3163,37,3126,10891,7818,3073,8448,6478,1970,2166,438,170,5674
3/1/2015,VA,Virginia,Unknown,51999,*,*,*,*,*,*,*,*,*,*,*,*,*,*,*,*,*,*,*
3/1/2015,VA,Virginia,Virginia Beach City,51810,63045,53096,9949,55269,316,54953,7776,327,7449,57619,47675,9944,31412,22169,9243,6170,1302,343,23597
3/1/2015,VA,Virginia,Warren,51187,6726,6075,651,5703,22,5681,1023,24,999,6131,5480,651,3983,3429,554,821,234,64,2864
3/1/2015,VA,Virginia,Washington,51191,14420,9947,4473,11310,58,11252,3110,21,3089,13592,9120,4472,10758,6637,4121,2473,525,187,7573
3/1/2015,VA,Virginia,Waynesboro City,51820,4671,3980,691,3805,20,3785,866,24,842,4386,3695,691,3425,2818,607,857,102,50,2416
3/1/2015,VA,Virginia,Westmoreland,51193,4586,3991,595,3994,28,3966,592,11,581,4198,3603,595,2580,2074,506,723,131,42,1684
3/1/2015,VA,Virginia,Williamsburg City,51830,2370,2027,343,2175,11,2164,195,*,*,2152,1810,342,1459,1159,300,198,*,*,1227
3/1/2015,VA,Virginia,Winchester City,51840,4836,4329,507,4126,19,4107,710,19,691,4407,3900,507,3080,2640,440,779,123,41,2137
3/1/2015,VA,Virginia,Wise,51195,10264,6929,3335,6679,15,6664,3585,19,3566,9664,6330,3334,7499,4375,3124,2352,493,163,4491
3/1/2015,VA,Virginia,Wythe,51197,7274,5865,1409,5604,30,5574,1670,25,1645,6882,5473,1409,5270,4064,1206,1456,286,105,3423
3/1/2015,VA,Virginia,York,51199,10649,9351,1298,9752,49,9703,897,31,866,9737,8441,1296,5052,3850,1202,626,165,46,4215
5/1/2015,VA,Virginia,Accomack,51001,8271,7117,1154,7030,42,6988,1241,44,1197,7734,6580,1154,5553,4564,989,1504,365,89,3595
5/1/2015,VA,Virginia,Albemarle,51003,17931,16005,1926,16372,62,16310,1559,55,1504,16077,14151,1926,11839,10111,1728,1458,275,86,10020
5/1/2015,VA,Virginia,Alexandria City,51510,15954,14240,1714,14551,76,14475,1403,95,1308,12852,11140,1712,7225,5636,1589,1942,330,71,4882
5/1/2015,VA,Virginia,Alleghany,51005,4438,3792,646,3548,19,3529,890,13,877,4195,3549,646,3327,2809,518,828,108,50,2341
5/1/2015,VA,Virginia,Amelia,51007,2856,2215,641,2366,*,*,490,13,477,2635,1994,641,2006,1416,590,476,87,26,1417
5/1/2015,VA,Virginia,Amherst,51009,7300,6176,1124,5982,45,5937,1318,37,1281,6782,5658,1124,5368,4330,1038,1151,231,78,3908
5/1/2015,VA,Virginia,Appomattox,51011,3680,3128,552,2964,23,2941,716,20,696,3459,2907,552,2741,2238,503,686,101,49,1905
5/1/2015,VA,Virginia,Arlington,51013,21973,19659,2314,20339,81,20258,1634,84,1550,17484,15170,2314,9767,7626,2141,2827,319,122,6499
5/1/2015,VA,Virginia,Augusta,51015,16627,14291,2336,14211,50,14161,2416,38,2378,15568,13232,2336,11621,9666,1955,1799,374,152,9296
5/1/2015,VA,Virginia,Bath,51017,1260,1141,119,1104,*,*,156,*,*,1179,1060,119,921,817,104,198,33,21,669
5/1/2015,VA,Virginia,Bedford,51019,18078,14836,3242,15255,69,15186,2823,50,2773,16866,13627,3239,12795,10138,2657,1960,461,158,10216
5/1/2015,VA,Virginia,Bland,51021,1708,1354,354,1335,*,*,373,*,*,1610,1256,354,1196,929,267,247,55,18,876
5/1/2015,VA,Virginia,Botetourt,51023,7917,6177,1740,6782,36,6746,1135,16,1119,7315,5575,1740,5622,4036,1586,837,169,55,4561
5/1/2015,VA,Virginia,Bristol City,51520,4364,2664,1700,3380,11,3369,984,11,973,4105,2405,1700,3379,1729,1650,971,167,55,2186
5/1/2015,VA,Virginia,Brunswick,51025,3809,3126,683,3081,30,3051,728,29,699,3589,2906,683,2795,2175,620,1085,109,39,1562
5/1/2015,VA,Virginia,Buchanan,51027,7325,4607,2718,4439,14,4425,2886,13,2873,7033,4315,2718,5777,3878,1899,1603,426,109,3639
5/1/2015,VA,Virginia,Buckingham,51029,3281,2648,633,2636,13,2623,645,12,633,3048,2415,633,2308,1769,539,703,143,44,1418
5/1/2015,VA,Virginia,Buena Vista City,51530,1414,1147,267,1130,*,*,284,*,*,1321,1054,267,1018,795,223,329,56,18,615
5/1/2015,VA,Virginia,Campbell,51031,12051,10151,1900,9840,73,9767,2211,65,2146,11302,9402,1900,8937,7208,1729,2039,362,182,6354
5/1/2015,VA,Virginia,Caroline,51033,5266,4353,913,4371,34,4337,895,37,858,4779,3866,913,3158,2339,819,743,238,55,2122
5/1/2015,VA,Virginia,Carroll,51035,7716,6654,1062,6122,23,6099,1594,21,1573,7330,6268,1062,5597,4747,850,1640,271,107,3579
5/1/2015,VA,Virginia,Charles City,51036,1718,1325,393,1439,18,1421,279,12,267,1592,1199,393,1182,856,326,260,81,15,826
5/1/2015,VA,Virginia,Charlotte,51037,3244,2749,495,2620,19,2601,624,11,613,3056,2561,495,2371,1929,442,772,131,53,1415
5/1/2015,VA,Virginia,Charlottesville City,51540,5835,5106,729,4693,23,4670,1142,46,1096,5240,4512,728,4112,3418,694,1197,155,54,2706
5/1/2015,VA,Virginia,Chesapeake City,51550,33351,27244,6107,28305,233,28072,5046,238,4808,29998,23891,6107,17728,12057,5671,3805,826,221,12876
5/1/2015,VA,Virginia,Chesterfield,51041,51596,40315,11281,44454,182,44272,7142,227,6915,46327,35048,11279,34163,23859,10304,4742,947,262,28212
5/1/2015,VA,Virginia,Clarke,51043,2871,2567,304,2616,15,2601,255,*,*,2592,2288,304,1680,1429,251,251,75,32,1322
5/1/2015,VA,Virginia,Colonial Heights City,51570,4105,3554,551,3531,*,*,574,13,561,3765,3214,551,2301,1795,506,457,100,24,1720
5/1/2015,VA,Virginia,Covington City,51580,1664,1433,231,1287,*,*,377,*,*,1550,1319,231,1204,985,219,347,54,20,783
5/1/2015,VA,Virginia,Craig,51045,1239,975,264,951,*,*,288,*,*,1139,875,264,885,624,261,200,37,14,634
5/1/2015,VA,Virginia,Culpeper,51047,8266,7199,1067,7074,51,7023,1192,39,1153,7540,6473,1067,5016,4065,951,1096,254,68,3598
5/1/2015,VA,Virginia,Cumberland,51049,2144,1669,475,1757,*,*,387,*,*,1992,1518,474,1516,1084,432,422,74,31,989
5/1/2015,VA,Virginia,Danville City,51590,11023,9267,1756,8596,79,8517,2427,116,2311,10447,8691,1756,8529,7244,1285,3163,438,162,4766
5/1/2015,VA,Virginia,Dickenson,51051,4671,3084,1587,2804,*,*,1867,13,1854,4446,2859,1587,3573,2164,1409,1085,221,86,2181
5/1/2015,VA,Virginia,Dinwiddie,51053,5405,4330,1075,4307,35,4272,1098,31,1067,4957,3882,1075,3574,2544,1030,883,180,49,2462
5/1/2015,VA,Virginia,Emporia City,51595,1137,857,280,870,13,857,267,14,253,1067,787,280,862,629,233,416,63,12,371
5/1/2015,VA,Virginia,Essex,51057,2690,2230,460,2289,17,2272,401,15,386,2504,2044,460,1839,1466,373,422,89,27,1301
5/1/2015,VA,Virginia,Fairfax,51059,133560,116857,16703,125541,522,125019,8019,398,7621,107847,91173,16674,57862,42513,15349,12640,2484,435,42303
5/1/2015,VA,Virginia,Fairfax City,51600,3516,3056,460,3230,13,3217,286,11,275,2959,2499,460,1628,1200,428,385,51,14,1178
5/1/2015,VA,Virginia,Falls Church City,51610,1698,1485,213,1610,*,*,88,*,*,1344,1132,212,751,560,191,129,*,*,599
5/1/2015,VA,Virginia,Fauquier,51061,11009,10014,995,9932,41,9891,1077,37,1040,9715,8721,994,5828,4981,847,873,193,52,4710
5/1/2015,VA,Virginia,Floyd,51063,3710,2999,711,3173,13,3160,537,*,*,3469,2758,711,2673,2020,653,527,93,47,2006
5/1/2015,VA,Virginia,Fluvanna,51065,5320,4600,720,4762,27,4735,558,24,534,4856,4136,720,3429,2790,639,463,115,21,2830
5/1/2015,VA,Virginia,Franklin,51067,13552,10081,3471,11117,40,11077,2435,22,2413,12722,9251,3471,10099,6791,3308,1915,463,154,7567
5/1/2015,VA,Virginia,Franklin City,51620,1851,1558,293,1433,18,1415,418,17,401,1745,1452,293,1415,1148,267,531,75,18,791
5/1/2015,VA,Virginia,Frederick,51069,14310,12679,1631,12590,45,12545,1720,44,1676,13068,11439,1629,8665,7279,1386,1392,340,122,6811
5/1/2015,VA,Virginia,Fredericksburg City,51630,3695,3280,415,3011,15,2996,684,30,654,3321,2906,415,2175,1786,389,718,81,44,1332
5/1/2015,VA,Virginia,Galax City,51640,1932,1811,121,1480,*,*,452,*,*,1827,1706,121,1430,1334,96,673,63,33,661
5/1/2015,VA,Virginia,Giles,51071,4412,3273,1139,3459,18,3441,953,13,940,4147,3009,1138,3352,2336,1016,766,134,37,2415
5/1/2015,VA,Virginia,Gloucester,51073,7668,6467,1201,6537,29,6508,1131,22,1109,7031,5830,1201,4364,3274,1090,899,174,49,3242
5/1/2015,VA,Virginia,Goochland,51075,4980,4047,933,4496,21,4475,484,17,467,4530,3597,933,3545,2747,798,410,101,35,2999
5/1/2015,VA,Virginia,Grayson,51077,4474,3950,524,3611,*,*,863,*,*,4290,3766,524,3155,2723,432,1000,182,85,1888
5/1/2015,VA,Virginia,Greene,51079,3325,2887,438,2887,13,2874,438,11,427,3030,2592,438,2129,1724,405,406,74,22,1627
5/1/2015,VA,Virginia,Greensville,51081,2382,1774,608,1868,23,1845,514,22,492,2215,1607,608,1812,1268,544,567,124,24,1097
5/1/2015,VA,Virginia,Halifax,51083,9262,8065,1197,7456,57,7399,1806,71,1735,8704,7508,1196,6954,5866,1088,2167,438,125,4224
5/1/2015,VA,Virginia,Hampton City,51650,23214,18037,5177,18901,193,18708,4313,208,4105,21206,16029,5177,12535,7569,4966,3444,753,175,8163
5/1/2015,VA,Virginia,Hanover,51085,18454,14607,3847,16583,72,16511,1871,51,1820,16772,12925,3847,12814,9526,3288,1351,360,97,11006
5/1/2015,VA,Virginia,Harrisonburg City,51660,4978,4401,577,4166,20,4146,812,21,791,4536,3959,577,3491,3059,432,927,128,37,2399
5/1/2015,VA,Virginia,Henrico,51087,50579,38964,11615,43728,325,43403,6851,297,6554,45747,34133,11614,35175,25030,10145,5751,1299,384,27741
5/1/2015,VA,Virginia,Henry,51089,14843,10800,4043,11631,72,11559,3212,62,3150,14133,10090,4043,11851,8657,3194,3114,667,231,7839
5/1/2015,VA,Virginia,Highland,51091,705,639,66,648,*,*,57,*,*,665,599,66,480,419,61,65,*,*,393
5/1/2015,VA,Virginia,Hopewell City,51670,4348,3532,816,3344,28,3316,1004,32,972,4050,3234,816,2696,1903,793,922,156,37,1581
5/1/2015,VA,Virginia,Isle of Wight,51093,7290,5716,1574,6320,37,6283,970,30,940,6764,5190,1574,4726,3236,1490,889,185,73,3579
5/1/2015,VA,Virginia,James City,51095,18098,15972,2126,16973,52,16921,1125,40,1085,16696,14574,2122,10148,8345,1803,851,197,44,9056
5/1/2015,VA,Virginia,King and Queen,51097,1610,1364,246,1345,*,*,265,*,*,1500,1254,246,1111,890,221,265,*,*,763
5/1/2015,VA,Virginia,King George,51099,3381,3054,327,2895,19,2876,486,20,466,2933,2606,327,1441,1136,305,421,87,20,913
5/1/2015,VA,Virginia,King William,51101,2968,2551,417,2522,18,2504,446,25,421,2738,2321,417,2112,1750,362,368,86,21,1637
5/1/2015,VA,Virginia,Lancaster,51103,4154,3594,560,3811,17,3794,343,*,*,3967,3407,560,2735,2334,401,486,82,29,2138
5/1/2015,VA,Virginia,Lee,51105,6288,4184,2104,4189,14,4175,2099,15,2084,5971,3871,2100,4755,2781,1974,1926,249,79,2501
5/1/2015,VA,Virginia,Lexington City,51678,1582,1421,161,1434,15,1419,148,*,*,1479,1318,161,1106,967,139,220,*,*,848
5/1/2015,VA,Virginia,Loudoun,51107,30536,26552,3984,28328,99,28229,2208,103,2105,25319,21342,3977,15529,11979,3550,2573,584,136,12236
5/1/2015,VA,Virginia,Louisa,51109,7051,5864,1187,5859,39,5820,1192,34,1158,6473,5286,1187,4644,3558,1086,1026,248,65,3305
5/1/2015,VA,Virginia,Lunenburg,51111,2915,2492,423,2360,18,2342,555,21,534,2678,2255,423,1980,1586,394,673,122,43,1142
5/1/2015,VA,Virginia,Lynchburg City,51680,14209,12149,2060,11222,91,11131,2987,109,2878,13221,11162,2059,10541,8678,1863,3213,432,148,6748
5/1/2015,VA,Virginia,Madison,51113,2775,2400,375,2434,12,2422,341,*,*,2586,2211,375,1841,1499,342,380,89,25,1347
5/1/2015,VA,Virginia,Manassas City,51683,3990,3353,637,3439,29,3410,551,32,519,3373,2737,636,2227,1632,595,501,95,32,1599
5/1/2015,VA,Virginia,Manassas Park City,51685,1096,909,187,935,11,924,161,13,148,907,720,187,609,436,173,151,48,12,398
5/1/2015,VA,Virginia,Martinsville City,51690,3907,3060,847,2932,19,2913,975,38,937,3731,2884,847,3199,2513,686,1293,167,60,1679
5/1/2015,VA,Virginia,Mathews,51115,2717,2338,379,2490,*,*,227,*,*,2576,2197,379,1696,1367,329,256,46,18,1376
5/1/2015,VA,Virginia,Mecklenburg,51117,8871,7429,1442,7244,50,7194,1627,54,1573,8375,6935,1440,6465,5297,1168,1896,368,121,4080
5/1/2015,VA,Virginia,Middlesex,51119,3379,2864,515,3012,20,2992,367,*,*,3174,2659,515,2341,1939,402,407,85,25,1824
5/1/2015,VA,Virginia,Montgomery,51121,12774,10567,2207,10447,39,10408,2327,33,2294,11611,9404,2207,9176,7094,2082,1793,291,122,6970
5/1/2015,VA,Virginia,Nelson,51125,4164,3600,564,3622,17,3605,542,16,526,3841,3277,564,2759,2240,519,598,100,42,2019
5/1/2015,VA,Virginia,New Kent,51127,3748,3106,642,3308,16,3292,440,11,429,3424,2782,642,2324,1808,516,284,74,21,1945
5/1/2015,VA,Virginia,Newport News City,51700,26061,19918,6143,21328,168,21160,4733,240,4493,23897,17757,6140,15108,9203,5905,4345,765,221,9777
5/1/2015,VA,Virginia,Norfolk City,51710,30493,23427,7066,24078,257,23821,6415,352,6063,27479,20413,7066,17810,11018,6792,6680,1247,276,9607
5/1/2015,VA,Virginia,Northampton,51131,3374,2854,520,2845,29,2816,529,32,497,3160,2640,520,2478,2002,476,884,92,40,1462
5/1/2015,VA,Virginia,Northumberland,51133,4501,3938,563,4154,14,4140,347,*,*,4214,3651,563,2679,2314,365,420,96,34,2129
5/1/2015,VA,Virginia,Norton City,51720,1164,860,304,766,*,*,398,*,*,1076,773,303,845,561,284,352,50,19,424
5/1/2015,VA,Virginia,Nottoway,51135,3519,2863,656,2847,28,2819,672,20,652,3260,2604,656,2505,2005,500,906,129,44,1426
5/1/2015,VA,Virginia,Orange,51137,8137,7147,990,7130,42,7088,1007,38,969,7481,6492,989,4698,3868,830,923,232,66,3477
5/1/2015,VA,Virginia,Page,51139,5829,5125,704,4698,19,4679,1131,17,1114,5458,4754,704,3928,3313,615,1130,206,85,2507
5/1/2015,VA,Virginia,Patrick,51141,5022,3806,1216,4102,13,4089,920,16,904,4794,3579,1215,3816,2781,1035,973,196,76,2571
5/1/2015,VA,Virginia,Petersburg City,51730,7008,5388,1620,5114,98,5016,1894,90,1804,6406,4786,1620,4509,2942,1567,1945,361,73,2130
5/1/2015,VA,Virginia,Pittsylvania,51143,15204,12468,2736,12312,106,12206,2892,84,2808,14411,11675,2736,11650,9248,2402,3031,568,210,7841
5/1/2015,VA,Virginia,Poquoson City,51735,2398,2125,273,2216,*,*,182,0,182,2181,1908,273,1049,799,250,101,*,*,909
5/1/2015,VA,Virginia,Portsmouth City,51740,17335,13172,4163,13266,194,13072,4069,209,3860,15477,11314,4163,9895,5908,3987,3765,661,154,5315
5/1/2015,VA,Virginia,Powhatan,51145,5232,4196,1036,4623,23,4600,609,15,594,4784,3748,1036,3655,2725,930,373,100,34,3148
5/1/2015,VA,Virginia,Prince Edward,51147,4383,3608,775,3475,27,3448,908,33,875,4087,3313,774,3091,2463,628,1027,173,43,1848
5/1/2015,VA,Virginia,Prince George,51149,5278,4588,690,4423,26,4397,855,22,833,4882,4192,690,2770,2135,635,516,108,26,2120
5/1/2015,VA,Virginia,Prince William,51153,40912,34288,6624,36181,230,35951,4731,288,4443,34833,28213,6620,19072,12937,6135,4447,924,182,13519
5/1/2015,VA,Virginia,Pulaski,51155,8772,7185,1587,6823,25,6798,1949,33,1916,8194,6607,1587,6228,4729,1499,1648,331,120,4129
5/1/2015,VA,Virginia,Radford City,51750,1962,1599,363,1570,*,*,392,*,*,1798,1435,363,1470,1127,343,321,44,27,1078
5/1/2015,VA,Virginia,Rappahannock,51157,1886,1738,148,1724,*,*,162,*,*,1706,1558,148,1075,953,122,158,39,12,866
5/1/2015,VA,Virginia,Richmond,51159,1831,1476,355,1578,14,1564,253,12,241,1722,1367,355,1233,979,254,293,91,22,827
5/1/2015,VA,Virginia,Richmond City,51760,31546,22168,9378,24277,270,24007,7269,356,6913,28375,18997,9378,22976,13984,8992,8183,1390,322,13081
5/1/2015,VA,Virginia,Roanoke,51161,21833,17661,4172,19168,90,19078,2665,51,2614,20230,16058,4172,15525,11712,3813,1910,416,147,13052
5/1/2015,VA,Virginia,Roanoke City,51770,19567,14450,5117,14418,119,14299,5149,151,4998,17971,12856,5115,14226,9337,4889,4675,800,220,8531
5/1/2015,VA,Virginia,Rockbridge,51163,5598,4710,888,4704,20,4684,894,*,*,5214,4326,888,3819,3079,740,813,172,64,2770
5/1/2015,VA,Virginia,Rockingham,51165,15935,13454,2481,13868,49,13819,2067,47,2020,14730,12250,2480,11100,9290,1810,1743,485,140,8732
5/1/2015,VA,Virginia,Russell,51167,7668,5318,2350,5060,12,5048,2608,11,2597,7320,4970,2350,6136,4202,1934,1721,304,125,3986
5/1/2015,VA,Virginia,Salem City,51775,5809,4763,1046,4873,29,4844,936,19,917,5316,4270,1046,4109,3145,964,816,141,42,3110
5/1/2015,VA,Virginia,Scott,51169,6463,3357,3106,4784,17,4767,1679,12,1667,6187,3081,3106,5315,2267,3048,1539,249,111,3416
5/1/2015,VA,Virginia,Shenandoah,51171,9772,8671,1101,8554,19,8535,1218,28,1190,9147,8046,1101,6146,5237,909,1233,237,102,4574
5/1/2015,VA,Virginia,Smyth,51173,8656,6842,1814,6341,19,6322,2315,28,2287,8171,6357,1814,6517,4885,1632,2136,399,160,3822
5/1/2015,VA,Virginia,Southampton,51175,3880,3265,615,3202,25,3177,678,27,651,3620,3005,615,2775,2229,546,717,137,33,1888
5/1/2015,VA,Virginia,Spotsylvania,51177,18032,15864,2168,15495,109,15386,2537,94,2443,16046,13880,2166,9387,7494,1893,1785,484,116,7002
5/1/2015,VA,Virginia,Stafford,51179,14567,13187,1380,12691,75,12616,1876,94,1782,12756,11377,1379,6261,5061,1200,1191,340,78,4652
5/1/2015,VA,Virginia,Staunton City,51790,5792,5137,655,4689,22,4667,1103,27,1076,5435,4780,655,4167,3618,549,1050,161,49,2907
5/1/2015,VA,Virginia,Suffolk City,51800,14304,11635,2669,11547,83,11464,2757,93,2664,13028,10361,2667,8720,6284,2436,2586,401,105,5628
5/1/2015,VA,Virginia,Surry,51181,1457,1113,344,1213,12,1201,244,13,231,1348,1004,344,966,642,324,216,66,14,670
5/1/2015,VA,Virginia,Sussex,51183,2296,1812,484,1841,34,1807,455,*,*,2137,1653,484,1614,1158,456,472,138,24,980
5/1/2015,VA,Virginia,Tazewell,51185,11511,8438,3073,8329,40,8289,3182,38,3144,10886,7815,3071,8500,6528,1972,2182,430,169,5719
5/1/2015,VA,Virginia,Unknown,51999,*,*,*,*,*,*,*,*,*,*,*,*,*,*,*,*,*,*,*
5/1/2015,VA,Virginia,Virginia Beach City,51810,63292,53315,9977,55438,308,55130,7854,327,7527,57755,47784,9971,31462,22185,9277,6268,1278,331,23585
5/1/2015,VA,Virginia,Warren,51187,6756,6101,655,5724,21,5703,1032,25,1007,6148,5493,655,3987,3433,554,837,222,66,2862
5/1/2015,VA,Virginia,Washington,51191,14444,9968,4476,11315,58,11257,3129,21,3108,13594,9119,4475,10754,6628,4126,2493,515,184,7562
5/1/2015,VA,Virginia,Waynesboro City,51820,4669,3977,692,3804,20,3784,865,23,842,4369,3677,692,3408,2800,608,863,101,47,2397
5/1/2015,VA,Virginia,Westmoreland,51193,4587,3994,593,3997,25,3972,590,*,*,4188,3595,593,2559,2055,504,731,124,42,1662
5/1/2015,VA,Virginia,Williamsburg City,51830,2375,2037,338,2178,*,*,197,*,*,2154,1817,337,1461,1167,294,205,*,*,1221
5/1/2015,VA,Virginia,Winchester City,51840,4843,4343,500,4121,18,4103,722,19,703,4405,3905,500,3082,2649,433,789,122,42,2129
5/1/2015,VA,Virginia,Wise,51195,10251,6910,3341,6655,15,6640,3596,19,3577,9649,6309,3340,7481,4346,3135,2373,483,161,4464
5/1/2015,VA,Virginia,Wythe,51197,7290,5878,1412,5596,29,5567,1694,24,1670,6890,5478,1412,5266,4059,1207,1468,284,96,3418
5/1/2015,VA,Virginia,York,51199,10710,9414,1296,9793,49,9744,917,31,886,9782,8487,1295,5049,3849,1200,638,160,39,4212
11/1/2015,VA,Virginia,Accomack,51001,8369,7223,1146,7095,39,7056,1274,43,1231,7828,6682,1146,5633,4650,983,1559,372,95,3607
11/1/2015,VA,Virginia,Albemarle,51003,18227,16304,1923,16610,53,16557,1617,57,1560,16373,14450,1923,12080,10354,1726,1487,271,89,10233
11/1/2015,VA,Virginia,Alexandria City,51510,16369,14280,2089,14936,65,14871,1433,92,1341,13179,11092,2087,7399,5436,1963,2006,330,77,4986
11/1/2015,VA,Virginia,Alleghany,51005,4458,3810,648,3548,15,3533,910,12,898,4232,3584,648,3352,2834,518,835,103,50,2364
11/1/2015,VA,Virginia,Amelia,51007,2899,2258,641,2401,*,*,498,12,486,2680,2039,641,2032,1442,590,483,80,28,1441
11/1/2015,VA,Virginia,Amherst,51009,7370,6233,1137,6026,39,5987,1344,35,1309,6852,5715,1137,5414,4365,1049,1172,222,75,3945
11/1/2015,VA,Virginia,Appomattox,51011,3703,3154,549,2969,19,2950,734,21,713,3486,2937,549,2752,2254,498,691,95,51,1915
11/1/2015,VA,Virginia,Arlington,51013,22554,19731,2823,20878,71,20807,1676,84,1592,17914,15091,2823,9948,7291,2657,2910,315,123,6600
11/1/2015,VA,Virginia,Augusta,51015,16823,14493,2330,14352,44,14308,2471,40,2431,15753,13423,2330,11759,9803,1956,1851,379,154,9375
11/1/2015,VA,Virginia,Bath,51017,1257,1145,112,1097,*,*,160,*,*,1179,1067,112,909,813,96,193,36,20,660
11/1/2015,VA,Virginia,Bedford,51019,18296,15052,3244,15424,62,15362,2872,49,2823,17076,13835,3241,12985,10311,2674,2015,466,159,10345
11/1/2015,VA,Virginia,Bland,51021,1720,1368,352,1336,*,*,384,*,*,1619,1267,352,1204,938,266,267,51,18,868
11/1/2015,VA,Virginia,Botetourt,51023,8069,6326,1743,6896,34,6862,1173,15,1158,7454,5711,1743,5726,4138,1588,862,173,57,4634
11/1/2015,VA,Virginia,Bristol City,51520,4384,2681,1703,3377,11,3366,1007,11,996,4120,2417,1703,3404,1751,1653,1007,163,58,2176
11/1/2015,VA,Virginia,Brunswick,51025,3859,3178,681,3102,23,3079,757,29,728,3642,2961,681,2821,2203,618,1113,108,39,1561
11/1/2015,VA,Virginia,Buchanan,51027,7349,4624,2725,4411,12,4399,2938,13,2925,7049,4324,2725,5793,3876,1917,1656,410,120,3607
11/1/2015,VA,Virginia,Buckingham,51029,3320,2705,615,2659,12,2647,661,14,647,3103,2488,615,2344,1819,525,722,147,44,1431
11/1/2015,VA,Virginia,Buena Vista City,51530,1425,1158,267,1135,*,*,290,*,*,1332,1065,267,1022,799,223,331,57,18,616
11/1/2015,VA,Virginia,Campbell,51031,12177,10278,1899,9906,71,9835,2271,57,2214,11432,9533,1899,9056,7320,1736,2099,366,179,6412
11/1/2015,VA,Virginia,Caroline,51033,5338,4425,913,4413,30,4383,925,37,888,4851,3938,913,3225,2403,822,780,238,55,2152
11/1/2015,VA,Virginia,Carroll,51035,7774,6705,1069,6148,21,6127,1626,19,1607,7382,6313,1069,5639,4778,861,1681,261,101,3596
11/1/2015,VA,Virginia,Charles City,51036,1755,1362,393,1474,16,1458,281,13,268,1629,1236,393,1197,872,325,273,75,18,831
11/1/2015,VA,Virginia,Charlotte,51037,3280,2786,494,2637,16,2621,643,13,630,3095,2601,494,2399,1958,441,798,132,51,1418
11/1/2015,VA,Virginia,Charlottesville City,51540,5926,5189,737,4760,23,4737,1166,48,1118,5329,4593,736,4167,3464,703,1233,153,58,2723
11/1/2015,VA,Virginia,Chesapeake City,51550,34042,27858,6184,28833,216,28617,5209,236,4973,30747,24563,6184,18158,12397,5761,3971,830,220,13137
11/1/2015,VA,Virginia,Chesterfield,51041,52749,41321,11428,45344,163,45181,7405,228,7177,47510,36084,11426,35049,24605,10444,4945,946,268,28890
11/1/2015,VA,Virginia,Clarke,51043,2932,2630,302,2670,15,2655,262,*,*,2647,2345,302,1725,1470,255,258,75,32,1360
11/1/2015,VA,Virginia,Colonial Heights City,51570,4125,3576,549,3531,*,*,594,12,582,3781,3232,549,2308,1804,504,459,94,25,1730
11/1/2015,VA,Virginia,Covington City,51580,1669,1441,228,1283,*,*,386,*,*,1555,1327,228,1216,1000,216,361,51,22,782
11/1/2015,VA,Virginia,Craig,51045,1247,983,264,952,*,*,295,*,*,1149,885,264,894,633,261,205,39,11,639
11/1/2015,VA,Virginia,Culpeper,51047,8416,7364,1052,7192,48,7144,1224,37,1187,7668,6616,1052,5114,4177,937,1131,253,64,3666
11/1/2015,VA,Virginia,Cumberland,51049,2162,1688,474,1770,*,*,392,*,*,2008,1534,474,1532,1100,432,432,74,26,1000
11/1/2015,VA,Virginia,Danville City,51590,11060,9311,1749,8584,71,8513,2476,117,2359,10489,8740,1749,8569,7272,1297,3217,442,160,4750
11/1/2015,VA,Virginia,Dickenson,51051,4705,3087,1618,2801,*,*,1904,13,1891,4478,2860,1618,3584,2143,1441,1112,215,88,2169
11/1/2015,VA,Virginia,Dinwiddie,51053,5495,4403,1092,4362,32,4330,1133,33,1100,5044,3952,1092,3638,2590,1048,908,177,50,2503
11/1/2015,VA,Virginia,Emporia City,51595,1129,856,273,854,11,843,275,14,261,1055,782,273,850,623,227,419,60,12,359
11/1/2015,VA,Virginia,Essex,51057,2721,2263,458,2306,16,2290,415,16,399,2545,2087,458,1856,1492,364,424,92,28,1312
11/1/2015,VA,Virginia,Fairfax,51059,137270,119976,17294,128971,476,128495,8299,410,7889,111056,93788,17268,59597,43630,15967,13040,2535,454,43568
11/1/2015,VA,Virginia,Fairfax City,51600,3608,3123,485,3313,13,3300,295,12,283,3031,2546,485,1680,1226,454,402,51,15,1212
11/1/2015,VA,Virginia,Falls Church City,51610,1755,1530,225,1661,*,*,94,*,*,1383,1158,225,783,576,207,132,*,*,630
11/1/2015,VA,Virginia,Fauquier,51061,11265,10261,1004,10150,37,10113,1115,41,1074,9936,8933,1003,5963,5099,864,908,191,52,4812
11/1/2015,VA,Virginia,Floyd,51063,3761,3048,713,3211,13,3198,550,*,*,3518,2805,713,2701,2049,652,539,96,49,2017
11/1/2015,VA,Virginia,Fluvanna,51065,5390,4683,707,4826,24,4802,564,24,540,4923,4216,707,3487,2858,629,471,116,20,2880
11/1/2015,VA,Virginia,Franklin,51067,13737,10281,3456,11243,37,11206,2494,22,2472,12906,9450,3456,10268,6976,3292,1964,460,166,7678
11/1/2015,VA,Virginia,Franklin City,51620,1871,1578,293,1446,16,1430,425,20,405,1756,1463,293,1418,1149,269,550,69,15,784
11/1/2015,VA,Virginia,Frederick,51069,14544,12915,1629,12772,41,12731,1772,43,1729,13274,11647,1627,8818,7436,1382,1447,337,125,6909
11/1/2015,VA,Virginia,Fredericksburg City,51630,3755,3341,414,3055,13,3042,700,25,675,3385,2971,414,2223,1833,390,748,81,39,1355
11/1/2015,VA,Virginia,Galax City,51640,1935,1811,124,1471,*,*,464,*,*,1831,1707,124,1431,1333,98,680,59,32,660
11/1/2015,VA,Virginia,Giles,51071,4439,3310,1129,3462,15,3447,977,13,964,4180,3052,1128,3368,2366,1002,782,132,35,2419
11/1/2015,VA,Virginia,Gloucester,51073,7837,6610,1227,6645,28,6617,1192,24,1168,7214,5987,1227,4469,3354,1115,926,182,54,3307
11/1/2015,VA,Virginia,Goochland,51075,5093,4147,946,4593,18,4575,500,19,481,4617,3671,946,3616,2803,813,427,106,34,3049
11/1/2015,VA,Virginia,Grayson,51077,4524,3998,526,3641,*,*,883,*,*,4328,3802,526,3166,2732,434,1015,176,86,1889
11/1/2015,VA,Virginia,Greene,51079,3393,2958,435,2945,*,*,448,*,*,3113,2678,435,2191,1789,402,428,74,24,1665
11/1/2015,VA,Virginia,Greensville,51081,2404,1805,599,1884,19,1865,520,21,499,2245,1646,599,1833,1303,530,580,128,23,1102
11/1/2015,VA,Virginia,Halifax,51083,9357,8172,1185,7512,55,7457,1845,69,1776,8821,7637,1184,7022,5943,1079,2199,445,133,4245
11/1/2015,VA,Virginia,Hampton City,51650,23543,18308,5235,19125,175,18950,4418,202,4216,21530,16295,5235,12705,7673,5032,3558,751,184,8212
11/1/2015,VA,Virginia,Hanover,51085,18770,14887,3883,16826,65,16761,1944,52,1892,17070,13187,3883,13055,9737,3318,1401,353,98,11203
11/1/2015,VA,Virginia,Harrisonburg City,51660,5028,4466,562,4191,17,4174,837,23,814,4567,4005,562,3513,3093,420,941,123,36,2413
11/1/2015,VA,Virginia,Henrico,51087,51371,39710,11661,44335,301,44034,7036,299,6737,46474,34814,11660,35764,25547,10217,5922,1321,394,28127
11/1/2015,VA,Virginia,Henry,51089,14919,10880,4039,11648,66,11582,3271,61,3210,14198,10159,4039,11908,8702,3206,3192,680,228,7808
11/1/2015,VA,Virginia,Highland,51091,706,643,63,650,*,*,56,*,*,668,605,63,483,425,58,68,*,*,394
11/1/2015,VA,Virginia,Hopewell City,51670,4370,3560,810,3335,26,3309,1035,33,1002,4080,3270,810,2732,1945,787,954,154,35,1589
11/1/2015,VA,Virginia,Isle of Wight,51093,7396,5826,1570,6409,35,6374,987,29,958,6872,5302,1570,4793,3309,1484,903,181,75,3634
11/1/2015,VA,Virginia,James City,51095,18403,16275,2128,17228,48,17180,1175,42,1133,16995,14870,2125,10375,8568,1807,878,184,44,9269
11/1/2015,VA,Virginia,King and Queen,51097,1655,1405,250,1377,*,*,278,*,*,1544,1294,250,1143,919,224,275,74,11,783
11/1/2015,VA,Virginia,King George,51099,3451,3123,328,2950,18,2932,501,20,481,2998,2670,328,1474,1167,307,432,83,16,943
11/1/2015,VA,Virginia,King William,51101,3040,2617,423,2582,14,2568,458,25,433,2810,2387,423,2177,1811,366,383,89,22,1683
11/1/2015,VA,Virginia,Lancaster,51103,4180,3638,542,3825,13,3812,355,*,*,4003,3461,542,2758,2372,386,492,83,28,2155
11/1/2015,VA,Virginia,Lee,51105,6299,4164,2135,4162,11,4151,2137,13,2124,5990,3859,2131,4777,2768,2009,1953,245,80,2499
11/1/2015,VA,Virginia,Lexington City,51678,1591,1429,162,1440,13,1427,151,*,*,1487,1325,162,1112,972,140,225,*,*,847
11/1/2015,VA,Virginia,Loudoun,51107,31485,26945,4540,29181,91,29090,2304,112,2192,26118,21583,4535,16112,12002,4110,2722,578,141,12671
11/1/2015,VA,Virginia,Louisa,51109,7161,5990,1171,5923,36,5887,1238,35,1203,6591,5420,1171,4742,3667,1075,1060,241,68,3373
11/1/2015,VA,Virginia,Lunenburg,51111,2940,2532,408,2371,15,2356,569,22,547,2720,2312,408,2003,1624,379,700,127,41,1135
11/1/2015,VA,Virginia,Lynchburg City,51680,14301,12238,2063,11253,81,11172,3048,103,2945,13315,11253,2062,10663,8789,1874,3277,428,151,6807
11/1/2015,VA,Virginia,Madison,51113,2803,2443,360,2456,11,2445,347,*,*,2596,2236,360,1851,1523,328,387,80,25,1359
11/1/2015,VA,Virginia,Manassas City,51683,4090,3434,656,3514,27,3487,576,40,536,3463,2808,655,2293,1676,617,524,95,34,1640
11/1/2015,VA,Virginia,Manassas Park City,51685,1137,939,198,966,*,*,171,16,155,951,754,197,634,450,184,169,51,14,400
11/1/2015,VA,Virginia,Martinsville City,51690,3892,3051,841,2904,17,2887,988,37,951,3710,2869,841,3180,2493,687,1296,167,60,1657
11/1/2015,VA,Virginia,Mathews,51115,2747,2374,373,2510,*,*,237,*,*,2611,2238,373,1723,1401,322,261,47,16,1399
11/1/2015,VA,Virginia,Mecklenburg,51117,8942,7501,1441,7282,46,7236,1660,52,1608,8458,7019,1439,6520,5354,1166,1940,368,119,4093
11/1/2015,VA,Virginia,Middlesex,51119,3414,2914,500,3039,19,3020,375,*,*,3215,2715,500,2362,1978,384,418,85,30,1829
11/1/2015,VA,Virginia,Montgomery,51121,12915,10705,2210,10519,36,10483,2396,33,2363,11782,9572,2210,9313,7225,2088,1847,294,127,7045
11/1/2015,VA,Virginia,Nelson,51125,4235,3667,568,3678,15,3663,557,15,542,3923,3355,568,2812,2290,522,610,102,45,2055
11/1/2015,VA,Virginia,New Kent,51127,3842,3210,632,3388,15,3373,454,11,443,3514,2882,632,2376,1868,508,298,74,21,1983
11/1/2015,VA,Virginia,Newport News City,51700,26342,20209,6133,21489,155,21334,4853,245,4608,24200,18070,6130,15294,9391,5903,4492,783,224,9795
11/1/2015,VA,Virginia,Norfolk City,51710,30919,23793,7126,24299,238,24061,6620,351,6269,27897,20771,7126,18094,11231,6863,6885,1223,274,9712
11/1/2015,VA,Virginia,Northampton,51131,3423,2899,524,2874,27,2847,549,31,518,3201,2677,524,2519,2036,483,907,91,37,1484
11/1/2015,VA,Virginia,Northumberland,51133,4532,3974,558,4170,14,4156,362,*,*,4240,3682,558,2684,2320,364,428,98,33,2125
11/1/2015,VA,Virginia,Norton City,51720,1183,879,304,779,*,*,404,*,*,1096,792,304,862,576,286,365,46,20,431
11/1/2015,VA,Virginia,Nottoway,51135,3557,2923,634,2865,27,2838,692,20,672,3307,2673,634,2533,2055,478,918,129,40,1446
11/1/2015,VA,Virginia,Orange,51137,8243,7264,979,7216,38,7178,1027,37,990,7588,6609,979,4775,3955,820,952,227,67,3529
11/1/2015,VA,Virginia,Page,51139,5897,5205,692,4722,16,4706,1175,17,1158,5512,4820,692,3957,3357,600,1164,217,79,2497
11/1/2015,VA,Virginia,Patrick,51141,5004,3811,1193,4073,11,4062,931,15,916,4774,3582,1192,3807,2790,1017,994,193,81,2539
11/1/2015,VA,Virginia,Petersburg City,51730,7085,5462,1623,5159,88,5071,1926,86,1840,6486,4863,1623,4570,2998,1572,1997,360,75,2138
11/1/2015,VA,Virginia,Pittsylvania,51143,15406,12676,2730,12437,102,12335,2969,81,2888,14600,11870,2730,11764,9359,2405,3088,542,215,7919
11/1/2015,VA,Virginia,Poquoson City,51735,2430,2158,272,2244,*,*,186,0,186,2227,1955,272,1074,825,249,101,29,11,933
11/1/2015,VA,Virginia,Portsmouth City,51740,17567,13360,4207,13390,177,13213,4177,210,3967,15749,11543,4206,10090,6048,4042,3904,661,162,5363
11/1/2015,VA,Virginia,Powhatan,51145,5364,4333,1031,4732,21,4711,632,15,617,4931,3900,1031,3749,2825,924,395,101,34,3219
11/1/2015,VA,Virginia,Prince Edward,51147,4435,3659,776,3500,24,3476,935,33,902,4137,3361,776,3129,2504,625,1065,165,41,1858
11/1/2015,VA,Virginia,Prince George,51149,5400,4716,684,4513,24,4489,887,22,865,4986,4302,684,2833,2203,630,545,109,26,2153
11/1/2015,VA,Virginia,Prince William,51153,42183,35358,6825,37264,219,37045,4919,288,4631,35997,29176,6821,19732,13401,6331,4682,932,196,13922
11/1/2015,VA,Virginia,Pulaski,51155,8849,7267,1582,6873,22,6851,1976,30,1946,8262,6680,1582,6254,4759,1495,1685,325,120,4124
11/1/2015,VA,Virginia,Radford City,51750,1975,1612,363,1575,*,*,400,*,*,1814,1451,363,1475,1131,344,325,41,25,1084
11/1/2015,VA,Virginia,Rappahannock,51157,1926,1775,151,1759,*,*,167,*,*,1743,1592,151,1101,974,127,159,38,12,892
11/1/2015,VA,Virginia,Richmond,51159,1845,1505,340,1584,13,1571,261,11,250,1738,1398,340,1235,992,243,292,90,22,831
11/1/2015,VA,Virginia,Richmond City,51760,32008,22576,9432,24563,239,24324,7445,361,7084,28811,19379,9432,23306,14265,9041,8475,1383,321,13127
11/1/2015,VA,Virginia,Roanoke,51161,22091,17950,4141,19351,78,19273,2740,47,2693,20456,16315,4141,15717,11941,3776,1943,425,154,13195
11/1/2015,VA,Virginia,Roanoke City,51770,19833,14698,5135,14559,107,14452,5274,145,5129,18202,13069,5133,14399,9485,4914,4823,797,215,8564
11/1/2015,VA,Virginia,Rockbridge,51163,5650,4767,883,4732,16,4716,918,11,907,5264,4381,883,3842,3105,737,837,168,61,2776
11/1/2015,VA,Virginia,Rockingham,51165,16160,13728,2432,14010,43,13967,2150,50,2100,14923,12492,2431,11257,9497,1760,1798,494,151,8814
11/1/2015,VA,Virginia,Russell,51167,7674,5320,2354,5028,12,5016,2646,*,*,7335,4981,2354,6157,4214,1943,1745,310,131,3971
11/1/2015,VA,Virginia,Salem City,51775,5821,4799,1022,4855,26,4829,966,18,948,5325,4303,1022,4113,3168,945,819,143,40,3111
11/1/2015,VA,Virginia,Scott,51169,6473,3367,3106,4761,13,4748,1712,11,1701,6203,3097,3106,5314,2264,3050,1557,248,106,3403
11/1/2015,VA,Virginia,Shenandoah,51171,9855,8754,1101,8607,15,8592,1248,25,1223,9228,8127,1101,6225,5315,910,1268,241,104,4612
11/1/2015,VA,Virginia,Smyth,51173,8663,6832,1831,6320,17,6303,2343,27,2316,8178,6347,1831,6524,4875,1649,2170,391,151,3812
11/1/2015,VA,Virginia,Southampton,51175,3946,3327,619,3243,22,3221,703,28,675,3690,3071,619,2825,2274,551,746,135,33,1911
11/1/2015,VA,Virginia,Spotsylvania,51177,18419,16276,2143,15799,102,15697,2620,90,2530,16409,14267,2142,9601,7739,1862,1859,464,115,7163
11/1/2015,VA,Virginia,Stafford,51179,14948,13628,1320,13012,70,12942,1936,94,1842,13127,11808,1319,6388,5244,1144,1252,343,83,4710
11/1/2015,VA,Virginia,Staunton City,51790,5805,5025,780,4676,19,4657,1129,30,1099,5454,4674,780,4178,3503,675,1078,153,50,2897
11/1/2015,VA,Virginia,Suffolk City,51800,14506,11854,2652,11678,75,11603,2828,93,2735,13273,10622,2651,8826,6401,2425,2628,399,109,5690
11/1/2015,VA,Virginia,Surry,51181,1474,1132,342,1223,11,1212,251,13,238,1359,1017,342,980,658,322,220,67,14,679
11/1/2015,VA,Virginia,Sussex,51183,2305,1830,475,1845,32,1813,460,*,*,2145,1670,475,1623,1175,448,489,140,23,971
11/1/2015,VA,Virginia,Tazewell,51185,11592,8502,3090,8347,36,8311,3245,36,3209,10964,7876,3088,8570,6573,1997,2242,431,176,5721
11/1/2015,VA,Virginia,Unknown,51999,*,*,*,*,*,*,*,*,*,*,*,*,*,*,*,*,*,*,*
11/1/2015,VA,Virginia,Virginia Beach City,51810,64590,54455,10135,56492,291,56201,8098,324,7774,59102,48974,10128,32140,22692,9448,6467,1268,348,24057
11/1/2015,VA,Virginia,Warren,51187,6907,6259,648,5826,19,5807,1081,27,1054,6297,5649,648,4095,3550,545,876,230,69,2920
11/1/2015,VA,Virginia,Washington,51191,14504,10030,4474,11307,51,11256,3197,25,3172,13665,9192,4473,10794,6669,4125,2543,516,181,7554
11/1/2015,VA,Virginia,Waynesboro City,51820,4684,3995,689,3811,17,3794,873,21,852,4391,3702,689,3419,2813,606,874,102,47,2396
11/1/2015,VA,Virginia,Westmoreland,51193,4611,4027,584,4006,24,3982,605,*,*,4225,3641,584,2557,2059,498,734,122,41,1660
11/1/2015,VA,Virginia,Williamsburg City,51830,2408,2073,335,2202,*,*,206,*,*,2189,1855,334,1474,1184,290,209,*,*,1235
11/1/2015,VA,Virginia,Winchester City,51840,4935,4432,503,4184,16,4168,751,18,733,4497,3994,503,3151,2714,437,811,127,42,2171
11/1/2015,VA,Virginia,Wise,51195,10349,6956,3393,6661,14,6647,3688,19,3669,9764,6372,3392,7579,4379,3200,2441,475,161,4502
11/1/2015,VA,Virginia,Wythe,51197,7307,5709,1598,5577,26,5551,1730,24,1706,6904,5306,1598,5270,3871,1399,1500,277,97,3396
11/1/2015,VA,Virginia,York,51199,10886,9588,1298,9940,44,9896,946,32,914,9972,8674,1298,5128,3923,1205,646,160,42,4280
10/1/2015,VA,Virginia,Accomack,51001,8350,7209,1141,7079,41,7038,1271,43,1228,7814,6673,1141,5613,4636,977,1547,371,93,3602
10/1/2015,VA,Virginia,Albemarle,51003,18207,16278,1929,16597,55,16542,1610,53,1557,16369,14440,1929,12071,10338,1733,1484,270,86,10231
10/1/2015,VA,Virginia,Alexandria City,51510,16304,14206,2098,14875,66,14809,1429,92,1337,13141,11045,2096,7388,5416,1972,2003,332,73,4980
10/1/2015,VA,Virginia,Alleghany,51005,4458,3809,649,3551,15,3536,907,12,895,4230,3581,649,3353,2835,518,835,104,50,2364
10/1/2015,VA,Virginia,Amelia,51007,2893,2253,640,2399,*,*,494,11,483,2676,2036,640,2029,1440,589,479,83,28,1439
10/1/2015,VA,Virginia,Amherst,51009,7357,6218,1139,6016,39,5977,1341,35,1306,6842,5703,1139,5406,4355,1051,1167,229,71,3939
10/1/2015,VA,Virginia,Appomattox,51011,3704,3154,550,2972,20,2952,732,21,711,3488,2938,550,2754,2255,499,691,98,51,1914
10/1/2015,VA,Virginia,Arlington,51013,22480,19637,2843,20810,72,20738,1670,83,1587,17861,15018,2843,9927,7250,2677,2889,315,121,6602
10/1/2015,VA,Virginia,Augusta,51015,16790,14448,2342,14326,45,14281,2464,40,2424,15733,13391,2342,11751,9785,1966,1855,381,154,9361
10/1/2015,VA,Virginia,Bath,51017,1260,1148,112,1100,*,*,160,*,*,1183,1071,112,912,816,96,193,37,20,662
10/1/2015,VA,Virginia,Bedford,51019,18270,15036,3234,15407,64,15343,2863,49,2814,17049,13818,3231,12965,10305,2660,2012,465,158,10330
10/1/2015,VA,Virginia,Bland,51021,1722,1367,355,1337,*,*,385,*,*,1622,1267,355,1205,937,268,266,52,18,869
10/1/2015,VA,Virginia,Botetourt,51023,8053,6314,1739,6887,34,6853,1166,15,1151,7437,5698,1739,5712,4130,1582,854,169,57,4632
10/1/2015,VA,Virginia,Bristol City,51520,4376,2675,1701,3376,11,3365,1000,11,989,4118,2417,1701,3394,1744,1650,999,164,57,2174
10/1/2015,VA,Virginia,Brunswick,51025,3852,3175,677,3099,25,3074,753,29,724,3636,2959,677,2821,2205,616,1108,111,36,1566
10/1/2015,VA,Virginia,Buchanan,51027,7347,4611,2736,4421,12,4409,2926,13,2913,7055,4319,2736,5787,3871,1916,1647,408,115,3617
10/1/2015,VA,Virginia,Buckingham,51029,3311,2691,620,2652,13,2639,659,13,646,3092,2472,620,2341,1813,528,716,146,45,1434
10/1/2015,VA,Virginia,Buena Vista City,51530,1421,1158,263,1132,*,*,289,*,*,1329,1066,263,1021,802,219,332,57,18,614
10/1/2015,VA,Virginia,Campbell,51031,12148,10246,1902,9900,71,9829,2248,59,2189,11417,9515,1902,9035,7298,1737,2084,364,180,6407
10/1/2015,VA,Virginia,Caroline,51033,5338,4430,908,4420,30,4390,918,37,881,4849,3941,908,3214,2397,817,775,240,55,2144
10/1/2015,VA,Virginia,Carroll,51035,7772,6707,1065,6155,21,6134,1617,19,1598,7384,6319,1065,5637,4780,857,1677,260,103,3597
10/1/2015,VA,Virginia,Charles City,51036,1747,1356,391,1467,16,1451,280,12,268,1624,1233,391,1197,874,323,274,75,16,832
10/1/2015,VA,Virginia,Charlotte,51037,3283,2782,501,2641,16,2625,642,13,629,3095,2594,501,2399,1952,447,793,133,51,1422
10/1/2015,VA,Virginia,Charlottesville City,51540,5908,5173,735,4746,23,4723,1162,48,1114,5308,4574,734,4156,3455,701,1234,152,57,2713
10/1/2015,VA,Virginia,Chesapeake City,51550,33922,27734,6188,28746,219,28527,5176,237,4939,30641,24453,6188,18101,12336,5765,3950,823,221,13107
10/1/2015,VA,Virginia,Chesterfield,51041,52599,41182,11417,45230,166,45064,7369,226,7143,47383,35968,11415,34943,24505,10438,4920,953,267,28803
10/1/2015,VA,Virginia,Clarke,51043,2917,2616,301,2656,15,2641,261,*,*,2631,2330,301,1715,1461,254,257,75,32,1351
10/1/2015,VA,Virginia,Colonial Heights City,51570,4126,3578,548,3535,*,*,591,12,579,3789,3241,548,2311,1808,503,460,96,24,1731
10/1/2015,VA,Virginia,Covington City,51580,1669,1439,230,1285,*,*,384,*,*,1555,1325,230,1215,997,218,358,52,22,783
10/1/2015,VA,Virginia,Craig,51045,1245,982,263,952,*,*,293,*,*,1149,886,263,890,630,260,201,39,11,639
10/1/2015,VA,Virginia,Culpeper,51047,8405,7356,1049,7182,48,7134,1223,38,1185,7662,6613,1049,5107,4171,936,1129,255,64,3659
10/1/2015,VA,Virginia,Cumberland,51049,2161,1686,475,1770,*,*,391,*,*,2007,1533,474,1534,1102,432,436,74,27,997
10/1/2015,VA,Virginia,Danville City,51590,11061,9307,1754,8597,73,8524,2464,117,2347,10486,8732,1754,8558,7260,1298,3204,443,159,4752
10/1/2015,VA,Virginia,Dickenson,51051,4690,3070,1620,2797,*,*,1893,13,1880,4468,2848,1620,3581,2137,1444,1110,216,89,2166
10/1/2015,VA,Virginia,Dinwiddie,51053,5474,4381,1093,4350,32,4318,1124,32,1092,5026,3933,1093,3615,2567,1048,899,174,49,2493
10/1/2015,VA,Virginia,Emporia City,51595,1130,858,272,857,11,846,273,14,259,1055,783,272,851,626,225,419,61,12,359
10/1/2015,VA,Virginia,Essex,51057,2724,2267,457,2312,17,2295,412,16,396,2546,2089,457,1857,1492,365,425,92,28,1312
10/1/2015,VA,Virginia,Fairfax,51059,136707,119500,17207,128462,479,127983,8245,408,7837,110682,93501,17181,59434,43552,15882,13021,2527,447,43439
10/1/2015,VA,Virginia,Fairfax City,51600,3601,3119,482,3304,13,3291,297,13,284,3028,2546,482,1674,1223,451,401,51,15,1207
10/1/2015,VA,Virginia,Falls Church City,51610,1752,1529,223,1658,*,*,94,*,*,1381,1158,223,779,574,205,135,*,*,623
10/1/2015,VA,Virginia,Fauquier,51061,11237,10234,1003,10131,37,10094,1106,41,1065,9908,8906,1002,5958,5095,863,900,192,52,4814
10/1/2015,VA,Virginia,Floyd,51063,3747,3032,715,3199,13,3186,548,*,*,3509,2794,715,2697,2044,653,537,94,49,2017
10/1/2015,VA,Virginia,Fluvanna,51065,5383,4673,710,4822,25,4797,561,23,538,4920,4210,710,3490,2858,632,474,114,20,2882
10/1/2015,VA,Virginia,Franklin,51067,13712,10255,3457,11225,39,11186,2487,22,2465,12881,9424,3457,10253,6959,3294,1962,461,162,7668
10/1/2015,VA,Virginia,Franklin City,51620,1872,1583,289,1447,16,1431,425,20,405,1759,1470,289,1421,1156,265,547,69,16,789
10/1/2015,VA,Virginia,Frederick,51069,14510,12881,1629,12744,42,12702,1766,44,1722,13245,11618,1627,8792,7409,1383,1442,336,121,6893
10/1/2015,VA,Virginia,Fredericksburg City,51630,3752,3335,417,3052,13,3039,700,27,673,3382,2965,417,2223,1830,393,747,82,40,1354
10/1/2015,VA,Virginia,Galax City,51640,1926,1802,124,1462,*,*,464,*,*,1825,1701,124,1426,1328,98,680,57,32,657
10/1/2015,VA,Virginia,Giles,51071,4439,3306,1133,3466,15,3451,973,13,960,4178,3046,1132,3366,2360,1006,779,132,36,2419
10/1/2015,VA,Virginia,Gloucester,51073,7820,6593,1227,6634,28,6606,1186,23,1163,7197,5970,1227,4463,3346,1117,925,181,52,3305
10/1/2015,VA,Virginia,Goochland,51075,5081,4139,942,4584,18,4566,497,19,478,4611,3669,942,3611,2801,810,424,103,35,3049
10/1/2015,VA,Virginia,Grayson,51077,4520,3994,526,3642,*,*,878,*,*,4324,3798,526,3165,2729,436,1011,176,84,1894
10/1/2015,VA,Virginia,Greene,51079,3389,2953,436,2941,11,2930,448,*,*,3106,2670,436,2184,1781,403,423,74,24,1663
10/1/2015,VA,Virginia,Greensville,51081,2400,1800,600,1880,19,1861,520,21,499,2242,1642,600,1829,1296,533,580,124,22,1103
10/1/2015,VA,Virginia,Halifax,51083,9339,8150,1189,7503,55,7448,1836,69,1767,8805,7617,1188,7014,5931,1083,2192,438,134,4250
10/1/2015,VA,Virginia,Hampton City,51650,23481,18246,5235,19086,176,18910,4395,205,4190,21471,16236,5235,12667,7636,5031,3522,755,182,8208
10/1/2015,VA,Virginia,Hanover,51085,18729,14871,3858,16796,66,16730,1933,52,1881,17032,13174,3858,13022,9728,3294,1392,353,95,11182
10/1/2015,VA,Virginia,Harrisonburg City,51660,5024,4459,565,4190,17,4173,834,23,811,4563,3998,565,3508,3086,422,937,122,37,2412
10/1/2015,VA,Virginia,Henrico,51087,51288,39620,11668,44283,305,43978,7005,300,6705,46402,34735,11667,35668,25451,10217,5892,1317,391,28068
10/1/2015,VA,Virginia,Henry,51089,14911,10865,4046,11645,66,11579,3266,61,3205,14200,10154,4046,11897,8685,3212,3180,677,229,7811
10/1/2015,VA,Virginia,Highland,51091,707,644,63,651,*,*,56,*,*,669,606,63,483,425,58,68,*,*,394
10/1/2015,VA,Virginia,Hopewell City,51670,4377,3559,818,3342,27,3315,1035,33,1002,4090,3272,818,2739,1944,795,956,155,36,1592
10/1/2015,VA,Virginia,Isle of Wight,51093,7389,5814,1575,6400,36,6364,989,30,959,6860,5285,1575,4788,3300,1488,904,184,74,3626
10/1/2015,VA,Virginia,James City,51095,18360,16234,2126,17192,49,17143,1168,42,1126,16969,14847,2122,10344,8541,1803,870,184,45,9245
10/1/2015,VA,Virginia,King and Queen,51097,1649,1399,250,1373,*,*,276,*,*,1539,1289,250,1142,918,224,274,74,11,783
10/1/2015,VA,Virginia,King George,51099,3445,3119,326,2945,19,2926,500,20,480,2998,2672,326,1478,1173,305,433,84,16,945
10/1/2015,VA,Virginia,King William,51101,3032,2610,422,2573,14,2559,459,25,434,2801,2379,422,2170,1805,365,383,88,22,1677
10/1/2015,VA,Virginia,Lancaster,51103,4175,3625,550,3821,15,3806,354,*,*,3999,3449,550,2753,2361,392,495,83,28,2147
10/1/2015,VA,Virginia,Lee,51105,6305,4174,2131,4169,11,4158,2136,13,2123,5996,3869,2127,4779,2775,2004,1956,242,79,2502
10/1/2015,VA,Virginia,Lexington City,51678,1596,1435,161,1445,13,1432,151,*,*,1493,1332,161,1115,976,139,226,*,*,850
10/1/2015,VA,Virginia,Loudoun,51107,31377,26829,4548,29083,93,28990,2294,113,2181,26065,21522,4543,16070,11954,4116,2704,576,138,12652
10/1/2015,VA,Virginia,Louisa,51109,7152,5974,1178,5926,37,5889,1226,34,1192,6582,5404,1178,4735,3654,1081,1051,240,68,3376
10/1/2015,VA,Virginia,Lunenburg,51111,2938,2529,409,2375,15,2360,563,22,541,2716,2307,409,1996,1615,381,694,124,41,1137
10/1/2015,VA,Virginia,Lynchburg City,51680,14282,12225,2057,11244,83,11161,3038,103,2935,13296,11240,2056,10629,8761,1868,3267,429,148,6785
10/1/2015,VA,Virginia,Madison,51113,2802,2435,367,2457,11,2446,345,*,*,2594,2227,367,1859,1524,335,389,82,25,1363
10/1/2015,VA,Virginia,Manassas City,51683,4080,3425,655,3509,28,3481,571,38,533,3460,2806,654,2297,1682,615,521,96,35,1645
10/1/2015,VA,Virginia,Manassas Park City,51685,1128,930,198,960,*,*,168,16,152,939,742,197,630,446,184,168,51,14,397
10/1/2015,VA,Virginia,Martinsville City,51690,3891,3053,838,2906,17,2889,985,37,948,3711,2873,838,3181,2498,683,1289,167,62,1663
10/1/2015,VA,Virginia,Mathews,51115,2740,2370,370,2506,*,*,234,*,*,2606,2236,370,1719,1400,319,260,48,16,1395
10/1/2015,VA,Virginia,Mecklenburg,51117,8927,7486,1441,7274,46,7228,1653,52,1601,8447,7008,1439,6511,5346,1165,1928,370,121,4092
10/1/2015,VA,Virginia,Middlesex,51119,3400,2893,507,3027,20,3007,373,*,*,3206,2699,507,2358,1967,391,415,85,29,1829
10/1/2015,VA,Virginia,Montgomery,51121,12894,10681,2213,10507,38,10469,2387,33,2354,11755,9542,2213,9318,7226,2092,1845,296,124,7053
10/1/2015,VA,Virginia,Nelson,51125,4227,3659,568,3670,16,3654,557,15,542,3911,3343,568,2810,2288,522,611,102,45,2052
10/1/2015,VA,Virginia,New Kent,51127,3827,3191,636,3375,16,3359,452,11,441,3501,2865,636,2370,1858,512,297,75,21,1977
10/1/2015,VA,Virginia,Newport News City,51700,26294,20164,6130,21459,156,21303,4835,243,4592,24169,18042,6127,15248,9348,5900,4455,774,221,9798
10/1/2015,VA,Virginia,Norfolk City,51710,30886,23754,7132,24291,241,24050,6595,353,6242,27888,20756,7132,18083,11214,6869,6871,1230,267,9715
10/1/2015,VA,Virginia,Northampton,51131,3420,2903,517,2872,27,2845,548,31,517,3199,2682,517,2520,2044,476,907,90,37,1486
10/1/2015,VA,Virginia,Northumberland,51133,4535,3978,557,4175,14,4161,360,*,*,4245,3688,557,2690,2328,362,426,99,33,2132
10/1/2015,VA,Virginia,Norton City,51720,1182,878,304,780,*,*,402,*,*,1096,792,304,864,578,286,364,46,20,434
10/1/2015,VA,Virginia,Nottoway,51135,3548,2911,637,2859,28,2831,689,19,670,3297,2660,637,2528,2046,482,920,129,41,1438
10/1/2015,VA,Virginia,Orange,51137,8234,7248,986,7209,39,7170,1025,36,989,7572,6586,986,4760,3932,828,944,226,64,3526
10/1/2015,VA,Virginia,Page,51139,5884,5191,693,4716,16,4700,1168,17,1151,5507,4814,693,3956,3353,603,1162,216,77,2501
10/1/2015,VA,Virginia,Patrick,51141,5002,3807,1195,4074,11,4063,928,15,913,4774,3580,1194,3807,2789,1018,988,194,83,2542
10/1/2015,VA,Virginia,Petersburg City,51730,7082,5455,1627,5162,90,5072,1920,86,1834,6483,4856,1627,4565,2988,1577,1981,360,77,2147
10/1/2015,VA,Virginia,Pittsylvania,51143,15374,12639,2735,12424,102,12322,2950,80,2870,14568,11833,2735,11758,9348,2410,3077,548,217,7916
10/1/2015,VA,Virginia,Poquoson City,51735,2426,2154,272,2241,*,*,185,0,185,2218,1946,272,1063,814,249,101,29,11,922
10/1/2015,VA,Virginia,Portsmouth City,51740,17532,13347,4185,13378,180,13198,4154,211,3943,15717,11532,4185,10061,6043,4018,3883,655,157,5366
10/1/2015,VA,Virginia,Powhatan,51145,5335,4311,1024,4706,22,4684,629,14,615,4900,3876,1024,3730,2813,917,389,101,34,3206
10/1/2015,VA,Virginia,Prince Edward,51147,4434,3664,770,3503,24,3479,931,33,898,4137,3367,770,3137,2516,621,1063,168,43,1863
10/1/2015,VA,Virginia,Prince George,51149,5392,4705,687,4512,24,4488,880,22,858,4973,4286,687,2825,2192,633,538,107,26,2154
10/1/2015,VA,Virginia,Prince William,51153,42023,35207,6816,37128,222,36906,4895,289,4606,35890,29078,6812,19688,13362,6326,4656,936,195,13901
10/1/2015,VA,Virginia,Pulaski,51155,8851,7267,1584,6874,22,6852,1977,30,1947,8256,6672,1584,6259,4762,1497,1685,328,119,4127
10/1/2015,VA,Virginia,Radford City,51750,1976,1615,361,1578,*,*,398,*,*,1816,1455,361,1475,1133,342,326,42,26,1081
10/1/2015,VA,Virginia,Rappahannock,51157,1925,1775,150,1759,*,*,166,*,*,1741,1591,150,1096,970,126,160,38,12,886
10/1/2015,VA,Virginia,Richmond,51159,1847,1504,343,1589,13,1576,258,11,247,1741,1398,343,1237,992,245,294,88,22,833
10/1/2015,VA,Virginia,Richmond City,51760,31927,22490,9437,24514,245,24269,7413,358,7055,28759,19322,9437,23278,14233,9045,8445,1390,319,13124
10/1/2015,VA,Virginia,Roanoke,51161,22056,17920,4136,19327,79,19248,2729,46,2683,20419,16283,4136,15708,11930,3778,1940,423,152,13193
10/1/2015,VA,Virginia,Roanoke City,51770,19807,14667,5140,14550,109,14441,5257,148,5109,18181,13044,5137,14372,9454,4918,4807,795,216,8554
10/1/2015,VA,Virginia,Rockbridge,51163,5651,4769,882,4736,17,4719,915,11,904,5264,4382,882,3847,3111,736,839,167,61,2780
10/1/2015,VA,Virginia,Rockingham,51165,16135,13697,2438,14001,44,13957,2134,50,2084,14910,12473,2437,11252,9486,1766,1787,498,148,8819
10/1/2015,VA,Virginia,Russell,51167,7677,5331,2346,5040,12,5028,2637,*,*,7342,4996,2346,6167,4230,1937,1744,310,131,3982
10/1/2015,VA,Virginia,Salem City,51775,5818,4792,1026,4856,26,4830,962,18,944,5322,4296,1026,4112,3163,949,816,139,42,3115
10/1/2015,VA,Virginia,Scott,51169,6478,3370,3108,4772,13,4759,1706,11,1695,6214,3106,3108,5325,2273,3052,1558,252,105,3410
10/1/2015,VA,Virginia,Shenandoah,51171,9856,8760,1096,8608,15,8593,1248,26,1222,9233,8137,1096,6204,5300,904,1263,239,101,4601
10/1/2015,VA,Virginia,Smyth,51173,8678,6843,1835,6335,17,6318,2343,27,2316,8197,6362,1835,6542,4890,1652,2171,393,154,3824
10/1/2015,VA,Virginia,Southampton,51175,3943,3324,619,3246,24,3222,697,28,669,3688,3069,619,2825,2275,550,745,135,33,1912
10/1/2015,VA,Virginia,Spotsylvania,51177,18365,16222,2143,15766,105,15661,2599,90,2509,16378,14236,2142,9590,7729,1861,1844,466,117,7163
10/1/2015,VA,Virginia,Stafford,51179,14894,13556,1338,12968,71,12897,1926,93,1833,13083,11746,1337,6370,5211,1159,1243,342,82,4703
10/1/2015,VA,Virginia,Staunton City,51790,5810,5021,789,4686,19,4667,1124,29,1095,5460,4671,789,4186,3502,684,1073,157,49,2907
10/1/2015,VA,Virginia,Suffolk City,51800,14472,11817,2655,11654,75,11579,2818,92,2726,13243,10589,2654,8810,6382,2428,2615,400,111,5684
10/1/2015,VA,Virginia,Surry,51181,1472,1127,345,1223,11,1212,249,13,236,1358,1013,345,982,657,325,223,66,14,679
10/1/2015,VA,Virginia,Sussex,51183,2309,1827,482,1849,32,1817,460,*,*,2154,1672,482,1630,1176,454,490,141,24,975
10/1/2015,VA,Virginia,Tazewell,51185,11593,8509,3084,8354,36,8318,3239,36,3203,10967,7885,3082,8559,6566,1993,2231,435,169,5724
10/1/2015,VA,Virginia,Unknown,51999,*,*,*,*,*,*,*,*,*,*,*,*,*,*,*,*,*,*,*
10/1/2015,VA,Virginia,Virginia Beach City,51810,64414,54293,10121,56347,294,56053,8067,324,7743,58952,48838,10114,32093,22664,9429,6433,1277,345,24038
10/1/2015,VA,Virginia,Warren,51187,6909,6260,649,5831,19,5812,1078,27,1051,6297,5648,649,4094,3550,544,872,229,70,2923
10/1/2015,VA,Virginia,Washington,51191,14495,10024,4471,11314,52,11262,3181,25,3156,13664,9194,4470,10804,6683,4121,2540,513,179,7572
10/1/2015,VA,Virginia,Waynesboro City,51820,4680,3991,689,3811,17,3794,869,21,848,4390,3701,689,3422,2818,604,873,101,47,2401
10/1/2015,VA,Virginia,Westmoreland,51193,4612,4031,581,4009,24,3985,603,*,*,4220,3639,581,2557,2063,494,735,123,40,1659
10/1/2015,VA,Virginia,Williamsburg City,51830,2405,2067,338,2198,*,*,207,*,*,2189,1852,337,1474,1181,293,211,*,*,1232
10/1/2015,VA,Virginia,Winchester City,51840,4933,4428,505,4184,17,4167,749,18,731,4487,3982,505,3154,2715,439,811,126,42,2175
10/1/2015,VA,Virginia,Wise,51195,10327,6934,3393,6659,14,6645,3668,19,3649,9748,6356,3392,7564,4368,3196,2422,481,160,4501
10/1/2015,VA,Virginia,Wythe,51197,7318,5702,1616,5594,26,5568,1724,24,1700,6919,5303,1616,5280,3862,1418,1500,277,99,3404
10/1/2015,VA,Virginia,York,51199,10863,9569,1294,9919,44,9875,944,32,912,9954,8660,1294,5127,3925,1202,648,158,42,4279
9/1/2015,VA,Virginia,Accomack,51001,8346,7202,1144,7078,41,7037,1268,43,1225,7817,6673,1144,5607,4626,981,1544,367,92,3604
9/1/2015,VA,Virginia,Albemarle,51003,18153,16219,1934,16553,56,16497,1600,52,1548,16315,14381,1934,12020,10284,1736,1482,267,85,10186
9/1/2015,VA,Virginia,Alexandria City,51510,16246,14130,2116,14823,71,14752,1423,92,1331,13123,11009,2114,7370,5382,1988,1996,333,73,4968
9/1/2015,VA,Virginia,Alleghany,51005,4455,3806,649,3548,15,3533,907,12,895,4226,3577,649,3356,2838,518,837,106,51,2362
9/1/2015,VA,Virginia,Amelia,51007,2884,2248,636,2392,*,*,492,11,481,2668,2032,636,2021,1435,586,477,85,27,1432
9/1/2015,VA,Virginia,Amherst,51009,7331,6197,1134,6000,40,5960,1331,35,1296,6821,5687,1134,5402,4356,1046,1163,228,74,3937
9/1/2015,VA,Virginia,Appomattox,51011,3703,3156,547,2974,20,2954,729,21,708,3484,2937,547,2747,2251,496,692,99,52,1904
9/1/2015,VA,Virginia,Arlington,51013,22356,19478,2878,20694,74,20620,1662,83,1579,17798,14920,2878,9894,7182,2712,2867,319,121,6587
9/1/2015,VA,Virginia,Augusta,51015,16765,14407,2358,14307,45,14262,2458,40,2418,15701,13343,2358,11722,9740,1982,1842,383,153,9344
9/1/2015,VA,Virginia,Bath,51017,1257,1142,115,1099,*,*,158,*,*,1178,1063,115,912,813,99,193,36,19,664
9/1/2015,VA,Virginia,Bedford,51019,18229,15005,3224,15374,65,15309,2855,51,2804,17030,13809,3221,12936,10285,2651,2007,459,157,10313
9/1/2015,VA,Virginia,Bland,51021,1717,1361,356,1335,*,*,382,*,*,1619,1263,356,1202,933,269,263,52,18,869
9/1/2015,VA,Virginia,Botetourt,51023,8046,6302,1744,6881,33,6848,1165,15,1150,7437,5693,1744,5712,4123,1589,856,170,56,4630
9/1/2015,VA,Virginia,Bristol City,51520,4382,2677,1705,3383,11,3372,999,11,988,4124,2419,1705,3400,1745,1655,998,165,58,2179
9/1/2015,VA,Virginia,Brunswick,51025,3846,3162,684,3095,26,3069,751,29,722,3633,2949,684,2818,2197,621,1109,111,36,1562
9/1/2015,VA,Virginia,Buchanan,51027,7342,4608,2734,4420,12,4408,2922,14,2908,7047,4313,2734,5780,3866,1914,1635,412,111,3622
9/1/2015,VA,Virginia,Buckingham,51029,3303,2679,624,2647,13,2634,656,13,643,3080,2456,624,2335,1803,532,712,146,45,1432
9/1/2015,VA,Virginia,Buena Vista City,51530,1412,1149,263,1123,*,*,289,*,*,1323,1060,263,1014,795,219,330,56,18,610
9/1/2015,VA,Virginia,Campbell,51031,12143,10237,1906,9901,72,9829,2242,60,2182,11411,9505,1906,9008,7267,1741,2070,362,179,6397
9/1/2015,VA,Virginia,Caroline,51033,5323,4409,914,4409,30,4379,914,36,878,4845,3931,914,3204,2382,822,773,237,54,2140
9/1/2015,VA,Virginia,Carroll,51035,7763,6696,1067,6153,21,6132,1610,19,1591,7377,6310,1067,5629,4770,859,1672,265,103,3589
9/1/2015,VA,Virginia,Charles City,51036,1745,1351,394,1465,17,1448,280,12,268,1621,1227,394,1194,868,326,270,77,17,830
9/1/2015,VA,Virginia,Charlotte,51037,3283,2781,502,2643,18,2625,640,13,627,3093,2592,501,2392,1944,448,792,131,49,1420
9/1/2015,VA,Virginia,Charlottesville City,51540,5896,5158,738,4741,23,4718,1155,46,1109,5295,4558,737,4145,3441,704,1221,153,57,2714
9/1/2015,VA,Virginia,Chesapeake City,51550,33787,27599,6188,28641,219,28422,5146,238,4908,30534,24346,6188,18060,12299,5761,3922,834,219,13085
9/1/2015,VA,Virginia,Chesterfield,51041,52399,41017,11382,45062,168,44894,7337,225,7112,47214,35834,11380,34787,24388,10399,4888,945,268,28686
9/1/2015,VA,Virginia,Clarke,51043,2905,2602,303,2644,15,2629,261,*,*,2622,2319,303,1706,1450,256,259,75,32,1340
9/1/2015,VA,Virginia,Colonial Heights City,51570,4125,3571,554,3534,*,*,591,12,579,3791,3237,554,2312,1804,508,460,98,24,1730
9/1/2015,VA,Virginia,Covington City,51580,1674,1442,232,1290,*,*,384,*,*,1560,1328,232,1214,994,220,356,52,22,784
9/1/2015,VA,Virginia,Craig,51045,1245,980,265,952,*,*,293,*,*,1148,883,265,886,624,262,198,40,12,636
9/1/2015,VA,Virginia,Culpeper,51047,8369,7316,1053,7154,48,7106,1215,39,1176,7643,6590,1053,5095,4154,941,1123,252,61,3659
9/1/2015,VA,Virginia,Cumberland,51049,2154,1677,477,1763,*,*,391,*,*,2004,1528,476,1529,1095,434,429,74,28,998
9/1/2015,VA,Virginia,Danville City,51590,11047,9287,1760,8583,75,8508,2464,117,2347,10464,8704,1760,8540,7236,1304,3198,440,161,4741
9/1/2015,VA,Virginia,Dickenson,51051,4693,3072,1621,2803,*,*,1890,12,1878,4477,2856,1621,3591,2148,1443,1109,221,89,2172
9/1/2015,VA,Virginia,Dinwiddie,51053,5456,4362,1094,4338,32,4306,1118,32,1086,5012,3918,1094,3612,2563,1049,898,177,49,2488
9/1/2015,VA,Virginia,Emporia City,51595,1129,854,275,857,11,846,272,14,258,1056,781,275,852,623,229,418,59,12,363
9/1/2015,VA,Virginia,Essex,51057,2725,2266,459,2315,17,2298,410,16,394,2546,2087,459,1855,1488,367,426,90,28,1311
9/1/2015,VA,Virginia,Fairfax,51059,136097,118965,17132,127885,489,127396,8212,405,7807,110369,93263,17106,59188,43384,15804,12954,2528,450,43256
9/1/2015,VA,Virginia,Fairfax City,51600,3585,3105,480,3291,13,3278,294,12,282,3011,2531,480,1669,1220,449,398,51,15,1205
9/1/2015,VA,Virginia,Falls Church City,51610,1734,1512,222,1644,*,*,90,*,*,1367,1145,222,777,573,204,135,*,*,621
9/1/2015,VA,Virginia,Fauquier,51061,11174,10174,1000,10074,37,10037,1100,41,1059,9856,8857,999,5922,5062,860,897,192,52,4781
9/1/2015,VA,Virginia,Floyd,51063,3737,3022,715,3192,13,3179,545,*,*,3504,2789,715,2690,2037,653,531,92,50,2017
9/1/2015,VA,Virginia,Fluvanna,51065,5370,4657,713,4810,25,4785,560,23,537,4905,4192,713,3469,2835,634,477,113,19,2860
9/1/2015,VA,Virginia,Franklin,51067,13676,10216,3460,11197,40,11157,2479,23,2456,12851,9391,3460,10207,6910,3297,1954,465,161,7627
9/1/2015,VA,Virginia,Franklin City,51620,1866,1576,290,1441,16,1425,425,20,405,1756,1466,290,1417,1151,266,544,71,17,785
9/1/2015,VA,Virginia,Frederick,51069,14473,12847,1626,12716,43,12673,1757,44,1713,13215,11591,1624,8775,7393,1382,1429,340,121,6885
9/1/2015,VA,Virginia,Fredericksburg City,51630,3752,3326,426,3055,14,3041,697,27,670,3385,2959,426,2223,1821,402,743,81,42,1357
9/1/2015,VA,Virginia,Galax City,51640,1927,1802,125,1466,*,*,461,*,*,1830,1705,125,1429,1330,99,678,58,33,660
9/1/2015,VA,Virginia,Giles,51071,4437,3301,1136,3469,15,3454,968,13,955,4177,3042,1135,3365,2356,1009,774,133,37,2421
9/1/2015,VA,Virginia,Gloucester,51073,7771,6547,1224,6603,29,6574,1168,23,1145,7158,5934,1224,4432,3318,1114,921,177,51,3283
9/1/2015,VA,Virginia,Goochland,51075,5063,4121,942,4568,18,4550,495,18,477,4595,3653,942,3592,2783,809,422,103,35,3032
9/1/2015,VA,Virginia,Grayson,51077,4509,3985,524,3632,*,*,877,*,*,4320,3796,524,3161,2725,436,1013,175,85,1888
9/1/2015,VA,Virginia,Greene,51079,3375,2939,436,2927,12,2915,448,11,437,3090,2654,436,2163,1760,403,417,73,24,1649
9/1/2015,VA,Virginia,Greensville,51081,2401,1797,604,1884,19,1865,517,21,496,2238,1634,604,1831,1295,536,584,122,22,1103
9/1/2015,VA,Virginia,Halifax,51083,9311,8119,1192,7483,55,7428,1828,70,1758,8774,7583,1191,6993,5909,1084,2178,435,130,4250
9/1/2015,VA,Virginia,Hampton City,51650,23414,18183,5231,19041,182,18859,4373,205,4168,21423,16192,5231,12640,7614,5026,3507,754,178,8201
9/1/2015,VA,Virginia,Hanover,51085,18669,14801,3868,16748,68,16680,1921,52,1869,16993,13125,3868,12993,9687,3306,1385,358,98,11152
9/1/2015,VA,Virginia,Harrisonburg City,51660,5018,4449,569,4188,17,4171,830,23,807,4565,3996,569,3503,3077,426,938,120,36,2409
9/1/2015,VA,Virginia,Henrico,51087,51144,39461,11683,44171,307,43864,6973,299,6674,46325,34643,11682,35608,25385,10223,5871,1310,388,28039
9/1/2015,VA,Virginia,Henry,51089,14898,10851,4047,11642,67,11575,3256,62,3194,14190,10143,4047,11888,8675,3213,3166,669,228,7825
9/1/2015,VA,Virginia,Highland,51091,708,646,62,652,*,*,56,*,*,670,608,62,485,427,58,70,*,*,393
9/1/2015,VA,Virginia,Hopewell City,51670,4374,3551,823,3346,27,3319,1028,32,996,4089,3266,823,2727,1927,800,948,153,37,1589
9/1/2015,VA,Virginia,Isle of Wight,51093,7372,5796,1576,6384,36,6348,988,30,958,6844,5268,1576,4780,3291,1489,906,188,73,3613
9/1/2015,VA,Virginia,James City,51095,18308,16171,2137,17148,51,17097,1160,42,1118,16931,14798,2133,10310,8496,1814,865,190,45,9210
9/1/2015,VA,Virginia,King and Queen,51097,1639,1388,251,1364,*,*,275,*,*,1532,1281,251,1134,909,225,271,73,11,779
9/1/2015,VA,Virginia,King George,51099,3436,3105,331,2941,19,2922,495,20,475,2994,2663,331,1472,1163,309,432,84,18,938
9/1/2015,VA,Virginia,King William,51101,3018,2598,420,2562,15,2547,456,25,431,2786,2366,420,2152,1788,364,380,89,22,1661
9/1/2015,VA,Virginia,Lancaster,51103,4175,3621,554,3821,15,3806,354,*,*,4001,3447,554,2755,2360,395,496,82,28,2149
9/1/2015,VA,Virginia,Lee,51105,6300,4171,2129,4171,11,4160,2129,13,2116,5990,3865,2125,4775,2772,2003,1949,242,79,2505
9/1/2015,VA,Virginia,Lexington City,51678,1594,1433,161,1444,14,1430,150,*,*,1494,1333,161,1112,973,139,223,*,*,851
9/1/2015,VA,Virginia,Loudoun,51107,31211,26650,4561,28936,95,28841,2275,110,2165,25962,21406,4556,15984,11856,4128,2678,577,138,12591
9/1/2015,VA,Virginia,Louisa,51109,7136,5957,1179,5915,37,5878,1221,35,1186,6563,5384,1179,4720,3638,1082,1050,242,68,3360
9/1/2015,VA,Virginia,Lunenburg,51111,2934,2529,405,2373,17,2356,561,23,538,2711,2306,405,1997,1620,377,690,122,41,1144
9/1/2015,VA,Virginia,Lynchburg City,51680,14265,12220,2045,11226,84,11142,3039,104,2935,13289,11245,2044,10593,8738,1855,3255,431,148,6759
9/1/2015,VA,Virginia,Madison,51113,2791,2418,373,2447,11,2436,344,*,*,2588,2215,373,1857,1516,341,388,82,25,1362
9/1/2015,VA,Virginia,Manassas City,51683,4060,3403,657,3493,28,3465,567,36,531,3442,2786,656,2286,1669,617,514,97,35,1640
9/1/2015,VA,Virginia,Manassas Park City,51685,1121,924,197,954,*,*,167,16,151,934,738,196,628,445,183,165,50,12,401
9/1/2015,VA,Virginia,Martinsville City,51690,3891,3048,843,2908,17,2891,983,38,945,3719,2876,843,3191,2504,687,1295,167,61,1668
9/1/2015,VA,Virginia,Mathews,51115,2733,2359,374,2501,*,*,232,*,*,2600,2226,374,1717,1394,323,255,48,17,1397
9/1/2015,VA,Virginia,Mecklenburg,51117,8914,7473,1441,7264,48,7216,1650,54,1596,8434,6995,1439,6502,5338,1164,1919,369,122,4092
9/1/2015,VA,Virginia,Middlesex,51119,3391,2885,506,3022,20,3002,369,*,*,3200,2694,506,2353,1962,391,411,85,27,1830
9/1/2015,VA,Virginia,Montgomery,51121,12888,10678,2210,10511,38,10473,2377,33,2344,11744,9534,2210,9302,7214,2088,1831,296,125,7050
9/1/2015,VA,Virginia,Nelson,51125,4210,3645,565,3658,16,3642,552,15,537,3889,3324,565,2796,2277,519,610,102,45,2039
9/1/2015,VA,Virginia,New Kent,51127,3812,3179,633,3361,16,3345,451,11,440,3486,2853,633,2372,1863,509,295,75,21,1981
9/1/2015,VA,Virginia,Newport News City,51700,26236,20129,6107,21420,159,21261,4816,239,4577,24115,18011,6104,15213,9340,5873,4443,769,219,9782
9/1/2015,VA,Virginia,Norfolk City,51710,30806,23672,7134,24229,245,23984,6577,354,6223,27851,20717,7134,18061,11195,6866,6850,1244,272,9695
9/1/2015,VA,Virginia,Northampton,51131,3410,2892,518,2870,27,2843,540,31,509,3192,2674,518,2509,2032,477,898,91,33,1487
9/1/2015,VA,Virginia,Northumberland,51133,4527,3968,559,4170,14,4156,357,*,*,4241,3682,559,2687,2324,363,427,98,34,2128
9/1/2015,VA,Virginia,Norton City,51720,1175,871,304,776,*,*,399,*,*,1088,784,304,856,570,286,362,46,19,429
9/1/2015,VA,Virginia,Nottoway,51135,3544,2904,640,2855,28,2827,689,19,670,3293,2653,640,2526,2041,485,916,127,43,1440
9/1/2015,VA,Virginia,Orange,51137,8198,7215,983,7176,40,7136,1022,36,986,7538,6556,982,4745,3922,823,942,226,65,3512
9/1/2015,VA,Virginia,Page,51139,5865,5168,697,4709,17,4692,1156,17,1139,5485,4788,697,3946,3339,607,1155,209,78,2504
9/1/2015,VA,Virginia,Patrick,51141,5009,3812,1197,4085,12,4073,924,16,908,4786,3590,1196,3816,2797,1019,990,194,81,2551
9/1/2015,VA,Virginia,Petersburg City,51730,7063,5427,1636,5147,94,5053,1916,86,1830,6470,4834,1636,4557,2970,1587,1976,361,76,2144
9/1/2015,VA,Virginia,Pittsylvania,51143,15321,12595,2726,12390,102,12288,2931,80,2851,14534,11808,2726,11721,9322,2399,3073,546,214,7888
9/1/2015,VA,Virginia,Poquoson City,51735,2420,2149,271,2236,*,*,184,0,184,2210,1939,271,1061,813,248,99,*,*,923
9/1/2015,VA,Virginia,Portsmouth City,51740,17485,13300,4185,13342,182,13160,4143,211,3932,15703,11518,4185,10025,6009,4016,3864,653,157,5351
9/1/2015,VA,Virginia,Powhatan,51145,5307,4279,1028,4682,22,4660,625,14,611,4872,3844,1028,3711,2791,920,380,103,34,3194
9/1/2015,VA,Virginia,Prince Edward,51147,4426,3657,769,3498,25,3473,928,34,894,4132,3363,769,3133,2514,619,1059,167,44,1863
9/1/2015,VA,Virginia,Prince George,51149,5372,4691,681,4495,25,4470,877,22,855,4959,4278,681,2816,2187,629,535,106,26,2149
9/1/2015,VA,Virginia,Prince William,51153,41820,35028,6792,36963,225,36738,4857,285,4572,35736,28948,6788,19572,13275,6297,4623,929,189,13831
9/1/2015,VA,Virginia,Pulaski,51155,8831,7249,1582,6858,23,6835,1973,30,1943,8243,6661,1582,6255,4760,1495,1678,331,118,4128
9/1/2015,VA,Virginia,Radford City,51750,1978,1615,363,1583,*,*,395,*,*,1816,1453,363,1478,1134,344,322,43,26,1087
9/1/2015,VA,Virginia,Rappahannock,51157,1916,1767,149,1751,*,*,165,*,*,1735,1586,149,1093,969,124,159,38,12,884
9/1/2015,VA,Virginia,Richmond,51159,1844,1498,346,1586,13,1573,258,11,247,1738,1392,346,1236,988,248,293,88,22,833
9/1/2015,VA,Virginia,Richmond City,51760,31834,22386,9448,24453,251,24202,7381,356,7025,28699,19251,9448,23237,14179,9058,8390,1392,318,13137
9/1/2015,VA,Virginia,Roanoke,51161,22020,17888,4132,19302,81,19221,2718,46,2672,20394,16262,4132,15673,11900,3773,1927,422,149,13175
9/1/2015,VA,Virginia,Roanoke City,51770,19770,14616,5154,14530,112,14418,5240,150,5090,18159,13008,5151,14357,9425,4932,4783,794,218,8562
9/1/2015,VA,Virginia,Rockbridge,51163,5632,4753,879,4724,18,4706,908,*,*,5245,4366,879,3841,3106,735,834,168,61,2778
9/1/2015,VA,Virginia,Rockingham,51165,16076,13624,2452,13957,44,13913,2119,49,2070,14864,12413,2451,11209,9426,1783,1777,494,144,8794
9/1/2015,VA,Virginia,Russell,51167,7684,5329,2355,5053,12,5041,2631,*,*,7349,4994,2355,6170,4227,1943,1744,304,129,3993
9/1/2015,VA,Virginia,Salem City,51775,5807,4782,1025,4850,26,4824,957,18,939,5314,4289,1025,4103,3155,948,814,141,41,3107
9/1/2015,VA,Virginia,Scott,51169,6469,3370,3099,4766,13,4753,1703,11,1692,6202,3103,3099,5314,2271,3043,1546,251,108,3409
9/1/2015,VA,Virginia,Shenandoah,51171,9831,8731,1100,8588,15,8573,1243,27,1216,9214,8114,1100,6199,5291,908,1258,238,101,4602
9/1/2015,VA,Virginia,Smyth,51173,8672,6837,1835,6326,17,6309,2346,28,2318,8191,6356,1835,6530,4879,1651,2158,400,156,3816
9/1/2015,VA,Virginia,Southampton,51175,3929,3313,616,3236,24,3212,693,27,666,3668,3052,616,2810,2264,546,740,137,34,1899
9/1/2015,VA,Virginia,Spotsylvania,51177,18300,16151,2149,15709,105,15604,2591,92,2499,16329,14181,2148,9568,7694,1874,1832,471,118,7147
9/1/2015,VA,Virginia,Stafford,51179,14825,13471,1354,12908,71,12837,1917,93,1824,13034,11681,1353,6342,5168,1174,1225,343,82,4692
9/1/2015,VA,Virginia,Staunton City,51790,5801,5007,794,4684,20,4664,1117,28,1089,5454,4660,794,4176,3487,689,1074,154,49,2899
9/1/2015,VA,Virginia,Suffolk City,51800,14446,11792,2654,11638,77,11561,2808,92,2716,13223,10570,2653,8803,6375,2428,2615,394,112,5682
9/1/2015,VA,Virginia,Surry,51181,1463,1115,348,1217,11,1206,246,13,233,1352,1004,348,979,651,328,222,66,14,677
9/1/2015,VA,Virginia,Sussex,51183,2300,1816,484,1843,32,1811,457,*,*,2151,1667,484,1623,1167,456,484,139,25,975
9/1/2015,VA,Virginia,Tazewell,51185,11569,8479,3090,8338,37,8301,3231,36,3195,10947,7859,3088,8529,6531,1998,2223,429,170,5707
9/1/2015,VA,Virginia,Unknown,51999,*,*,*,*,*,*,*,*,*,*,*,*,*,*,*,*,*,*,*
9/1/2015,VA,Virginia,Virginia Beach City,51810,64167,54076,10091,56143,297,55846,8024,323,7701,58778,48694,10084,32001,22600,9401,6411,1272,343,23975
9/1/2015,VA,Virginia,Warren,51187,6882,6230,652,5813,19,5794,1069,27,1042,6268,5616,652,4067,3521,546,863,227,70,2907
9/1/2015,VA,Virginia,Washington,51191,14476,10005,4471,11306,55,11251,3170,24,3146,13653,9183,4470,10797,6678,4119,2538,511,178,7570
9/1/2015,VA,Virginia,Waynesboro City,51820,4688,3996,692,3816,19,3797,872,22,850,4400,3708,692,3429,2822,607,876,100,48,2405
9/1/2015,VA,Virginia,Westmoreland,51193,4611,4026,585,4009,24,3985,602,11,591,4216,3631,585,2556,2058,498,734,120,39,1663
9/1/2015,VA,Virginia,Williamsburg City,51830,2399,2062,337,2193,*,*,206,*,*,2180,1844,336,1472,1179,293,209,*,*,1231
9/1/2015,VA,Virginia,Winchester City,51840,4918,4416,502,4175,18,4157,743,18,725,4478,3976,502,3138,2702,436,806,124,40,2168
9/1/2015,VA,Virginia,Wise,51195,10312,6926,3386,6656,14,6642,3656,20,3636,9723,6338,3385,7541,4356,3185,2421,479,160,4481
9/1/2015,VA,Virginia,Wythe,51197,7315,5694,1621,5595,26,5569,1720,24,1696,6918,5297,1621,5275,3855,1420,1500,276,99,3400
9/1/2015,VA,Virginia,York,51199,10841,9545,1296,9901,46,9855,940,32,908,9935,8639,1296,5119,3915,1204,648,160,41,4270
4/1/2016,VA,Virginia,Accomack,51001,8433,7234,1199,7206,49,7157,1227,45,1182,7873,6674,1199,5746,4720,1026,1525,381,96,3744
4/1/2016,VA,Virginia,Albemarle,51003,18678,16676,2002,17104,60,17044,1574,61,1513,16770,14768,2002,12554,10773,1781,1453,279,90,10732
4/1/2016,VA,Virginia,Alexandria City,51510,16486,14303,2183,15095,75,15020,1391,90,1301,13242,11061,2181,7749,5693,2056,1970,321,67,5391
4/1/2016,VA,Virginia,Alleghany,51005,4499,3852,647,3595,18,3577,904,15,889,4269,3622,647,3409,2900,509,812,106,55,2436
4/1/2016,VA,Virginia,Amelia,51007,2913,2272,641,2430,12,2418,483,13,470,2688,2047,641,2077,1484,593,468,75,39,1495
4/1/2016,VA,Virginia,Amherst,51009,7463,6282,1181,6172,48,6124,1291,33,1258,6942,5761,1181,5553,4461,1092,1154,226,82,4091
4/1/2016,VA,Virginia,Appomattox,51011,3720,3156,564,3020,18,3002,700,21,679,3511,2947,564,2801,2285,516,676,92,40,1993
4/1/2016,VA,Virginia,Arlington,51013,22580,19718,2862,20976,86,20890,1604,86,1518,17854,14992,2862,10414,7715,2699,2855,317,112,7130
4/1/2016,VA,Virginia,Augusta,51015,17024,14635,2389,14606,49,14557,2418,43,2375,15975,13586,2389,12057,10070,1987,1788,397,151,9721
4/1/2016,VA,Virginia,Bath,51017,1255,1143,112,1106,*,*,149,*,*,1178,1066,112,920,827,93,178,34,23,685
4/1/2016,VA,Virginia,Bedford,51019,18423,15072,3351,15660,75,15585,2763,44,2719,17200,13851,3349,13286,10518,2768,1959,483,157,10687
4/1/2016,VA,Virginia,Bland,51021,1738,1359,379,1359,*,*,379,*,*,1628,1249,379,1230,1025,205,262,47,19,902
4/1/2016,VA,Virginia,Botetourt,51023,8158,6377,1781,7057,43,7014,1101,20,1081,7539,5758,1781,5854,4234,1620,816,197,60,4781
4/1/2016,VA,Virginia,Bristol City,51520,4419,2683,1736,3429,18,3411,990,*,*,4149,2413,1736,3464,1778,1686,1005,150,60,2249
4/1/2016,VA,Virginia,Brunswick,51025,3880,3200,680,3154,28,3126,726,27,699,3647,2967,680,2845,2225,620,1108,110,42,1585
4/1/2016,VA,Virginia,Buchanan,51027,7315,4508,2807,4533,17,4516,2782,11,2771,7000,4193,2807,5794,3805,1989,1615,412,120,3647
4/1/2016,VA,Virginia,Buckingham,51029,3358,2765,593,2704,20,2684,654,12,642,3125,2532,593,2362,1976,386,709,146,42,1465
4/1/2016,VA,Virginia,Buena Vista City,51530,1440,1180,260,1161,*,*,279,*,*,1353,1093,260,1048,834,214,319,62,20,647
4/1/2016,VA,Virginia,Campbell,51031,12234,10263,1971,10033,86,9947,2201,65,2136,11481,9510,1971,9205,7394,1811,2068,370,173,6594
4/1/2016,VA,Virginia,Caroline,51033,5435,4509,926,4530,28,4502,905,39,866,4923,3997,926,3347,2498,849,779,240,52,2276
4/1/2016,VA,Virginia,Carroll,51035,7798,6703,1095,6248,22,6226,1550,19,1531,7389,6294,1095,5694,4797,897,1612,276,106,3700
4/1/2016,VA,Virginia,Charles City,51036,1775,1369,406,1506,17,1489,269,11,258,1636,1230,406,1230,881,349,252,77,19,882
4/1/2016,VA,Virginia,Charlotte,51037,3282,2776,506,2666,16,2650,616,15,601,3094,2588,506,2427,1977,450,777,129,52,1469
4/1/2016,VA,Virginia,Charlottesville City,51540,5929,5170,759,4825,25,4800,1104,50,1054,5313,4555,758,4206,3484,722,1204,151,53,2798
4/1/2016,VA,Virginia,Chesapeake City,51550,34561,28117,6444,29499,257,29242,5062,229,4833,31224,24780,6444,18938,12913,6025,3970,845,237,13886
4/1/2016,VA,Virginia,Chesterfield,51041,53983,41854,12129,46690,173,46517,7293,247,7046,48677,36550,12127,36669,25539,11130,5104,967,280,30318
4/1/2016,VA,Virginia,Clarke,51043,3012,2690,322,2762,15,2747,250,*,*,2737,2415,322,1829,1560,269,258,77,34,1460
4/1/2016,VA,Virginia,Colonial Heights City,51570,4104,3538,566,3538,13,3525,566,12,554,3771,3205,566,2359,1834,525,448,100,23,1788
4/1/2016,VA,Virginia,Covington City,51580,1640,1418,222,1273,*,*,367,*,*,1526,1304,222,1197,988,209,361,53,16,767
4/1/2016,VA,Virginia,Craig,51045,1262,1005,257,983,*,*,279,*,*,1161,904,257,909,661,248,203,39,11,656
4/1/2016,VA,Virginia,Culpeper,51047,8585,7513,1072,7395,51,7344,1190,37,1153,7787,6715,1072,5325,4366,959,1102,250,66,3907
4/1/2016,VA,Virginia,Cumberland,51049,2180,1697,483,1798,*,*,382,*,*,2023,1540,483,1566,1124,442,422,88,24,1032
4/1/2016,VA,Virginia,Danville City,51590,11057,8805,2252,8674,84,8590,2383,118,2265,10477,8225,2252,8663,7291,1372,3171,441,154,4897
4/1/2016,VA,Virginia,Dickenson,51051,4669,2985,1684,2878,*,*,1791,12,1779,4453,2769,1684,3626,2115,1511,1089,218,79,2240
4/1/2016,VA,Virginia,Dinwiddie,51053,5559,4424,1135,4451,36,4415,1108,34,1074,5118,3983,1135,3744,2656,1088,880,185,55,2624
4/1/2016,VA,Virginia,Emporia City,51595,1134,856,278,862,15,847,272,14,258,1062,784,278,868,639,229,412,*,*,379
4/1/2016,VA,Virginia,Essex,51057,2731,2263,468,2319,17,2302,412,12,400,2551,2083,468,1889,1540,349,406,94,24,1365
4/1/2016,VA,Virginia,Fairfax,51059,137596,119726,17870,129629,522,129107,7967,414,7553,111264,93425,17839,63003,46435,16568,12716,2624,460,47203
4/1/2016,VA,Virginia,Fairfax City,51600,3606,3102,504,3333,15,3318,273,*,*,3020,2516,504,1790,1325,465,376,*,*,1348
4/1/2016,VA,Virginia,Falls Church City,51610,1771,1538,233,1688,*,*,83,*,*,1387,1154,233,828,615,213,127,*,*,678
4/1/2016,VA,Virginia,Fauquier,51061,11462,10443,1019,10373,51,10322,1089,44,1045,10122,9104,1018,6345,5471,874,911,207,59,5168
4/1/2016,VA,Virginia,Floyd,51063,3825,3091,734,3282,11,3271,543,*,*,3563,2829,734,2765,2088,677,538,98,52,2077
4/1/2016,VA,Virginia,Fluvanna,51065,5422,4686,736,4854,22,4832,568,22,546,4957,4221,736,3578,2924,654,480,124,21,2953
4/1/2016,VA,Virginia,Franklin,51067,13889,10282,3607,11491,49,11442,2398,27,2371,13042,9435,3607,10510,7096,3414,1943,483,158,7926
4/1/2016,VA,Virginia,Franklin City,51620,1875,1569,306,1469,19,1450,406,18,388,1757,1451,306,1435,1151,284,534,64,15,822
4/1/2016,VA,Virginia,Frederick,51069,14890,13159,1731,13189,49,13140,1701,47,1654,13573,11842,1731,9208,7730,1478,1404,347,133,7324
4/1/2016,VA,Virginia,Fredericksburg City,51630,3777,3331,446,3098,18,3080,679,25,654,3403,2957,446,2296,1875,421,742,83,40,1431
4/1/2016,VA,Virginia,Galax City,51640,1944,1804,140,1501,*,*,443,11,432,1839,1699,140,1457,1342,115,669,65,32,691
4/1/2016,VA,Virginia,Giles,51071,4467,3396,1071,3518,21,3497,949,15,934,4208,3138,1070,3397,2693,704,787,134,35,2441
4/1/2016,VA,Virginia,Gloucester,51073,7867,6625,1242,6712,36,6676,1155,19,1136,7263,6021,1242,4592,3464,1128,925,177,50,3440
4/1/2016,VA,Virginia,Goochland,51075,5193,4208,985,4715,19,4696,478,19,459,4704,3719,985,3776,2935,841,409,93,30,3244
4/1/2016,VA,Virginia,Grayson,51077,4551,3964,587,3707,11,3696,844,*,*,4351,3764,587,3239,2756,483,985,177,83,1994
4/1/2016,VA,Virginia,Greene,51079,3454,2995,459,3014,*,*,440,*,*,3161,2702,459,2266,1844,422,436,82,24,1724
4/1/2016,VA,Virginia,Greensville,51081,2406,1805,601,1914,21,1893,492,18,474,2249,1648,601,1843,1328,515,565,131,27,1120
4/1/2016,VA,Virginia,Halifax,51083,9378,8122,1256,7599,63,7536,1779,67,1712,8847,7591,1256,7088,5970,1118,2114,464,139,4371
4/1/2016,VA,Virginia,Hampton City,51650,23738,18342,5396,19465,211,19254,4273,200,4073,21692,16296,5396,12990,7801,5189,3485,801,183,8521
4/1/2016,VA,Virginia,Hanover,51085,19204,15125,4079,17302,79,17223,1902,54,1848,17487,13408,4079,13675,10143,3532,1375,348,90,11862
4/1/2016,VA,Virginia,Harrisonburg City,51660,5074,4493,581,4263,16,4247,811,23,788,4612,4031,581,3609,3183,426,928,134,39,2508
4/1/2016,VA,Virginia,Henrico,51087,52157,39900,12257,45268,329,44939,6889,293,6596,47200,34943,12257,37180,26270,10910,5921,1366,384,29509
4/1/2016,VA,Virginia,Henry,51089,14889,10762,4127,11775,78,11697,3114,58,3056,14181,10054,4127,11966,8674,3292,2998,704,248,8016
4/1/2016,VA,Virginia,Highland,51091,710,649,61,654,*,*,56,*,*,668,607,61,491,432,59,63,*,*,404
4/1/2016,VA,Virginia,Hopewell City,51670,4382,3552,830,3378,30,3348,1004,38,966,4089,3259,830,2761,1950,811,916,157,37,1651
4/1/2016,VA,Virginia,Isle of Wight,51093,7515,5902,1613,6570,52,6518,945,26,919,6970,5357,1613,4926,3412,1514,895,193,76,3762
4/1/2016,VA,Virginia,James City,51095,18814,16567,2247,17675,63,17612,1139,45,1094,17385,15141,2244,10896,9004,1892,829,192,45,9830
4/1/2016,VA,Virginia,King and Queen,51097,1672,1400,272,1403,*,*,269,*,*,1559,1287,272,1164,922,242,259,77,13,815
4/1/2016,VA,Virginia,King George,51099,3545,3183,362,3032,16,3016,513,23,490,3076,2714,362,1566,1231,335,442,84,14,1026
4/1/2016,VA,Virginia,King William,51101,3103,2669,434,2649,23,2626,454,25,429,2857,2423,434,2264,1874,390,371,99,18,1776
4/1/2016,VA,Virginia,Lancaster,51103,4188,3651,537,3858,17,3841,330,11,319,4003,3466,537,2840,2466,374,466,92,24,2258
4/1/2016,VA,Virginia,Lee,51105,6293,4045,2248,4251,16,4235,2042,12,2030,5979,3733,2246,4840,2718,2122,1905,250,72,2613
4/1/2016,VA,Virginia,Lexington City,51678,1590,1435,155,1455,15,1440,135,*,*,1481,1326,155,1113,984,129,214,*,*,860
4/1/2016,VA,Virginia,Loudoun,51107,32445,27695,4750,30180,118,30062,2265,110,2155,26953,22209,4744,17397,13066,4331,2753,612,138,13894
4/1/2016,VA,Virginia,Louisa,51109,7318,6101,1217,6128,39,6089,1190,35,1155,6740,5523,1217,4952,3827,1125,1046,246,71,3589
4/1/2016,VA,Virginia,Lunenburg,51111,2946,2554,392,2397,16,2381,549,20,529,2719,2327,392,2013,1650,363,684,130,46,1153
4/1/2016,VA,Virginia,Lynchburg City,51680,14480,12304,2176,11538,92,11446,2942,105,2837,13488,11313,2175,10901,8922,1979,3232,429,147,7093
4/1/2016,VA,Virginia,Madison,51113,2829,2449,380,2490,*,*,339,*,*,2630,2250,380,1908,1564,344,383,86,27,1412
4/1/2016,VA,Virginia,Manassas City,51683,4165,3483,682,3618,34,3584,547,41,506,3505,2823,682,2398,1755,643,513,91,36,1758
4/1/2016,VA,Virginia,Manassas Park City,51685,1156,946,210,994,11,983,162,15,147,967,758,209,675,483,192,165,56,13,441
4/1/2016,VA,Virginia,Martinsville City,51690,3923,3060,863,2943,27,2916,980,40,940,3714,2851,863,3199,2482,717,1277,172,57,1693
4/1/2016,VA,Virginia,Mathews,51115,2765,2379,386,2532,*,*,233,*,*,2623,2237,386,1775,1449,326,254,43,20,1458
4/1/2016,VA,Virginia,Mecklenburg,51117,8888,7430,1458,7324,54,7270,1564,51,1513,8399,6941,1458,6533,5361,1172,1882,379,115,4157
4/1/2016,VA,Virginia,Middlesex,51119,3457,2963,494,3075,22,3053,382,*,*,3249,2755,494,2460,2096,364,433,89,31,1907
4/1/2016,VA,Virginia,Montgomery,51121,13055,10795,2260,10748,46,10702,2307,36,2271,11854,9594,2260,9488,7346,2142,1800,313,113,7262
4/1/2016,VA,Virginia,Nelson,51125,4270,3703,567,3748,17,3731,522,12,510,3937,3370,567,2850,2329,521,563,101,44,2142
4/1/2016,VA,Virginia,New Kent,51127,3954,3303,651,3513,15,3498,441,*,*,3609,2958,651,2477,1954,523,276,73,14,2114
4/1/2016,VA,Virginia,Newport News City,51700,26592,20164,6428,21782,180,21602,4810,249,4561,24378,17951,6427,15647,9443,6204,4470,828,223,10126
4/1/2016,VA,Virginia,Norfolk City,51710,31081,23609,7472,24638,278,24360,6443,344,6099,28003,20531,7472,18445,11239,7206,6730,1287,277,10151
4/1/2016,VA,Virginia,Northampton,51131,3468,2913,555,2940,29,2911,528,25,503,3230,2675,555,2571,2061,510,903,95,34,1539
4/1/2016,VA,Virginia,Northumberland,51133,4512,3943,569,4178,18,4160,334,*,*,4217,3648,569,2743,2383,360,404,95,31,2213
4/1/2016,VA,Virginia,Norton City,51720,1174,856,318,787,*,*,387,*,*,1093,775,318,874,575,299,355,46,19,454
4/1/2016,VA,Virginia,Nottoway,51135,3628,2976,652,2944,32,2912,684,14,670,3369,2717,652,2618,2183,435,940,128,40,1510
4/1/2016,VA,Virginia,Orange,51137,8294,7346,948,7305,47,7258,989,37,952,7619,6671,948,4879,4177,702,909,216,73,3681
4/1/2016,VA,Virginia,Page,51139,5935,5223,712,4815,20,4795,1120,18,1102,5558,4846,712,4060,3444,616,1132,214,84,2630
4/1/2016,VA,Virginia,Patrick,51141,5052,3825,1227,4151,11,4140,901,14,887,4809,3583,1226,3884,2833,1051,982,207,79,2616
4/1/2016,VA,Virginia,Petersburg City,51730,7051,5374,1677,5220,107,5113,1831,78,1753,6446,4769,1677,4601,2969,1632,1946,348,72,2235
4/1/2016,VA,Virginia,Pittsylvania,51143,15544,12146,3398,12659,112,12547,2885,77,2808,14722,11324,3398,12035,9537,2498,3017,568,212,8238
4/1/2016,VA,Virginia,Poquoson City,51735,2434,2150,284,2269,*,*,165,*,*,2242,1958,284,1099,838,261,90,28,12,969
4/1/2016,VA,Virginia,Portsmouth City,51740,17525,13164,4361,13531,190,13341,3994,206,3788,15700,11341,4359,10234,6037,4197,3750,684,154,5646
4/1/2016,VA,Virginia,Powhatan,51145,5482,4413,1069,4864,20,4844,618,15,603,5031,3962,1069,3883,2930,953,382,109,33,3359
4/1/2016,VA,Virginia,Prince Edward,51147,4515,3716,799,3603,27,3576,912,32,880,4199,3400,799,3217,2600,617,1066,168,45,1938
4/1/2016,VA,Virginia,Prince George,51149,5492,4791,701,4640,27,4613,852,21,831,5063,4362,701,2982,2337,645,556,110,24,2292
4/1/2016,VA,Virginia,Prince William,51153,42939,35780,7159,38097,255,37842,4842,279,4563,36681,29525,7156,20929,14242,6687,4782,965,214,14968
4/1/2016,VA,Virginia,Pulaski,51155,8863,7240,1623,6976,32,6944,1887,28,1859,8288,6665,1623,6339,4805,1534,1631,321,115,4272
4/1/2016,VA,Virginia,Radford City,51750,1983,1614,369,1592,*,*,391,*,*,1819,1450,369,1489,1136,353,332,38,23,1096
4/1/2016,VA,Virginia,Rappahannock,51157,1952,1798,154,1798,*,*,154,*,*,1766,1613,153,1171,1044,127,153,39,11,968
4/1/2016,VA,Virginia,Richmond,51159,1895,1544,351,1638,15,1623,257,14,243,1782,1431,351,1296,1052,244,298,92,21,885
4/1/2016,VA,Virginia,Richmond City,51760,32068,22318,9750,25013,291,24722,7055,354,6701,28805,19055,9750,23712,14323,9389,8272,1395,303,13742
4/1/2016,VA,Virginia,Roanoke,51161,22352,17953,4399,19756,93,19663,2596,51,2545,20716,16318,4398,16177,12168,4009,1885,431,147,13714
4/1/2016,VA,Virginia,Roanoke City,51770,19864,14446,5418,14782,138,14644,5082,148,4934,18216,12800,5416,14559,9376,5183,4631,861,213,8854
4/1/2016,VA,Virginia,Rockbridge,51163,5713,4836,877,4815,20,4795,898,*,*,5329,4452,877,3943,3218,725,826,171,58,2888
4/1/2016,VA,Virginia,Rockingham,51165,16319,13906,2413,14265,46,14219,2054,41,2013,15058,12645,2413,11515,9786,1729,1720,508,158,9129
4/1/2016,VA,Virginia,Russell,51167,7649,5165,2484,5150,14,5136,2499,*,*,7322,4838,2484,6216,4149,2067,1672,314,123,4107
4/1/2016,VA,Virginia,Salem City,51775,5875,4806,1069,4926,31,4895,949,22,927,5395,4326,1069,4203,3218,985,822,155,42,3184
4/1/2016,VA,Virginia,Scott,51169,6519,3339,3180,4850,*,*,1669,14,1655,6250,3070,3180,5387,2262,3125,1530,245,120,3492
4/1/2016,VA,Virginia,Shenandoah,51171,10000,8852,1148,8777,24,8753,1223,25,1198,9366,8218,1148,6507,5543,964,1260,240,100,4907
4/1/2016,VA,Virginia,Smyth,51173,8734,6778,1956,6470,21,6449,2264,24,2240,8215,6259,1956,6624,4869,1755,2134,408,145,3937
4/1/2016,VA,Virginia,Southampton,51175,3966,3331,635,3283,28,3255,683,26,657,3708,3073,635,2868,2308,560,733,130,34,1971
4/1/2016,VA,Virginia,Spotsylvania,51177,18924,16631,2293,16337,113,16224,2587,90,2497,16843,14551,2292,10116,8136,1980,1853,479,131,7653
4/1/2016,VA,Virginia,Stafford,51179,15286,13865,1421,13407,84,13323,1879,88,1791,13437,12016,1421,6762,5528,1234,1231,357,72,5102
4/1/2016,VA,Virginia,Staunton City,51790,5864,5016,848,4788,23,4765,1076,26,1050,5498,4650,848,4250,3513,737,1036,157,59,2998
4/1/2016,VA,Virginia,Suffolk City,51800,14784,11807,2977,11997,87,11910,2787,93,2694,13537,10560,2977,9337,6585,2752,2598,431,107,6201
4/1/2016,VA,Virginia,Surry,51181,1492,1145,347,1245,12,1233,247,13,234,1380,1033,347,1004,679,325,203,77,15,709
4/1/2016,VA,Virginia,Sussex,51183,2311,1806,505,1883,32,1851,428,*,*,2149,1644,505,1646,1170,476,488,136,18,1004
4/1/2016,VA,Virginia,Tazewell,51185,11652,8509,3143,8531,36,8495,3121,38,3083,11005,7864,3141,8632,6643,1989,2208,441,178,5805
4/1/2016,VA,Virginia,Unknown,51999,*,*,*,*,*,*,*,*,*,*,*,*,*,*,*,*,*,*,*
4/1/2016,VA,Virginia,Virginia Beach City,51810,65587,54941,10646,57664,346,57318,7923,337,7586,60067,49427,10640,33498,23536,9962,6426,1329,356,25387
4/1/2016,VA,Virginia,Warren,51187,6957,6285,672,5926,24,5902,1031,24,1007,6337,5665,672,4234,3663,571,835,236,71,3092
4/1/2016,VA,Virginia,Washington,51191,14654,9995,4659,11603,52,11551,3051,27,3024,13793,9135,4658,11059,6757,4302,2462,510,175,7912
4/1/2016,VA,Virginia,Waynesboro City,51820,4702,3983,719,3822,19,3803,880,25,855,4403,3684,719,3478,2850,628,854,109,43,2472
4/1/2016,VA,Virginia,Westmoreland,51193,4667,4059,608,4077,24,4053,590,11,579,4276,3668,608,2664,2140,524,729,122,51,1762
4/1/2016,VA,Virginia,Williamsburg City,51830,2483,2106,377,2275,*,*,208,*,*,2263,1887,376,1569,1248,321,213,*,*,1321
4/1/2016,VA,Virginia,Winchester City,51840,4971,4425,546,4222,20,4202,749,18,731,4525,3979,546,3240,2772,468,816,125,49,2250
4/1/2016,VA,Virginia,Wise,51195,10404,6902,3502,6875,17,6858,3529,22,3507,9813,6312,3501,7711,4402,3309,2411,479,154,4667
4/1/2016,VA,Virginia,Wythe,51197,7332,5668,1664,5674,31,5643,1658,21,1637,6946,5282,1664,5345,3878,1467,1456,270,108,3511
4/1/2016,VA,Virginia,York,51199,10929,9611,1318,10026,43,9983,903,28,875,10023,8705,1318,5242,4028,1214,598,164,38,4442
8/1/2016,VA,Virginia,Accomack,51001,8490,7286,1204,7245,46,7199,1245,47,1198,7930,6726,1204,5785,4753,1032,1541,378,97,3769
8/1/2016,VA,Virginia,Albemarle,51003,18904,16909,1995,17305,56,17249,1599,58,1541,16998,15003,1995,12707,10937,1770,1486,277,92,10852
8/1/2016,VA,Virginia,Alexandria City,51510,16713,14501,2212,15292,69,15223,1421,88,1333,13477,11267,2210,7867,5780,2087,2032,321,71,5443
8/1/2016,VA,Virginia,Alleghany,51005,4510,3873,637,3595,17,3578,915,16,899,4289,3652,637,3411,2909,502,822,102,54,2433
8/1/2016,VA,Virginia,Amelia,51007,2933,2291,642,2452,12,2440,481,12,469,2713,2071,642,2094,1498,596,475,77,38,1504
8/1/2016,VA,Virginia,Amherst,51009,7508,6319,1189,6208,46,6162,1300,30,1270,6986,5797,1189,5590,4489,1101,1172,233,80,4105
8/1/2016,VA,Virginia,Appomattox,51011,3733,3167,566,3024,15,3009,709,20,689,3523,2957,566,2798,2281,517,677,91,37,1993
8/1/2016,VA,Virginia,Arlington,51013,22915,20030,2885,21283,83,21200,1632,88,1544,18170,15285,2885,10570,7847,2723,2922,324,115,7209
8/1/2016,VA,Virginia,Augusta,51015,17235,14845,2390,14780,44,14736,2455,42,2413,16181,13791,2390,12225,10237,1988,1847,397,153,9828
8/1/2016,VA,Virginia,Bath,51017,1266,1151,115,1113,*,*,153,*,*,1194,1079,115,926,829,97,176,35,24,691
8/1/2016,VA,Virginia,Bedford,51019,18623,15281,3342,15818,73,15745,2805,45,2760,17394,14054,3340,13408,10650,2758,1986,472,156,10794
8/1/2016,VA,Virginia,Bland,51021,1751,1367,384,1365,*,*,386,*,*,1650,1266,384,1241,1031,210,262,47,20,912
8/1/2016,VA,Virginia,Botetourt,51023,8245,6445,1800,7120,41,7079,1125,20,1105,7624,5824,1800,5917,4271,1646,826,188,61,4842
8/1/2016,VA,Virginia,Bristol City,51520,4429,2684,1745,3426,16,3410,1003,*,*,4156,2411,1745,3474,1780,1694,1011,150,57,2256
8/1/2016,VA,Virginia,Brunswick,51025,3912,3232,680,3165,28,3137,747,27,720,3678,2998,680,2858,2238,620,1127,109,43,1579
8/1/2016,VA,Virginia,Buchanan,51027,7320,4527,2793,4505,17,4488,2815,11,2804,7025,4232,2793,5796,3814,1982,1635,412,116,3633
8/1/2016,VA,Virginia,Buckingham,51029,3392,2805,587,2729,18,2711,663,15,648,3163,2576,587,2388,2004,384,724,143,46,1475
8/1/2016,VA,Virginia,Buena Vista City,51530,1441,1179,262,1159,*,*,282,*,*,1349,1087,262,1045,828,217,321,63,20,641
8/1/2016,VA,Virginia,Campbell,51031,12306,10331,1975,10072,80,9992,2234,65,2169,11556,9581,1975,9259,7447,1812,2108,370,171,6610
8/1/2016,VA,Virginia,Caroline,51033,5496,4563,933,4572,27,4545,924,40,884,4977,4044,933,3371,2516,855,802,236,53,2280
8/1/2016,VA,Virginia,Carroll,51035,7850,6759,1091,6279,21,6258,1571,18,1553,7437,6346,1091,5719,4827,892,1626,278,104,3711
8/1/2016,VA,Virginia,Charles City,51036,1800,1394,406,1526,17,1509,274,12,262,1655,1249,406,1243,894,349,260,78,17,888
8/1/2016,VA,Virginia,Charlotte,51037,3299,2799,500,2670,15,2655,629,16,613,3126,2627,499,2447,2003,444,798,126,52,1471
8/1/2016,VA,Virginia,Charlottesville City,51540,6012,5256,756,4895,25,4870,1117,49,1068,5412,4656,756,4278,3559,719,1232,156,52,2838
8/1/2016,VA,Virginia,Chesapeake City,51550,34988,28447,6541,29798,235,29563,5190,234,4956,31709,25168,6541,19170,13055,6115,4075,842,246,14007
8/1/2016,VA,Virginia,Chesterfield,51041,54701,42430,12271,47309,158,47151,7392,244,7148,49416,37147,12269,37247,25968,11279,5228,989,286,30744
8/1/2016,VA,Virginia,Clarke,51043,3043,2725,318,2789,14,2775,254,*,*,2750,2432,318,1830,1564,266,263,73,34,1460
8/1/2016,VA,Virginia,Colonial Heights City,51570,4118,3543,575,3540,12,3528,578,14,564,3795,3220,575,2394,1860,534,472,101,23,1798
8/1/2016,VA,Virginia,Covington City,51580,1642,1412,230,1270,*,*,372,*,*,1532,1302,230,1205,988,217,363,54,19,769
8/1/2016,VA,Virginia,Craig,51045,1272,1009,263,987,*,*,285,*,*,1173,910,263,909,656,253,203,39,11,656
8/1/2016,VA,Virginia,Culpeper,51047,8678,7606,1072,7465,45,7420,1213,37,1176,7875,6803,1072,5380,4420,960,1126,254,65,3935
8/1/2016,VA,Virginia,Cumberland,51049,2194,1708,486,1806,*,*,388,*,*,2032,1546,486,1576,1132,444,428,83,25,1040
8/1/2016,VA,Virginia,Danville City,51590,11070,8817,2253,8646,77,8569,2424,120,2304,10501,8248,2253,8668,7300,1368,3220,431,160,4857
8/1/2016,VA,Virginia,Dickenson,51051,4675,2992,1683,2862,*,*,1813,14,1799,4466,2783,1683,3624,2109,1515,1099,213,83,2229
8/1/2016,VA,Virginia,Dinwiddie,51053,5609,4467,1142,4487,33,4454,1122,34,1088,5165,4023,1142,3773,2679,1094,899,181,54,2639
8/1/2016,VA,Virginia,Emporia City,51595,1142,863,279,868,13,855,274,14,260,1071,792,279,872,641,231,424,*,*,372
8/1/2016,VA,Virginia,Essex,51057,2759,2285,474,2342,18,2324,417,11,406,2582,2108,474,1905,1551,354,422,89,23,1371
8/1/2016,VA,Virginia,Fairfax,51059,140023,121816,18207,131899,497,131402,8124,417,7707,113581,95402,18179,64084,47188,16896,13010,2607,471,47996
8/1/2016,VA,Virginia,Fairfax City,51600,3655,3134,521,3383,14,3369,272,*,*,3070,2549,521,1827,1345,482,378,58,11,1380
8/1/2016,VA,Virginia,Falls Church City,51610,1785,1548,237,1700,*,*,85,*,*,1403,1166,237,830,613,217,131,*,*,677
8/1/2016,VA,Virginia,Fauquier,51061,11599,10429,1170,10494,48,10446,1105,43,1062,10272,9103,1169,6410,5382,1028,923,206,59,5222
8/1/2016,VA,Virginia,Floyd,51063,3878,3137,741,3330,*,*,548,*,*,3620,2879,741,2793,2108,685,550,97,50,2096
8/1/2016,VA,Virginia,Fluvanna,51065,5484,4743,741,4903,20,4883,581,22,559,5021,4280,741,3611,2955,656,487,125,22,2977
8/1/2016,VA,Virginia,Franklin,51067,13999,10369,3630,11561,46,11515,2438,29,2409,13169,9539,3630,10575,7136,3439,1982,471,156,7966
8/1/2016,VA,Virginia,Franklin City,51620,1877,1583,294,1463,18,1445,414,18,396,1765,1471,294,1438,1166,272,541,66,15,816
8/1/2016,VA,Virginia,Frederick,51069,15001,13269,1732,13262,47,13215,1739,48,1691,13690,11958,1732,9281,7803,1478,1430,334,138,7379
8/1/2016,VA,Virginia,Fredericksburg City,51630,3821,3369,452,3128,18,3110,693,25,668,3445,2993,452,2336,1908,428,771,89,36,1440
8/1/2016,VA,Virginia,Galax City,51640,1936,1798,138,1485,*,*,451,*,*,1837,1699,138,1448,1332,116,679,61,31,677
8/1/2016,VA,Virginia,Giles,51071,4494,3427,1067,3527,19,3508,967,16,951,4231,3165,1066,3394,2688,706,798,130,34,2432
8/1/2016,VA,Virginia,Gloucester,51073,7921,6658,1263,6741,34,6707,1180,21,1159,7347,6084,1263,4628,3480,1148,940,176,47,3465
8/1/2016,VA,Virginia,Goochland,51075,5268,4272,996,4782,19,4763,486,19,467,4775,3779,996,3832,2984,848,413,97,30,3292
8/1/2016,VA,Virginia,Grayson,51077,4561,3971,590,3706,*,*,855,*,*,4362,3772,590,3238,2749,489,994,172,87,1985
8/1/2016,VA,Virginia,Greene,51079,3513,3047,466,3064,*,*,449,*,*,3221,2755,466,2307,1879,428,446,84,23,1754
8/1/2016,VA,Virginia,Greensville,51081,2423,1830,593,1923,21,1902,500,18,482,2264,1671,593,1837,1332,505,566,126,27,1118
8/1/2016,VA,Virginia,Halifax,51083,9430,8175,1255,7619,59,7560,1811,66,1745,8935,7680,1255,7112,5994,1118,2152,456,140,4364
8/1/2016,VA,Virginia,Hampton City,51650,23959,18508,5451,19607,197,19410,4352,203,4149,21916,16465,5451,13068,7825,5243,3560,787,179,8542
8/1/2016,VA,Virginia,Hanover,51085,19393,15269,4124,17464,77,17387,1929,52,1877,17668,13544,4124,13832,10258,3574,1394,351,96,11991
8/1/2016,VA,Virginia,Harrisonburg City,51660,5111,4536,575,4288,15,4273,823,23,800,4650,4075,575,3626,3205,421,939,131,37,2519
8/1/2016,VA,Virginia,Henrico,51087,52589,40232,12357,45617,313,45304,6972,287,6685,47675,35318,12357,37504,26483,11021,6029,1340,393,29742
8/1/2016,VA,Virginia,Henry,51089,14900,10802,4098,11754,66,11688,3146,60,3086,14215,10117,4098,11958,8671,3287,3024,695,250,7989
8/1/2016,VA,Virginia,Highland,51091,725,666,59,667,*,*,58,*,*,681,622,59,497,440,57,63,*,*,410
8/1/2016,VA,Virginia,Hopewell City,51670,4398,3550,848,3378,30,3348,1020,37,983,4118,3270,848,2766,1937,829,930,158,41,1637
8/1/2016,VA,Virginia,Isle of Wight,51093,7603,5980,1623,6633,51,6582,970,29,941,7068,5445,1623,4973,3450,1523,906,190,75,3802
8/1/2016,VA,Virginia,James City,51095,19010,16760,2250,17844,58,17786,1166,48,1118,17595,15348,2247,11030,9139,1891,855,193,49,9933
8/1/2016,VA,Virginia,King and Queen,51097,1682,1408,274,1404,*,*,278,*,*,1576,1302,274,1165,919,246,268,73,14,810
8/1/2016,VA,Virginia,King George,51099,3630,3265,365,3103,13,3090,527,23,504,3156,2791,365,1587,1248,339,455,78,15,1039
8/1/2016,VA,Virginia,King William,51101,3125,2691,434,2662,23,2639,463,24,439,2888,2454,434,2273,1883,390,376,103,21,1773
8/1/2016,VA,Virginia,Lancaster,51103,4219,3690,529,3883,15,3868,336,11,325,4029,3500,529,2853,2488,365,483,93,25,2252
8/1/2016,VA,Virginia,Lee,51105,6306,4037,2269,4244,16,4228,2062,11,2051,6004,3736,2268,4848,2705,2143,1930,248,73,2597
8/1/2016,VA,Virginia,Lexington City,51678,1598,1442,156,1463,15,1448,135,*,*,1492,1336,156,1124,995,129,211,*,*,875
8/1/2016,VA,Virginia,Loudoun,51107,32907,28144,4763,30594,110,30484,2313,109,2204,27382,22629,4753,17614,13272,4342,2830,615,138,14031
8/1/2016,VA,Virginia,Louisa,51109,7414,6204,1210,6200,37,6163,1214,33,1181,6833,5623,1210,4993,3874,1119,1064,245,71,3613
8/1/2016,VA,Virginia,Lunenburg,51111,2964,2576,388,2406,16,2390,558,21,537,2739,2351,388,2035,1676,359,695,122,45,1173
8/1/2016,VA,Virginia,Lynchburg City,51680,14578,12394,2184,11582,88,11494,2996,103,2893,13588,11405,2183,10947,8961,1986,3295,427,147,7078
8/1/2016,VA,Virginia,Madison,51113,2849,2474,375,2510,*,*,339,*,*,2657,2282,375,1917,1581,336,382,89,27,1419
8/1/2016,VA,Virginia,Manassas City,51683,4220,3529,691,3670,33,3637,550,39,511,3560,2869,691,2430,1778,652,526,90,35,1779
8/1/2016,VA,Virginia,Manassas Park City,51685,1179,971,208,1011,11,1000,168,15,153,996,789,207,688,497,191,180,56,13,439
8/1/2016,VA,Virginia,Martinsville City,51690,3927,3061,866,2930,26,2904,997,41,956,3714,2848,866,3183,2457,726,1287,170,58,1668
8/1/2016,VA,Virginia,Mathews,51115,2779,2391,388,2543,*,*,236,*,*,2635,2247,388,1780,1450,330,256,40,19,1465
8/1/2016,VA,Virginia,Mecklenburg,51117,8944,7490,1454,7349,53,7296,1595,51,1544,8463,7009,1454,6581,5407,1174,1911,378,112,4180
8/1/2016,VA,Virginia,Middlesex,51119,3487,2989,498,3102,22,3080,385,*,*,3277,2779,498,2472,2106,366,436,89,30,1917
8/1/2016,VA,Virginia,Montgomery,51121,13179,10927,2252,10850,42,10808,2329,37,2292,11953,9701,2252,9549,7413,2136,1838,311,109,7291
8/1/2016,VA,Virginia,Nelson,51125,4329,3769,560,3800,16,3784,529,11,518,3987,3427,560,2883,2371,512,576,97,45,2165
8/1/2016,VA,Virginia,New Kent,51127,4027,3377,650,3571,15,3556,456,*,*,3673,3023,650,2521,1996,525,284,73,15,2149
8/1/2016,VA,Virginia,Newport News City,51700,26749,20286,6463,21833,169,21664,4916,250,4666,24497,18036,6461,15726,9488,6238,4595,813,227,10091
8/1/2016,VA,Virginia,Norfolk City,51710,31434,23846,7588,24873,261,24612,6561,344,6217,28346,20758,7588,18605,11277,7328,6893,1287,280,10145
8/1/2016,VA,Virginia,Northampton,51131,3486,2929,557,2960,27,2933,526,24,502,3268,2711,557,2587,2078,509,914,94,33,1546
8/1/2016,VA,Virginia,Northumberland,51133,4539,3966,573,4198,17,4181,341,*,*,4243,3670,573,2762,2399,363,407,92,35,2228
8/1/2016,VA,Virginia,Norton City,51720,1179,860,319,786,*,*,393,*,*,1095,776,319,872,573,299,353,46,19,454
8/1/2016,VA,Virginia,Nottoway,51135,3646,2988,658,2949,31,2918,697,16,681,3396,2738,658,2631,2191,440,944,128,40,1519
8/1/2016,VA,Virginia,Orange,51137,8336,7362,974,7323,41,7282,1013,37,976,7673,6699,974,4911,4186,725,936,214,68,3693
8/1/2016,VA,Virginia,Page,51139,5970,5249,721,4842,19,4823,1128,16,1112,5606,4885,721,4080,3454,626,1136,212,88,2644
8/1/2016,VA,Virginia,Patrick,51141,5069,3826,1243,4158,*,*,911,13,898,4824,3582,1242,3896,2825,1071,1002,201,81,2612
8/1/2016,VA,Virginia,Petersburg City,51730,7101,5398,1703,5238,99,5139,1863,80,1783,6507,4804,1703,4637,2977,1660,1987,351,68,2231
8/1/2016,VA,Virginia,Pittsylvania,51143,15692,12286,3406,12766,100,12666,2926,76,2850,14859,11453,3406,12125,9639,2486,3085,559,213,8268
8/1/2016,VA,Virginia,Poquoson City,51735,2456,2177,279,2284,*,*,172,*,*,2262,1983,279,1096,840,256,92,27,13,964
8/1/2016,VA,Virginia,Portsmouth City,51740,17633,13225,4408,13588,174,13414,4045,210,3835,15818,11412,4406,10292,6046,4246,3817,674,147,5654
8/1/2016,VA,Virginia,Powhatan,51145,5531,4457,1074,4907,17,4890,624,14,610,5082,4008,1074,3936,2975,961,387,109,30,3410
8/1/2016,VA,Virginia,Prince Edward,51147,4550,3759,791,3633,25,3608,917,33,884,4223,3432,791,3223,2614,609,1071,171,45,1936
8/1/2016,VA,Virginia,Prince George,51149,5573,4878,695,4696,27,4669,877,22,855,5143,4448,695,3042,2402,640,574,116,23,2329
8/1/2016,VA,Virginia,Prince William,51153,43710,36392,7318,38740,240,38500,4970,287,4683,37441,30128,7313,21261,14414,6847,4944,954,214,15149
8/1/2016,VA,Virginia,Pulaski,51155,8914,7278,1636,7007,28,6979,1907,26,1881,8340,6704,1636,6362,4817,1545,1652,324,116,4270
8/1/2016,VA,Virginia,Radford City,51750,1998,1635,363,1603,*,*,395,*,*,1833,1470,363,1506,1158,348,336,39,21,1110
8/1/2016,VA,Virginia,Rappahannock,51157,1974,1814,160,1818,*,*,156,*,*,1789,1630,159,1186,1053,133,162,36,11,977
8/1/2016,VA,Virginia,Richmond,51159,1913,1557,356,1653,15,1638,260,15,245,1789,1433,356,1310,1062,248,305,89,21,895
8/1/2016,VA,Virginia,Richmond City,51760,32384,22524,9860,25230,273,24957,7154,348,6806,29159,19299,9860,23959,14459,9500,8496,1374,312,13777
8/1/2016,VA,Virginia,Roanoke,51161,22557,18152,4405,19912,88,19824,2645,54,2591,20919,16515,4404,16378,12360,4018,1955,426,154,13843
8/1/2016,VA,Virginia,Roanoke City,51770,19971,14525,5446,14848,134,14714,5123,142,4981,18331,12887,5444,14640,9425,5215,4749,847,208,8836
8/1/2016,VA,Virginia,Rockbridge,51163,5726,4846,880,4818,19,4799,908,*,*,5346,4466,880,3966,3240,726,840,168,59,2899
8/1/2016,VA,Virginia,Rockingham,51165,16492,14075,2417,14401,41,14360,2091,43,2048,15266,12849,2417,11645,9914,1731,1763,498,164,9220
8/1/2016,VA,Virginia,Russell,51167,7671,5195,2476,5134,12,5122,2537,*,*,7347,4871,2476,6225,4160,2065,1680,310,127,4108
8/1/2016,VA,Virginia,Salem City,51775,5894,4836,1058,4935,31,4904,959,20,939,5426,4368,1058,4227,3250,977,835,149,39,3204
8/1/2016,VA,Virginia,Scott,51169,6526,3362,3164,4842,*,*,1684,13,1671,6268,3104,3164,5399,2286,3113,1537,243,123,3496
8/1/2016,VA,Virginia,Shenandoah,51171,10073,8920,1153,8822,22,8800,1251,25,1226,9460,8307,1153,6562,5593,969,1280,239,104,4939
8/1/2016,VA,Virginia,Smyth,51173,8752,6811,1941,6454,19,6435,2298,23,2275,8240,6299,1941,6638,4899,1739,2169,402,146,3921
8/1/2016,VA,Virginia,Southampton,51175,3997,3365,632,3305,28,3277,692,25,667,3739,3107,632,2891,2333,558,749,134,34,1974
8/1/2016,VA,Virginia,Spotsylvania,51177,19173,16881,2292,16545,105,16440,2628,89,2539,17102,14811,2291,10242,8259,1983,1909,480,141,7712
8/1/2016,VA,Virginia,Stafford,51179,15551,14125,1426,13623,80,13543,1928,87,1841,13676,12250,1426,6866,5622,1244,1301,352,77,5136
8/1/2016,VA,Virginia,Staunton City,51790,5877,5041,836,4793,20,4773,1084,25,1059,5523,4687,836,4260,3536,724,1055,150,60,2995
8/1/2016,VA,Virginia,Suffolk City,51800,14943,11963,2980,12110,85,12025,2833,95,2738,13695,10715,2980,9395,6637,2758,2655,437,104,6199
8/1/2016,VA,Virginia,Surry,51181,1509,1165,344,1261,11,1250,248,13,235,1389,1045,344,1013,691,322,203,76,14,720
8/1/2016,VA,Virginia,Sussex,51183,2307,1797,510,1877,28,1849,430,*,*,2149,1639,510,1652,1171,481,489,137,17,1009
8/1/2016,VA,Virginia,Tazewell,51185,11719,8566,3153,8545,31,8514,3174,37,3137,11080,7929,3151,8675,6667,2008,2252,438,182,5803
8/1/2016,VA,Virginia,Unknown,51999,*,*,*,*,*,*,*,*,*,*,*,*,*,*,*,*,*,*,*
8/1/2016,VA,Virginia,Virginia Beach City,51810,66340,55615,10725,58268,320,57948,8072,338,7734,60820,50101,10719,33804,23755,10049,6558,1339,364,25543
8/1/2016,VA,Virginia,Warren,51187,7047,6373,674,6000,23,5977,1047,26,1021,6432,5758,674,4277,3706,571,851,231,76,3119
8/1/2016,VA,Virginia,Washington,51191,14723,10041,4682,11644,47,11597,3079,26,3053,13877,9196,4681,11128,6806,4322,2495,517,171,7945
8/1/2016,VA,Virginia,Waynesboro City,51820,4731,4005,726,3846,17,3829,885,22,863,4438,3712,726,3493,2858,635,869,110,45,2469
8/1/2016,VA,Virginia,Westmoreland,51193,4699,4075,624,4099,23,4076,600,11,589,4311,3687,624,2681,2141,540,737,121,49,1774
8/1/2016,VA,Virginia,Williamsburg City,51830,2505,2139,366,2290,*,*,215,*,*,2292,1927,365,1578,1269,309,211,*,*,1331
8/1/2016,VA,Virginia,Winchester City,51840,5006,4466,540,4239,20,4219,767,18,749,4563,4023,540,3262,2801,461,836,126,50,2250
8/1/2016,VA,Virginia,Wise,51195,10421,6916,3505,6860,17,6843,3561,24,3537,9852,6348,3504,7730,4413,3317,2443,473,160,4654
8/1/2016,VA,Virginia,Wythe,51197,7373,5697,1676,5694,30,5664,1679,21,1658,6981,5305,1676,5383,3906,1477,1481,266,109,3527
8/1/2016,VA,Virginia,York,51199,11014,9689,1325,10087,40,10047,927,26,901,10088,8765,1323,5251,4029,1222,613,166,41,4431
12/1/2016,VA,Virginia,Accomack,51001,8536,7341,1195,7272,41,7231,1264,47,1217,7967,6772,1195,5805,4780,1025,1570,370,100,3765
12/1/2016,VA,Virginia,Albemarle,51003,19107,17105,2002,17490,52,17438,1617,53,1564,17156,15154,2002,12832,11055,1777,1505,281,97,10949
12/1/2016,VA,Virginia,Alexandria City,51510,16985,14733,2252,15532,68,15464,1453,86,1367,13674,11425,2249,7976,5847,2129,2088,321,74,5493
12/1/2016,VA,Virginia,Alleghany,51005,4519,3886,633,3594,17,3577,925,15,910,4291,3658,633,3405,2903,502,825,99,54,2427
12/1/2016,VA,Virginia,Amelia,51007,2948,2308,640,2462,11,2451,486,13,473,2724,2084,640,2106,1512,594,489,76,38,1503
12/1/2016,VA,Virginia,Amherst,51009,7581,6386,1195,6259,45,6214,1322,30,1292,7039,5844,1195,5608,4506,1102,1198,228,74,4108
12/1/2016,VA,Virginia,Appomattox,51011,3740,3175,565,3020,15,3005,720,20,700,3529,2964,565,2800,2284,516,687,93,38,1982
12/1/2016,VA,Virginia,Arlington,51013,23266,20375,2891,21590,80,21510,1676,87,1589,18383,15492,2891,10662,7935,2727,2956,325,115,7266
12/1/2016,VA,Virginia,Augusta,51015,17375,14979,2396,14871,40,14831,2504,41,2463,16320,13924,2396,12344,10346,1998,1881,389,154,9920
12/1/2016,VA,Virginia,Bath,51017,1263,1151,112,1109,*,*,154,*,*,1190,1078,112,920,825,95,175,37,23,685
12/1/2016,VA,Virginia,Bedford,51019,18800,15453,3347,15953,68,15885,2847,46,2801,17530,14185,3345,13509,10750,2759,2009,468,160,10872
12/1/2016,VA,Virginia,Bland,51021,1753,1375,378,1365,*,*,388,*,*,1655,1277,378,1233,1030,203,262,47,19,905
12/1/2016,VA,Virginia,Botetourt,51023,8315,6524,1791,7170,37,7133,1145,19,1126,7682,5891,1791,5959,4321,1638,831,184,63,4881
12/1/2016,VA,Virginia,Bristol City,51520,4431,2679,1752,3422,15,3407,1009,*,*,4157,2405,1752,3469,1768,1701,1015,147,54,2253
12/1/2016,VA,Virginia,Brunswick,51025,3919,3234,685,3167,24,3143,752,27,725,3676,2991,685,2861,2233,628,1127,107,45,1582
12/1/2016,VA,Virginia,Buchanan,51027,7310,4510,2800,4474,16,4458,2836,11,2825,7034,4234,2800,5809,3813,1996,1656,411,117,3625
12/1/2016,VA,Virginia,Buckingham,51029,3395,2808,587,2725,15,2710,670,15,655,3169,2582,587,2392,2005,387,728,140,48,1476
12/1/2016,VA,Virginia,Buena Vista City,51530,1441,1174,267,1157,*,*,284,*,*,1346,1079,267,1042,821,221,326,61,19,636
12/1/2016,VA,Virginia,Campbell,51031,12349,10393,1956,10084,73,10011,2265,65,2200,11583,9627,1956,9244,7450,1794,2122,364,175,6583
12/1/2016,VA,Virginia,Caroline,51033,5533,4616,917,4589,25,4564,944,39,905,4993,4076,917,3368,2527,841,809,225,58,2276
12/1/2016,VA,Virginia,Carroll,51035,7888,6797,1091,6301,18,6283,1587,17,1570,7470,6379,1091,5740,4846,894,1647,274,104,3715
12/1/2016,VA,Virginia,Charles City,51036,1825,1418,407,1542,17,1525,283,13,270,1676,1269,407,1265,915,350,267,80,19,899
12/1/2016,VA,Virginia,Charlotte,51037,3310,2812,498,2673,14,2659,637,16,621,3131,2633,498,2451,2010,441,801,126,55,1469
12/1/2016,VA,Virginia,Charlottesville City,51540,6059,5310,749,4935,24,4911,1124,48,1076,5441,4692,749,4300,3588,712,1254,148,54,2844
12/1/2016,VA,Virginia,Chesapeake City,51550,35399,28804,6595,30108,218,29890,5291,234,5057,32028,25433,6595,19383,13214,6169,4165,850,244,14124
12/1/2016,VA,Virginia,Chesterfield,51041,55403,42983,12420,47908,146,47762,7495,246,7249,49978,37560,12418,37706,26260,11446,5340,998,292,31076
12/1/2016,VA,Virginia,Clarke,51043,3069,2759,310,2814,13,2801,255,*,*,2778,2468,310,1839,1580,259,262,72,33,1472
12/1/2016,VA,Virginia,Colonial Heights City,51570,4119,3531,588,3529,12,3517,590,14,576,3805,3217,588,2403,1856,547,478,106,25,1794
12/1/2016,VA,Virginia,Covington City,51580,1638,1412,226,1264,*,*,374,*,*,1533,1307,226,1196,982,214,362,57,18,759
12/1/2016,VA,Virginia,Craig,51045,1294,1031,263,1004,*,*,290,*,*,1196,933,263,923,670,253,208,38,11,666
12/1/2016,VA,Virginia,Culpeper,51047,8761,7672,1089,7522,39,7483,1239,39,1200,7946,6857,1089,5425,4447,978,1161,251,64,3949
12/1/2016,VA,Virginia,Cumberland,51049,2206,1729,477,1809,*,*,397,*,*,2037,1560,477,1586,1150,436,436,87,27,1036
12/1/2016,VA,Virginia,Danville City,51590,11098,8863,2235,8652,73,8579,2446,115,2331,10500,8265,2235,8687,7326,1361,3247,434,163,4843
12/1/2016,VA,Virginia,Dickenson,51051,4693,2984,1709,2855,*,*,1838,14,1824,4487,2778,1709,3650,2109,1541,1114,214,82,2240
12/1/2016,VA,Virginia,Dinwiddie,51053,5649,4503,1146,4508,31,4477,1141,34,1107,5200,4054,1146,3786,2689,1097,916,180,56,2634
12/1/2016,VA,Virginia,Emporia City,51595,1143,874,269,869,12,857,274,15,259,1071,802,269,876,654,222,425,*,*,374
12/1/2016,VA,Virginia,Essex,51057,2782,2317,465,2360,17,2343,422,11,411,2596,2131,465,1916,1570,346,430,88,21,1377
12/1/2016,VA,Virginia,Fairfax,51059,142299,123767,18532,133911,468,133443,8388,428,7960,115005,96503,18502,64902,47682,17220,13285,2630,493,48494
12/1/2016,VA,Virginia,Fairfax City,51600,3689,3166,523,3409,14,3395,280,*,*,3087,2564,523,1847,1361,486,385,60,11,1391
12/1/2016,VA,Virginia,Falls Church City,51610,1812,1569,243,1722,*,*,90,*,*,1414,1171,243,839,615,224,137,*,*,681
12/1/2016,VA,Virginia,Fauquier,51061,11737,10581,1156,10622,44,10578,1115,40,1075,10398,9243,1155,6477,5464,1013,940,192,58,5287
12/1/2016,VA,Virginia,Floyd,51063,3890,3151,739,3341,*,*,549,*,*,3625,2886,739,2794,2112,682,546,95,46,2107
12/1/2016,VA,Virginia,Fluvanna,51065,5532,4789,743,4942,17,4925,590,22,568,5059,4316,743,3658,2999,659,501,131,28,2998
12/1/2016,VA,Virginia,Franklin,51067,14106,10467,3639,11649,44,11605,2457,30,2427,13261,9623,3638,10653,7204,3449,2003,461,161,8028
12/1/2016,VA,Virginia,Franklin City,51620,1909,1609,300,1484,18,1466,425,18,407,1787,1487,300,1449,1170,279,556,63,15,815
12/1/2016,VA,Virginia,Frederick,51069,15146,13417,1729,13355,44,13311,1791,47,1744,13825,12096,1729,9387,7909,1478,1466,345,141,7435
12/1/2016,VA,Virginia,Fredericksburg City,51630,3832,3376,456,3128,17,3111,704,27,677,3456,3000,456,2339,1908,431,782,88,36,1433
12/1/2016,VA,Virginia,Galax City,51640,1942,1817,125,1485,*,*,457,*,*,1843,1718,125,1449,1345,104,689,59,32,669
12/1/2016,VA,Virginia,Giles,51071,4513,3444,1069,3534,18,3516,979,16,963,4249,3181,1068,3410,2705,705,805,128,33,2444
12/1/2016,VA,Virginia,Gloucester,51073,8005,6743,1262,6802,33,6769,1203,21,1182,7418,6156,1262,4663,3520,1143,949,177,46,3491
12/1/2016,VA,Virginia,Goochland,51075,5333,4339,994,4841,18,4823,492,18,474,4816,3822,994,3863,3016,847,425,100,31,3307
12/1/2016,VA,Virginia,Grayson,51077,4577,3981,596,3704,*,*,873,*,*,4381,3785,596,3250,2755,495,1007,181,87,1975
12/1/2016,VA,Virginia,Greene,51079,3541,3079,462,3084,*,*,457,*,*,3238,2776,462,2324,1899,425,453,83,25,1763
12/1/2016,VA,Virginia,Greensville,51081,2445,1850,595,1931,20,1911,514,18,496,2281,1686,595,1853,1344,509,574,127,27,1125
12/1/2016,VA,Virginia,Halifax,51083,9458,8201,1257,7630,57,7573,1828,67,1761,8947,7690,1257,7133,6013,1120,2174,446,145,4368
12/1/2016,VA,Virginia,Hampton City,51650,24163,18638,5525,19725,178,19547,4438,199,4239,22085,16560,5525,13144,7825,5319,3622,782,175,8565
12/1/2016,VA,Virginia,Hanover,51085,19574,15407,4167,17622,73,17549,1952,52,1900,17839,13672,4167,13976,10351,3625,1410,349,95,12122
12/1/2016,VA,Virginia,Harrisonburg City,51660,5145,4590,555,4313,14,4299,832,25,807,4674,4119,555,3647,3243,404,952,130,37,2528
12/1/2016,VA,Virginia,Henrico,51087,53106,40627,12479,45999,296,45703,7107,286,6821,48048,35569,12479,37815,26651,11164,6136,1342,407,29930
12/1/2016,VA,Virginia,Henry,51089,14922,10468,4454,11746,60,11686,3176,57,3119,14233,9779,4454,11948,8252,3696,3052,695,256,7945
12/1/2016,VA,Virginia,Highland,51091,740,680,60,678,*,*,62,*,*,694,634,60,504,446,58,60,*,*,417
12/1/2016,VA,Virginia,Hopewell City,51670,4411,3548,863,3380,28,3352,1031,34,997,4115,3252,863,2777,1933,844,945,156,43,1633
12/1/2016,VA,Virginia,Isle of Wight,51093,7716,6088,1628,6720,44,6676,996,29,967,7171,5543,1628,5016,3487,1529,921,189,73,3833
12/1/2016,VA,Virginia,James City,51095,19149,16921,2228,17963,53,17910,1186,47,1139,17710,15485,2225,11095,9224,1871,869,191,49,9986
12/1/2016,VA,Virginia,King and Queen,51097,1711,1436,275,1423,*,*,288,*,*,1604,1329,275,1182,934,248,274,71,16,821
12/1/2016,VA,Virginia,King George,51099,3670,3305,365,3132,13,3119,538,24,514,3187,2822,365,1602,1262,340,472,76,14,1040
12/1/2016,VA,Virginia,King William,51101,3159,2717,442,2683,22,2661,476,25,451,2920,2478,442,2291,1891,400,383,106,22,1780
12/1/2016,VA,Virginia,Lancaster,51103,4231,3706,525,3885,13,3872,346,12,334,4029,3504,525,2850,2489,361,490,97,22,2241
12/1/2016,VA,Virginia,Lee,51105,6321,4040,2281,4242,14,4228,2079,13,2066,6022,3742,2280,4853,2696,2157,1951,241,74,2587
12/1/2016,VA,Virginia,Lexington City,51678,1596,1439,157,1458,15,1443,138,*,*,1486,1329,157,1121,992,129,210,*,*,873
12/1/2016,VA,Virginia,Loudoun,51107,33431,28635,4796,31048,105,30943,2383,118,2265,27718,22930,4788,17845,13461,4384,2910,622,143,14170
12/1/2016,VA,Virginia,Louisa,51109,7492,6278,1214,6246,33,6213,1246,30,1216,6883,5669,1214,5017,3891,1126,1085,237,70,3625
12/1/2016,VA,Virginia,Lunenburg,51111,2964,2584,380,2396,16,2380,568,21,547,2746,2366,380,2040,1689,351,699,123,45,1173
12/1/2016,VA,Virginia,Lynchburg City,51680,14669,12484,2185,11623,83,11540,3046,101,2945,13624,11439,2185,10969,8978,1991,3324,440,151,7054
12/1/2016,VA,Virginia,Madison,51113,2884,2506,378,2540,*,*,344,11,333,2696,2318,378,1939,1599,340,389,88,25,1437
12/1/2016,VA,Virginia,Manassas City,51683,4271,3561,710,3711,33,3678,560,39,521,3603,2893,710,2446,1774,672,532,92,36,1786
12/1/2016,VA,Virginia,Manassas Park City,51685,1208,997,211,1034,11,1023,174,14,160,1020,810,210,703,508,195,192,53,13,445
12/1/2016,VA,Virginia,Martinsville City,51690,3929,2833,1096,2924,25,2899,1005,40,965,3711,2615,1096,3165,2198,967,1289,167,59,1650
12/1/2016,VA,Virginia,Mathews,51115,2777,2392,385,2540,*,*,237,*,*,2632,2247,385,1780,1452,328,250,38,20,1472
12/1/2016,VA,Virginia,Mecklenburg,51117,8976,7196,1780,7366,51,7315,1610,51,1559,8492,6712,1780,6605,5077,1528,1932,370,119,4184
12/1/2016,VA,Virginia,Middlesex,51119,3490,2990,500,3102,22,3080,388,*,*,3286,2786,500,2470,2103,367,442,82,30,1916
12/1/2016,VA,Virginia,Montgomery,51121,13281,11027,2254,10922,41,10881,2359,36,2323,12034,9780,2254,9614,7474,2140,1862,318,116,7318
12/1/2016,VA,Virginia,Nelson,51125,4363,3798,565,3831,15,3816,532,11,521,4014,3449,565,2904,2386,518,593,94,46,2171
12/1/2016,VA,Virginia,New Kent,51127,4083,3425,658,3616,15,3601,467,*,*,3724,3066,658,2560,2025,535,289,73,16,2182
12/1/2016,VA,Virginia,Newport News City,51700,26954,20409,6545,21950,164,21786,5004,242,4762,24680,18137,6543,15822,9502,6320,4665,825,229,10103
12/1/2016,VA,Virginia,Norfolk City,51710,31735,24024,7711,25033,251,24782,6702,342,6360,28606,20895,7711,18828,11371,7457,7037,1294,291,10206
12/1/2016,VA,Virginia,Northampton,51131,3494,2933,561,2961,25,2936,533,22,511,3275,2714,561,2590,2081,509,917,92,29,1552
12/1/2016,VA,Virginia,Northumberland,51133,4580,4006,574,4233,14,4219,347,*,*,4275,3701,574,2770,2408,362,413,93,33,2231
12/1/2016,VA,Virginia,Norton City,51720,1176,849,327,777,*,*,399,*,*,1095,768,327,877,571,306,353,45,18,461
12/1/2016,VA,Virginia,Nottoway,51135,3663,3016,647,2955,29,2926,708,16,692,3416,2769,647,2639,2201,438,952,130,40,1517
12/1/2016,VA,Virginia,Orange,51137,8401,7428,973,7367,39,7328,1034,36,998,7734,6761,973,4951,4232,719,963,207,68,3713
12/1/2016,VA,Virginia,Page,51139,6001,5302,699,4866,19,4847,1135,15,1120,5631,4932,699,4095,3490,605,1140,212,90,2653
12/1/2016,VA,Virginia,Patrick,51141,5094,3868,1226,4161,*,*,933,11,922,4847,3622,1225,3893,2838,1055,1014,199,80,2600
12/1/2016,VA,Virginia,Petersburg City,51730,7122,5413,1709,5237,91,5146,1885,81,1804,6504,4795,1709,4638,2972,1666,2021,347,67,2203
12/1/2016,VA,Virginia,Pittsylvania,51143,15815,12414,3401,12845,98,12747,2970,77,2893,14937,11536,3401,12174,9701,2473,3130,548,215,8281
12/1/2016,VA,Virginia,Poquoson City,51735,2471,2200,271,2295,*,*,176,*,*,2273,2002,271,1106,856,250,94,25,13,974
12/1/2016,VA,Virginia,Portsmouth City,51740,17777,13363,4414,13669,165,13504,4108,209,3899,15926,11514,4412,10330,6072,4258,3870,677,146,5637
12/1/2016,VA,Virginia,Powhatan,51145,5607,4527,1080,4973,17,4956,634,15,619,5151,4071,1080,3999,3035,964,398,117,31,3453
12/1/2016,VA,Virginia,Prince Edward,51147,4574,3794,780,3646,23,3623,928,33,895,4235,3455,780,3247,2651,596,1089,170,45,1943
12/1/2016,VA,Virginia,Prince George,51149,5609,4906,703,4722,25,4697,887,23,864,5181,4478,703,3047,2400,647,580,111,23,2333
12/1/2016,VA,Virginia,Prince William,51153,44431,37011,7420,39332,226,39106,5099,288,4811,37952,30537,7415,21530,14577,6953,5083,957,215,15275
12/1/2016,VA,Virginia,Pulaski,51155,8943,7329,1614,7016,27,6989,1927,26,1901,8364,6750,1614,6355,4830,1525,1673,320,114,4248
12/1/2016,VA,Virginia,Radford City,51750,2022,1652,370,1618,*,*,404,*,*,1850,1480,370,1519,1167,352,344,40,20,1115
12/1/2016,VA,Virginia,Rappahannock,51157,1993,1835,158,1837,*,*,156,*,*,1801,1644,157,1179,1048,131,166,*,*,970
12/1/2016,VA,Virginia,Richmond,51159,1909,1555,354,1646,15,1631,263,15,248,1782,1428,354,1309,1066,243,312,88,21,888
12/1/2016,VA,Virginia,Richmond City,51760,32619,22572,10047,25392,257,25135,7227,343,6884,29330,19283,10047,24089,14396,9693,8651,1340,312,13786
12/1/2016,VA,Virginia,Roanoke,51161,22672,18273,4399,19998,83,19915,2674,51,2623,21003,16605,4398,16451,12420,4031,2006,413,148,13884
12/1/2016,VA,Virginia,Roanoke City,51770,20068,14587,5481,14867,125,14742,5201,143,5058,18369,12889,5480,14687,9432,5255,4830,839,204,8814
12/1/2016,VA,Virginia,Rockbridge,51163,5766,4895,871,4848,18,4830,918,*,*,5378,4507,871,3986,3265,721,857,174,65,2890
12/1/2016,VA,Virginia,Rockingham,51165,16626,14219,2407,14494,37,14457,2132,41,2091,15382,12975,2407,11749,10029,1720,1786,504,166,9293
12/1/2016,VA,Virginia,Russell,51167,7692,5215,2477,5135,11,5124,2557,*,*,7368,4891,2477,6237,4167,2070,1698,311,127,4101
12/1/2016,VA,Virginia,Salem City,51775,5926,4851,1075,4965,28,4937,961,20,941,5443,4368,1075,4238,3242,996,835,148,40,3215
12/1/2016,VA,Virginia,Scott,51169,6535,3366,3169,4820,*,*,1715,13,1702,6281,3113,3168,5391,2271,3120,1539,243,121,3488
12/1/2016,VA,Virginia,Shenandoah,51171,10177,9032,1145,8902,21,8881,1275,25,1250,9548,8403,1145,6622,5663,959,1312,240,102,4968
12/1/2016,VA,Virginia,Smyth,51173,8765,6813,1952,6437,18,6419,2328,23,2305,8265,6313,1952,6655,4905,1750,2186,395,141,3933
12/1/2016,VA,Virginia,Southampton,51175,4012,3385,627,3314,28,3286,698,23,675,3754,3127,627,2905,2352,553,765,134,36,1970
12/1/2016,VA,Virginia,Spotsylvania,51177,19386,17068,2318,16701,97,16604,2685,89,2596,17272,14955,2317,10311,8309,2002,1945,485,140,7741
12/1/2016,VA,Virginia,Stafford,51179,15790,14375,1415,13837,77,13760,1953,85,1868,13843,12428,1415,6911,5676,1235,1338,346,76,5151
12/1/2016,VA,Virginia,Staunton City,51790,5905,5079,826,4818,19,4799,1087,26,1061,5555,4729,826,4283,3565,718,1057,149,65,3012
12/1/2016,VA,Virginia,Suffolk City,51800,15070,12099,2971,12179,80,12099,2891,93,2798,13815,10844,2971,9444,6691,2753,2675,443,110,6216
12/1/2016,VA,Virginia,Surry,51181,1528,1183,345,1276,*,*,252,*,*,1408,1063,345,1020,698,322,211,72,14,723
12/1/2016,VA,Virginia,Sussex,51183,2327,1811,516,1889,27,1862,438,*,*,2173,1657,516,1658,1171,487,488,137,18,1015
12/1/2016,VA,Virginia,Tazewell,51185,11793,8608,3185,8544,28,8516,3249,38,3211,11154,7971,3183,8672,6630,2042,2298,431,185,5758
12/1/2016,VA,Virginia,Unknown,51999,*,*,*,*,*,*,*,*,*,*,*,*,*,*,*,*,*,*,*
12/1/2016,VA,Virginia,Virginia Beach City,51810,67057,56192,10865,58789,299,58490,8268,331,7937,61457,50597,10860,34193,24002,10191,6666,1362,368,25797
12/1/2016,VA,Virginia,Warren,51187,7131,6459,672,6068,22,6046,1063,24,1039,6513,5841,672,4327,3760,567,883,227,75,3142
12/1/2016,VA,Virginia,Washington,51191,14766,10057,4709,11660,44,11616,3106,28,3078,13901,9193,4708,11145,6793,4352,2526,513,171,7935
12/1/2016,VA,Virginia,Waynesboro City,51820,4741,4008,733,3850,15,3835,891,23,868,4441,3708,733,3493,2851,642,884,115,41,2453
12/1/2016,VA,Virginia,Westmoreland,51193,4741,4119,622,4135,22,4113,606,13,593,4347,3725,622,2697,2160,537,740,128,49,1780
12/1/2016,VA,Virginia,Williamsburg City,51830,2525,2151,374,2304,*,*,221,*,*,2316,1943,373,1598,1280,318,221,*,*,1339
12/1/2016,VA,Virginia,Winchester City,51840,5045,4516,529,4266,19,4247,779,18,761,4589,4060,529,3269,2817,452,851,128,51,2239
12/1/2016,VA,Virginia,Wise,51195,10432,6925,3507,6848,17,6831,3584,23,3561,9865,6359,3506,7745,4424,3321,2457,467,157,4664
12/1/2016,VA,Virginia,Wythe,51197,7423,5766,1657,5718,30,5688,1705,20,1685,7016,5359,1657,5396,3939,1457,1504,263,112,3517
12/1/2016,VA,Virginia,York,51199,11114,9796,1318,10167,36,10131,947,27,920,10183,8867,1316,5279,4062,1217,623,164,43,4449
2/1/2016,VA,Virginia,Accomack,51001,8413,7210,1203,7197,49,7148,1216,46,1170,7867,6664,1203,5750,4721,1029,1521,385,99,3745
2/1/2016,VA,Virginia,Albemarle,51003,18573,16556,2017,17017,61,16956,1556,58,1498,16716,14699,2017,12527,10732,1795,1444,285,93,10705
2/1/2016,VA,Virginia,Alexandria City,51510,16345,14148,2197,14966,76,14890,1379,92,1287,13183,10988,2195,7734,5664,2070,1953,333,70,5378
2/1/2016,VA,Virginia,Alleghany,51005,4502,3849,653,3604,19,3585,898,16,882,4268,3615,653,3412,2902,510,804,113,54,2441
2/1/2016,VA,Virginia,Amelia,51007,2917,2273,644,2438,12,2426,479,13,466,2690,2046,644,2078,1482,596,472,78,40,1488
2/1/2016,VA,Virginia,Amherst,51009,7437,6246,1191,6153,49,6104,1284,34,1250,6924,5733,1191,5542,4441,1101,1142,240,85,4075
2/1/2016,VA,Virginia,Appomattox,51011,3710,3142,568,3016,18,2998,694,20,674,3505,2937,568,2788,2268,520,663,98,45,1982
2/1/2016,VA,Virginia,Arlington,51013,22465,19607,2858,20867,87,20780,1598,87,1511,17822,14964,2858,10391,7696,2695,2842,332,121,7096
2/1/2016,VA,Virginia,Augusta,51015,17004,14608,2396,14607,49,14558,2397,43,2354,15951,13555,2396,12071,10078,1993,1780,402,162,9727
2/1/2016,VA,Virginia,Bath,51017,1254,1139,115,1103,*,*,151,*,*,1179,1064,115,920,824,96,180,35,23,682
2/1/2016,VA,Virginia,Bedford,51019,18372,15012,3360,15629,79,15550,2743,47,2696,17152,13794,3358,13262,10494,2768,1949,487,163,10663
2/1/2016,VA,Virginia,Bland,51021,1732,1360,372,1357,*,*,375,*,*,1625,1253,372,1228,1029,199,259,48,21,900
2/1/2016,VA,Virginia,Botetourt,51023,8134,6350,1784,7040,44,6996,1094,21,1073,7511,5727,1784,5837,4212,1625,807,196,65,4769
2/1/2016,VA,Virginia,Bristol City,51520,4410,2679,1731,3429,18,3411,981,*,*,4147,2416,1731,3474,1792,1682,1007,159,62,2246
2/1/2016,VA,Virginia,Brunswick,51025,3853,3165,688,3134,28,3106,719,27,692,3638,2950,688,2837,2212,625,1097,117,42,1581
2/1/2016,VA,Virginia,Buchanan,51027,7322,4503,2819,4557,17,4540,2765,*,*,6997,4179,2818,5805,3814,1991,1594,427,122,3662
2/1/2016,VA,Virginia,Buckingham,51029,3345,2755,590,2696,20,2676,649,13,636,3117,2527,590,2363,1977,386,705,151,44,1463
2/1/2016,VA,Virginia,Buena Vista City,51530,1431,1178,253,1154,*,*,277,*,*,1342,1089,253,1041,834,207,315,66,20,640
2/1/2016,VA,Virginia,Campbell,51031,12213,10242,1971,10032,87,9945,2181,65,2116,11470,9499,1971,9196,7383,1813,2039,388,179,6590
2/1/2016,VA,Virginia,Caroline,51033,5404,4475,929,4509,29,4480,895,39,856,4899,3970,929,3341,2491,850,760,248,53,2280
2/1/2016,VA,Virginia,Carroll,51035,7782,6689,1093,6243,23,6220,1539,19,1520,7380,6287,1093,5699,4804,895,1613,279,104,3703
2/1/2016,VA,Virginia,Charles City,51036,1767,1361,406,1502,18,1484,265,11,254,1635,1229,406,1226,877,349,247,80,21,878
2/1/2016,VA,Virginia,Charlotte,51037,3273,2766,507,2664,16,2648,609,14,595,3091,2584,507,2422,1971,451,770,130,52,1470
2/1/2016,VA,Virginia,Charlottesville City,51540,5908,5150,758,4808,25,4783,1100,50,1050,5302,4545,757,4208,3487,721,1193,154,57,2804
2/1/2016,VA,Virginia,Chesapeake City,51550,34398,27953,6445,29386,262,29124,5012,230,4782,31106,24661,6445,18891,12871,6020,3904,879,238,13870
2/1/2016,VA,Virginia,Chesterfield,51041,53618,41524,12094,46386,176,46210,7232,247,6985,48374,36282,12092,36456,25359,11097,5040,981,293,30142
2/1/2016,VA,Virginia,Clarke,51043,3005,2680,325,2755,16,2739,250,*,*,2726,2401,325,1829,1556,273,262,77,32,1458
2/1/2016,VA,Virginia,Colonial Heights City,51570,4111,3543,568,3550,14,3536,561,13,548,3776,3208,568,2355,1829,526,441,103,21,1790
2/1/2016,VA,Virginia,Covington City,51580,1638,1418,220,1273,*,*,365,*,*,1526,1306,220,1201,995,206,355,51,16,779
2/1/2016,VA,Virginia,Craig,51045,1255,996,259,978,*,*,277,*,*,1158,899,259,903,653,250,202,40,13,648
2/1/2016,VA,Virginia,Culpeper,51047,8554,7469,1085,7373,54,7319,1181,36,1145,7772,6687,1085,5345,4373,972,1096,261,67,3921
2/1/2016,VA,Virginia,Cumberland,51049,2178,1697,481,1799,*,*,379,*,*,2019,1538,481,1566,1127,439,421,88,27,1030
2/1/2016,VA,Virginia,Danville City,51590,11045,8799,2246,8675,87,8588,2370,120,2250,10474,8228,2246,8678,7304,1374,3161,449,163,4905
2/1/2016,VA,Virginia,Dickenson,51051,4669,2987,1682,2882,*,*,1787,12,1775,4451,2769,1682,3626,2120,1506,1088,223,89,2226
2/1/2016,VA,Virginia,Dinwiddie,51053,5548,4419,1129,4447,39,4408,1101,34,1067,5115,3986,1129,3749,2666,1083,881,192,57,2619
2/1/2016,VA,Virginia,Emporia City,51595,1129,853,276,861,15,846,268,14,254,1059,783,276,868,641,227,414,*,*,376
2/1/2016,VA,Virginia,Essex,51057,2728,2257,471,2320,17,2303,408,13,395,2554,2083,471,1894,1543,351,412,96,28,1358
2/1/2016,VA,Virginia,Fairfax,51059,136608,118814,17794,128722,550,128172,7886,413,7473,110708,92943,17765,62688,46207,16481,12542,2700,480,46966
2/1/2016,VA,Virginia,Fairfax City,51600,3591,3089,502,3318,16,3302,273,*,*,3008,2506,502,1787,1324,463,371,56,11,1349
2/1/2016,VA,Virginia,Falls Church City,51610,1754,1524,230,1670,*,*,84,*,*,1386,1156,230,823,613,210,126,*,*,675
2/1/2016,VA,Virginia,Fauquier,51061,11382,10369,1013,10295,51,10244,1087,43,1044,10058,9046,1012,6304,5435,869,894,211,60,5139
2/1/2016,VA,Virginia,Floyd,51063,3808,3077,731,3267,11,3256,541,*,*,3551,2820,731,2753,2079,674,530,99,53,2071
2/1/2016,VA,Virginia,Fluvanna,51065,5388,4652,736,4827,23,4804,561,22,539,4925,4189,736,3557,2903,654,470,125,21,2941
2/1/2016,VA,Virginia,Franklin,51067,13826,10221,3605,11444,50,11394,2382,26,2356,12990,9385,3605,10460,7049,3411,1915,484,165,7896
2/1/2016,VA,Virginia,Franklin City,51620,1869,1565,304,1473,21,1452,396,18,378,1753,1449,304,1442,1160,282,531,65,18,828
2/1/2016,VA,Virginia,Frederick,51069,14824,13088,1736,13148,51,13097,1676,46,1630,13537,11801,1736,9184,7705,1479,1393,360,135,7296
2/1/2016,VA,Virginia,Fredericksburg City,51630,3761,3309,452,3085,18,3067,676,25,651,3402,2950,452,2292,1865,427,731,87,43,1431
2/1/2016,VA,Virginia,Galax City,51640,1953,1810,143,1505,*,*,448,11,437,1848,1705,143,1453,1335,118,670,66,34,683
2/1/2016,VA,Virginia,Giles,51071,4468,3414,1054,3525,22,3503,943,15,928,4208,3155,1053,3400,2714,686,776,142,38,2444
2/1/2016,VA,Virginia,Gloucester,51073,7856,6607,1249,6711,38,6673,1145,20,1125,7254,6005,1249,4593,3459,1134,917,179,52,3445
2/1/2016,VA,Virginia,Goochland,51075,5150,4172,978,4677,20,4657,473,19,454,4672,3694,978,3745,2909,836,407,97,35,3206
2/1/2016,VA,Virginia,Grayson,51077,4540,3955,585,3702,12,3690,838,*,*,4346,3761,585,3234,2752,482,985,183,87,1979
2/1/2016,VA,Virginia,Greene,51079,3434,2974,460,2999,*,*,435,*,*,3148,2688,460,2264,1840,424,433,80,24,1727
2/1/2016,VA,Virginia,Greensville,51081,2403,1803,600,1911,21,1890,492,18,474,2250,1650,600,1852,1338,514,564,132,26,1130
2/1/2016,VA,Virginia,Halifax,51083,9378,8122,1256,7605,67,7538,1773,69,1704,8844,7588,1256,7101,5983,1118,2125,474,145,4357
2/1/2016,VA,Virginia,Hampton City,51650,23627,18238,5389,19394,215,19179,4233,197,4036,21605,16216,5389,12943,7765,5178,3454,818,188,8483
2/1/2016,VA,Virginia,Hanover,51085,19124,15053,4071,17244,82,17162,1880,54,1826,17439,13368,4071,13619,10099,3520,1372,355,103,11789
2/1/2016,VA,Virginia,Harrisonburg City,51660,5056,4461,595,4252,18,4234,804,23,781,4599,4004,595,3600,3161,439,916,138,41,2505
2/1/2016,VA,Virginia,Henrico,51087,51965,39738,12227,45130,346,44784,6835,295,6540,47085,34858,12227,37096,26227,10869,5866,1406,393,29431
2/1/2016,VA,Virginia,Henry,51089,14902,10769,4133,11800,82,11718,3102,61,3041,14198,10065,4133,12003,8713,3290,2991,722,255,8035
2/1/2016,VA,Virginia,Highland,51091,716,654,62,660,*,*,56,*,*,674,612,62,494,434,60,65,*,*,405
2/1/2016,VA,Virginia,Hopewell City,51670,4377,3543,834,3377,31,3346,1000,38,962,4090,3256,834,2767,1953,814,913,162,37,1655
2/1/2016,VA,Virginia,Isle of Wight,51093,7474,5850,1624,6534,53,6481,940,26,914,6940,5316,1624,4917,3391,1526,882,205,78,3752
2/1/2016,VA,Virginia,James City,51095,18766,16515,2251,17637,63,17574,1129,44,1085,17342,15094,2248,10836,8943,1893,821,197,45,9773
2/1/2016,VA,Virginia,King and Queen,51097,1666,1392,274,1400,*,*,266,*,*,1557,1283,274,1163,920,243,259,78,15,811
2/1/2016,VA,Virginia,King George,51099,3516,3157,359,3017,18,2999,499,22,477,3055,2696,359,1559,1227,332,434,87,16,1022
2/1/2016,VA,Virginia,King William,51101,3082,2636,446,2634,24,2610,448,26,422,2848,2402,446,2261,1860,401,366,100,21,1774
2/1/2016,VA,Virginia,Lancaster,51103,4189,3645,544,3861,19,3842,328,11,317,4006,3462,544,2849,2470,379,469,95,24,2261
2/1/2016,VA,Virginia,Lee,51105,6275,4038,2237,4248,16,4232,2027,12,2015,5959,3724,2235,4845,2734,2111,1901,254,80,2610
2/1/2016,VA,Virginia,Lexington City,51678,1585,1426,159,1453,16,1437,132,*,*,1481,1322,159,1117,984,133,216,*,*,863
2/1/2016,VA,Virginia,Loudoun,51107,32248,27494,4754,30001,121,29880,2247,109,2138,26825,22077,4748,17275,12942,4333,2717,622,145,13791
2/1/2016,VA,Virginia,Louisa,51109,7251,6041,1210,6078,40,6038,1173,33,1140,6679,5469,1210,4904,3787,1117,1028,253,72,3551
2/1/2016,VA,Virginia,Lunenburg,51111,2932,2535,397,2383,16,2367,549,21,528,2711,2314,397,2006,1637,369,678,130,45,1153
2/1/2016,VA,Virginia,Lynchburg City,51680,14457,12283,2174,11543,100,11443,2914,107,2807,13477,11304,2173,10934,8957,1977,3227,445,150,7112
2/1/2016,VA,Virginia,Madison,51113,2820,2442,378,2483,*,*,337,*,*,2626,2248,378,1902,1560,342,382,86,27,1407
2/1/2016,VA,Virginia,Manassas City,51683,4143,3455,688,3601,35,3566,542,42,500,3497,2809,688,2387,1740,647,511,93,36,1747
2/1/2016,VA,Virginia,Manassas Park City,51685,1142,933,209,982,11,971,160,15,145,954,746,208,664,472,192,160,57,14,433
2/1/2016,VA,Virginia,Martinsville City,51690,3911,3044,867,2937,28,2909,974,40,934,3713,2846,867,3209,2488,721,1270,179,57,1703
2/1/2016,VA,Virginia,Mathews,51115,2755,2370,385,2526,11,2515,229,*,*,2614,2229,385,1762,1439,323,250,44,19,1449
2/1/2016,VA,Virginia,Mecklenburg,51117,8883,7417,1466,7326,56,7270,1557,49,1508,8388,6922,1466,6531,5351,1180,1860,383,119,4169
2/1/2016,VA,Virginia,Middlesex,51119,3459,2965,494,3077,23,3054,382,*,*,3252,2758,494,2452,2094,358,423,97,32,1900
2/1/2016,VA,Virginia,Montgomery,51121,12995,10733,2262,10696,47,10649,2299,35,2264,11830,9568,2262,9486,7343,2143,1798,311,118,7259
2/1/2016,VA,Virginia,Nelson,51125,4248,3684,564,3732,19,3713,516,13,503,3924,3360,564,2858,2341,517,564,104,45,2145
2/1/2016,VA,Virginia,New Kent,51127,3922,3268,654,3479,15,3464,443,*,*,3580,2926,654,2462,1937,525,273,79,15,2095
2/1/2016,VA,Virginia,Newport News City,51700,26491,20050,6441,21730,184,21546,4761,251,4510,24320,17880,6440,15622,9406,6216,4411,857,229,10125
2/1/2016,VA,Virginia,Norfolk City,51710,30957,23498,7459,24596,289,24307,6361,343,6018,27933,20474,7459,18437,11243,7194,6652,1317,289,10179
2/1/2016,VA,Virginia,Northampton,51131,3461,2905,556,2937,29,2908,524,26,498,3223,2667,556,2560,2048,512,893,98,36,1533
2/1/2016,VA,Virginia,Northumberland,51133,4511,3936,575,4182,17,4165,329,*,*,4215,3640,575,2737,2372,365,405,97,31,2204
2/1/2016,VA,Virginia,Norton City,51720,1171,854,317,785,*,*,386,*,*,1090,773,317,873,576,297,355,47,21,450
2/1/2016,VA,Virginia,Nottoway,51135,3599,2941,658,2927,33,2894,672,13,659,3347,2689,658,2604,2164,440,927,128,42,1507
2/1/2016,VA,Virginia,Orange,51137,8272,7326,946,7289,48,7241,983,35,948,7603,6657,946,4869,4167,702,912,227,73,3657
2/1/2016,VA,Virginia,Page,51139,5931,5216,715,4813,21,4792,1118,18,1100,5557,4842,715,4050,3434,616,1121,222,83,2624
2/1/2016,VA,Virginia,Patrick,51141,5043,3817,1226,4146,11,4135,897,14,883,4799,3574,1225,3885,2833,1052,967,211,82,2625
2/1/2016,VA,Virginia,Petersburg City,51730,7038,5366,1672,5218,109,5109,1820,77,1743,6450,4778,1672,4617,2992,1625,1922,361,78,2256
2/1/2016,VA,Virginia,Pittsylvania,51143,15522,12134,3388,12649,116,12533,2873,79,2794,14691,11303,3388,12021,9522,2499,2994,585,227,8215
2/1/2016,VA,Virginia,Poquoson City,51735,2428,2147,281,2261,*,*,167,*,*,2236,1955,281,1100,843,257,92,31,12,965
2/1/2016,VA,Virginia,Portsmouth City,51740,17473,13126,4347,13502,193,13309,3971,207,3764,15680,11335,4345,10225,6047,4178,3732,698,157,5638
2/1/2016,VA,Virginia,Powhatan,51145,5455,4391,1064,4842,21,4821,613,15,598,5012,3948,1064,3872,2924,948,378,110,36,3348
2/1/2016,VA,Virginia,Prince Edward,51147,4505,3711,794,3600,29,3571,905,30,875,4196,3402,794,3215,2602,613,1052,175,46,1942
2/1/2016,VA,Virginia,Prince George,51149,5466,4763,703,4622,30,4592,844,20,824,5033,4330,703,2977,2331,646,546,114,25,2292
2/1/2016,VA,Virginia,Prince William,51153,42627,35497,7130,37837,263,37574,4790,278,4512,36470,29344,7126,20810,14155,6655,4702,994,211,14903
2/1/2016,VA,Virginia,Pulaski,51155,8842,7213,1629,6962,33,6929,1880,28,1852,8267,6638,1629,6327,4790,1537,1614,329,125,4259
2/1/2016,VA,Virginia,Radford City,51750,1970,1600,370,1582,*,*,388,*,*,1810,1440,370,1482,1130,352,328,36,25,1093
2/1/2016,VA,Virginia,Rappahannock,51157,1937,1782,155,1786,*,*,151,*,*,1753,1599,154,1165,1037,128,152,39,11,963
2/1/2016,VA,Virginia,Richmond,51159,1885,1529,356,1632,15,1617,253,13,240,1772,1416,356,1283,1037,246,289,91,20,883
2/1/2016,VA,Virginia,Richmond City,51760,31969,22216,9753,24954,297,24657,7015,346,6669,28758,19005,9753,23698,14306,9392,8165,1443,326,13764
2/1/2016,VA,Virginia,Roanoke,51161,22314,17898,4416,19733,96,19637,2581,49,2532,20671,16256,4415,16157,12136,4021,1868,443,159,13687
2/1/2016,VA,Virginia,Roanoke City,51770,19821,14409,5412,14795,142,14653,5026,146,4880,18192,12782,5410,14566,9387,5179,4598,868,218,8882
2/1/2016,VA,Virginia,Rockbridge,51163,5687,4809,878,4788,22,4766,899,*,*,5303,4425,878,3933,3209,724,824,171,59,2879
2/1/2016,VA,Virginia,Rockingham,51165,16260,13829,2431,14221,49,14172,2039,44,1995,15022,12591,2431,11480,9742,1738,1693,517,155,9115
2/1/2016,VA,Virginia,Russell,51167,7645,5160,2485,5156,14,5142,2489,*,*,7321,4836,2485,6212,4149,2063,1669,315,135,4093
2/1/2016,VA,Virginia,Salem City,51775,5863,4796,1067,4922,31,4891,941,21,920,5382,4315,1067,4195,3213,982,813,159,44,3179
2/1/2016,VA,Virginia,Scott,51169,6516,3343,3173,4856,12,4844,1660,14,1646,6245,3072,3173,5386,2271,3115,1518,254,121,3493
2/1/2016,VA,Virginia,Shenandoah,51171,9961,8814,1147,8746,24,8722,1215,25,1190,9333,8186,1147,6474,5511,963,1245,246,104,4879
2/1/2016,VA,Virginia,Smyth,51173,8734,6777,1957,6475,21,6454,2259,24,2235,8230,6273,1957,6647,4885,1762,2110,430,150,3957
2/1/2016,VA,Virginia,Southampton,51175,3961,3325,636,3285,28,3257,676,26,650,3705,3069,636,2874,2312,562,726,136,33,1979
2/1/2016,VA,Virginia,Spotsylvania,51177,18815,16521,2294,16260,114,16146,2555,90,2465,16773,14480,2293,10096,8115,1981,1831,489,133,7643
2/1/2016,VA,Virginia,Stafford,51179,15209,13768,1441,13341,88,13253,1868,89,1779,13365,11924,1441,6786,5531,1255,1210,376,75,5125
2/1/2016,VA,Virginia,Staunton City,51790,5846,5007,839,4775,24,4751,1071,27,1044,5480,4641,839,4252,3526,726,1027,165,58,3002
2/1/2016,VA,Virginia,Suffolk City,51800,14711,11729,2982,11949,91,11858,2762,93,2669,13482,10500,2982,9324,6570,2754,2595,443,110,6176
2/1/2016,VA,Virginia,Surry,51181,1482,1134,348,1242,13,1229,240,12,228,1371,1023,348,999,673,326,202,76,15,706
2/1/2016,VA,Virginia,Sussex,51183,2314,1805,509,1888,33,1855,426,*,*,2152,1643,509,1651,1171,480,481,143,21,1006
2/1/2016,VA,Virginia,Tazewell,51185,11639,8498,3141,8540,38,8502,3099,38,3061,10988,7849,3139,8650,6669,1981,2201,443,182,5824
2/1/2016,VA,Virginia,Unknown,51999,*,*,*,*,*,*,*,*,*,*,*,*,*,*,*,*,*,*,*
2/1/2016,VA,Virginia,Virginia Beach City,51810,65301,54657,10644,57454,358,57096,7847,329,7518,59833,49195,10638,33421,23466,9955,6364,1342,373,25342
2/1/2016,VA,Virginia,Warren,51187,6932,6251,681,5907,24,5883,1025,24,1001,6325,5644,681,4241,3663,578,839,232,74,3096
2/1/2016,VA,Virginia,Washington,51191,14626,9959,4667,11585,56,11529,3041,27,3014,13780,9114,4666,11068,6763,4305,2441,526,180,7921
2/1/2016,VA,Virginia,Waynesboro City,51820,4695,3954,741,3828,19,3809,867,24,843,4396,3655,741,3487,2837,650,843,114,46,2484
2/1/2016,VA,Virginia,Westmoreland,51193,4660,4050,610,4078,27,4051,582,11,571,4272,3662,610,2658,2133,525,728,123,50,1757
2/1/2016,VA,Virginia,Williamsburg City,51830,2481,2100,381,2275,*,*,206,*,*,2261,1881,380,1564,1239,325,212,*,*,1315
2/1/2016,VA,Virginia,Winchester City,51840,4966,4420,546,4226,21,4205,740,18,722,4520,3974,546,3245,2779,466,806,125,51,2263
2/1/2016,VA,Virginia,Wise,51195,10394,6890,3504,6887,18,6869,3507,24,3483,9802,6299,3503,7706,4398,3308,2395,498,161,4652
2/1/2016,VA,Virginia,Wythe,51197,7307,5642,1665,5663,32,5631,1644,22,1622,6915,5250,1665,5343,3876,1467,1454,276,106,3507
2/1/2016,VA,Virginia,York,51199,10893,9566,1327,10001,46,9955,892,27,865,9985,8658,1327,5218,3995,1223,601,166,40,4411
1/1/2016,VA,Virginia,Accomack,51001,8418,7214,1204,7208,50,7158,1210,47,1163,7875,6671,1204,5742,4713,1029,1512,390,99,3741
1/1/2016,VA,Virginia,Albemarle,51003,18537,16522,2015,16982,62,16920,1555,59,1496,16691,14676,2015,12509,10717,1792,1442,286,94,10687
1/1/2016,VA,Virginia,Alexandria City,51510,16301,14107,2194,14923,76,14847,1378,93,1285,13170,10978,2192,7712,5644,2068,1939,333,73,5367
1/1/2016,VA,Virginia,Alleghany,51005,4508,3852,656,3613,20,3593,895,16,879,4274,3618,656,3418,2907,511,804,113,53,2448
1/1/2016,VA,Virginia,Amelia,51007,2907,2258,649,2429,13,2416,478,13,465,2679,2030,649,2069,1470,599,469,78,38,1484
1/1/2016,VA,Virginia,Amherst,51009,7431,6237,1194,6151,49,6102,1280,33,1247,6919,5725,1194,5530,4427,1103,1140,241,82,4067
1/1/2016,VA,Virginia,Appomattox,51011,3714,3143,571,3019,18,3001,695,21,674,3508,2937,571,2793,2270,523,665,100,45,1983
1/1/2016,VA,Virginia,Arlington,51013,22391,19544,2847,20798,88,20710,1593,87,1506,17815,14968,2847,10354,7673,2681,2826,333,122,7073
1/1/2016,VA,Virginia,Augusta,51015,16982,14586,2396,14593,50,14543,2389,44,2345,15936,13540,2396,12053,10060,1993,1766,401,164,9722
1/1/2016,VA,Virginia,Bath,51017,1254,1142,112,1105,*,*,149,*,*,1178,1066,112,916,822,94,180,34,23,679
1/1/2016,VA,Virginia,Bedford,51019,18354,14989,3365,15621,79,15542,2733,47,2686,17154,13792,3362,13232,10465,2767,1932,491,164,10645
1/1/2016,VA,Virginia,Bland,51021,1729,1358,371,1358,*,*,371,*,*,1625,1254,371,1225,1027,198,257,50,22,896
1/1/2016,VA,Virginia,Botetourt,51023,8127,6343,1784,7039,45,6994,1088,20,1068,7504,5720,1784,5828,4204,1624,804,196,63,4765
1/1/2016,VA,Virginia,Bristol City,51520,4404,2669,1735,3426,18,3408,978,*,*,4144,2409,1735,3468,1784,1684,1001,155,62,2250
1/1/2016,VA,Virginia,Brunswick,51025,3859,3171,688,3139,28,3111,720,27,693,3641,2953,688,2842,2216,626,1101,116,42,1583
1/1/2016,VA,Virginia,Buchanan,51027,7310,4500,2810,4553,17,4536,2757,*,*,6988,4179,2809,5795,3811,1984,1590,425,122,3658
1/1/2016,VA,Virginia,Buckingham,51029,3347,2758,589,2700,20,2680,647,13,634,3122,2533,589,2364,1979,385,705,151,43,1465
1/1/2016,VA,Virginia,Buena Vista City,51530,1428,1174,254,1153,*,*,275,*,*,1339,1085,254,1038,831,207,312,65,20,641
1/1/2016,VA,Virginia,Campbell,51031,12204,10222,1982,10029,88,9941,2175,63,2112,11458,9476,1982,9181,7358,1823,2032,386,180,6583
1/1/2016,VA,Virginia,Caroline,51033,5387,4444,943,4498,29,4469,889,40,849,4890,3947,943,3342,2480,862,753,249,53,2287
1/1/2016,VA,Virginia,Carroll,51035,7783,6685,1098,6246,23,6223,1537,19,1518,7380,6282,1098,5697,4801,896,1615,276,104,3702
1/1/2016,VA,Virginia,Charles City,51036,1763,1361,402,1497,18,1479,266,12,254,1634,1232,402,1225,880,345,248,78,21,878
1/1/2016,VA,Virginia,Charlotte,51037,3274,2769,505,2662,17,2645,612,14,598,3091,2586,505,2422,1974,448,773,128,52,1469
1/1/2016,VA,Virginia,Charlottesville City,51540,5890,5135,755,4791,26,4765,1099,49,1050,5293,4539,754,4195,3477,718,1185,155,58,2797
1/1/2016,VA,Virginia,Chesapeake City,51550,34326,27882,6444,29331,267,29064,4995,228,4767,31047,24603,6444,18841,12822,6019,3873,872,240,13856
1/1/2016,VA,Virginia,Chesterfield,51041,53488,41410,12078,46278,182,46096,7210,247,6963,48267,36191,12076,36357,25286,11071,4993,983,292,30089
1/1/2016,VA,Virginia,Clarke,51043,2997,2673,324,2748,17,2731,249,*,*,2717,2393,324,1827,1554,273,261,76,31,1459
1/1/2016,VA,Virginia,Colonial Heights City,51570,4118,3544,574,3558,15,3543,560,13,547,3786,3212,574,2360,1828,532,438,108,21,1793
1/1/2016,VA,Virginia,Covington City,51580,1642,1428,214,1279,*,*,363,*,*,1531,1317,214,1197,997,200,352,51,16,778
1/1/2016,VA,Virginia,Craig,51045,1252,995,257,975,*,*,277,*,*,1154,897,257,898,650,248,203,39,12,644
1/1/2016,VA,Virginia,Culpeper,51047,8535,7442,1093,7361,54,7307,1174,35,1139,7764,6671,1093,5344,4367,977,1088,267,67,3922
1/1/2016,VA,Virginia,Cumberland,51049,2173,1691,482,1797,*,*,376,*,*,2018,1536,482,1557,1116,441,419,86,26,1026
1/1/2016,VA,Virginia,Danville City,51590,11051,8790,2261,8686,88,8598,2365,120,2245,10477,8216,2261,8683,7304,1379,3146,458,162,4917
1/1/2016,VA,Virginia,Dickenson,51051,4678,2993,1685,2892,*,*,1786,12,1774,4457,2772,1685,3623,2117,1506,1089,220,87,2227
1/1/2016,VA,Virginia,Dinwiddie,51053,5543,4407,1136,4440,40,4400,1103,35,1068,5111,3975,1136,3744,2659,1085,875,194,56,2619
1/1/2016,VA,Virginia,Emporia City,51595,1132,858,274,864,15,849,268,14,254,1061,787,274,866,641,225,414,*,*,376
1/1/2016,VA,Virginia,Essex,51057,2717,2246,471,2315,18,2297,402,13,389,2546,2075,471,1889,1540,349,414,96,28,1351
1/1/2016,VA,Virginia,Fairfax,51059,136151,118390,17761,128297,561,127736,7854,410,7444,110454,92721,17733,62447,45997,16450,12460,2708,481,46798
1/1/2016,VA,Virginia,Fairfax City,51600,3579,3078,501,3305,16,3289,274,*,*,3007,2506,501,1783,1321,462,367,57,11,1348
1/1/2016,VA,Virginia,Falls Church City,51610,1756,1526,230,1671,*,*,85,*,*,1388,1158,230,823,614,209,126,*,*,675
1/1/2016,VA,Virginia,Fauquier,51061,11365,10347,1018,10286,53,10233,1079,43,1036,10037,9020,1017,6293,5420,873,887,213,60,5133
1/1/2016,VA,Virginia,Floyd,51063,3807,3068,739,3267,12,3255,540,*,*,3552,2813,739,2755,2075,680,530,100,52,2073
1/1/2016,VA,Virginia,Fluvanna,51065,5380,4649,731,4819,23,4796,561,24,537,4927,4196,731,3552,2903,649,471,127,21,2933
1/1/2016,VA,Virginia,Franklin,51067,13822,10209,3613,11449,52,11397,2373,26,2347,12985,9372,3613,10463,7046,3417,1914,482,167,7900
1/1/2016,VA,Virginia,Franklin City,51620,1870,1566,304,1478,21,1457,392,18,374,1759,1455,304,1440,1158,282,527,66,18,829
1/1/2016,VA,Virginia,Frederick,51069,14809,13069,1740,13137,52,13085,1672,45,1627,13525,11785,1740,9177,7696,1481,1385,361,135,7296
1/1/2016,VA,Virginia,Fredericksburg City,51630,3766,3313,453,3091,19,3072,675,25,650,3405,2952,453,2286,1859,427,721,87,43,1435
1/1/2016,VA,Virginia,Galax City,51640,1951,1805,146,1502,*,*,449,12,437,1848,1702,146,1451,1330,121,668,65,34,684
1/1/2016,VA,Virginia,Giles,51071,4468,3420,1048,3525,22,3503,943,15,928,4208,3161,1047,3390,2711,679,773,142,37,2438
1/1/2016,VA,Virginia,Gloucester,51073,7854,6599,1255,6714,38,6676,1140,20,1120,7252,5997,1255,4589,3448,1141,911,182,53,3443
1/1/2016,VA,Virginia,Goochland,51075,5142,4166,976,4674,21,4653,468,18,450,4663,3687,976,3730,2896,834,405,97,34,3194
1/1/2016,VA,Virginia,Grayson,51077,4541,3946,595,3705,13,3692,836,*,*,4350,3755,595,3233,2742,491,988,183,87,1975
1/1/2016,VA,Virginia,Greene,51079,3434,2971,463,2999,*,*,435,*,*,3152,2689,463,2256,1829,427,430,81,24,1721
1/1/2016,VA,Virginia,Greensville,51081,2403,1801,602,1912,21,1891,491,18,473,2248,1646,602,1852,1338,514,562,132,26,1132
1/1/2016,VA,Virginia,Halifax,51083,9373,8112,1261,7607,67,7540,1766,70,1696,8836,7575,1261,7101,5980,1121,2113,470,145,4373
1/1/2016,VA,Virginia,Hampton City,51650,23601,18236,5365,19389,217,19172,4212,198,4014,21584,16219,5365,12914,7759,5155,3440,813,185,8476
1/1/2016,VA,Virginia,Hanover,51085,19084,15010,4074,17212,82,17130,1872,55,1817,17409,13335,4074,13595,10071,3524,1368,357,101,11769
1/1/2016,VA,Virginia,Harrisonburg City,51660,5049,4451,598,4248,19,4229,801,23,778,4591,3993,598,3600,3158,442,913,139,41,2507
1/1/2016,VA,Virginia,Henrico,51087,51928,39710,12218,45110,353,44757,6818,298,6520,47059,34841,12218,37044,26186,10858,5824,1401,395,29424
1/1/2016,VA,Virginia,Henry,51089,14906,10749,4157,11811,82,11729,3095,62,3033,14203,10046,4157,12012,8706,3306,2979,729,256,8048
1/1/2016,VA,Virginia,Highland,51091,715,653,62,659,*,*,56,*,*,674,612,62,495,435,60,65,*,*,405
1/1/2016,VA,Virginia,Hopewell City,51670,4373,3545,828,3377,33,3344,996,38,958,4088,3260,828,2765,1957,808,910,162,38,1655
1/1/2016,VA,Virginia,Isle of Wight,51093,7458,5833,1625,6518,53,6465,940,27,913,6928,5303,1625,4901,3373,1528,878,203,78,3742
1/1/2016,VA,Virginia,James City,51095,18725,16473,2252,17599,62,17537,1126,43,1083,17314,15065,2249,10806,8914,1892,819,197,45,9745
1/1/2016,VA,Virginia,King and Queen,51097,1667,1395,272,1399,*,*,268,*,*,1559,1287,272,1167,926,241,259,78,15,815
1/1/2016,VA,Virginia,King George,51099,3498,3140,358,3000,19,2981,498,21,477,3042,2684,358,1559,1227,332,434,88,16,1021
1/1/2016,VA,Virginia,King William,51101,3076,2635,441,2629,24,2605,447,26,421,2845,2404,441,2250,1853,397,363,101,21,1765
1/1/2016,VA,Virginia,Lancaster,51103,4186,3641,545,3858,19,3839,328,11,317,4003,3458,545,2848,2469,379,471,93,25,2259
1/1/2016,VA,Virginia,Lee,51105,6283,4051,2232,4262,16,4246,2021,12,2009,5962,3732,2230,4849,2745,2104,1899,256,80,2614
1/1/2016,VA,Virginia,Lexington City,51678,1581,1423,158,1450,16,1434,131,*,*,1478,1320,158,1116,985,131,214,*,*,861
1/1/2016,VA,Virginia,Loudoun,51107,32133,27365,4768,29900,121,29779,2233,109,2124,26778,22016,4762,17225,12880,4345,2695,618,144,13768
1/1/2016,VA,Virginia,Louisa,51109,7238,6019,1219,6070,40,6030,1168,32,1136,6666,5447,1219,4898,3769,1129,1026,253,71,3548
1/1/2016,VA,Virginia,Lunenburg,51111,2928,2539,389,2382,17,2365,546,21,525,2710,2321,389,2002,1640,362,673,130,44,1155
1/1/2016,VA,Virginia,Lynchburg City,51680,14449,12266,2183,11539,101,11438,2910,108,2802,13479,11297,2182,10927,8942,1985,3205,450,156,7116
1/1/2016,VA,Virginia,Madison,51113,2820,2440,380,2486,*,*,334,*,*,2622,2242,380,1900,1556,344,379,87,26,1408
1/1/2016,VA,Virginia,Manassas City,51683,4126,3444,682,3587,36,3551,539,42,497,3497,2815,682,2384,1742,642,503,97,35,1749
1/1/2016,VA,Virginia,Manassas Park City,51685,1139,929,210,979,11,968,160,15,145,953,744,209,663,472,191,160,55,15,433
1/1/2016,VA,Virginia,Martinsville City,51690,3917,3043,874,2947,28,2919,970,40,930,3726,2852,874,3221,2496,725,1272,181,57,1711
1/1/2016,VA,Virginia,Mathews,51115,2756,2372,384,2528,11,2517,228,*,*,2615,2231,384,1763,1441,322,249,44,19,1451
1/1/2016,VA,Virginia,Mecklenburg,51117,8880,7409,1471,7330,58,7272,1550,48,1502,8393,6922,1471,6529,5347,1182,1857,382,118,4172
1/1/2016,VA,Virginia,Middlesex,51119,3466,2973,493,3089,23,3066,377,*,*,3256,2763,493,2446,2091,355,418,99,32,1897
1/1/2016,VA,Virginia,Montgomery,51121,12968,10690,2278,10678,47,10631,2290,35,2255,11819,9541,2278,9473,7314,2159,1787,313,119,7254
1/1/2016,VA,Virginia,Nelson,51125,4247,3688,559,3730,19,3711,517,13,504,3928,3369,559,2851,2339,512,563,103,44,2141
1/1/2016,VA,Virginia,New Kent,51127,3909,3252,657,3470,16,3454,439,*,*,3573,2916,657,2450,1921,529,272,77,16,2085
1/1/2016,VA,Virginia,Newport News City,51700,26445,20028,6417,21699,185,21514,4746,253,4493,24279,17863,6416,15583,9392,6191,4373,850,229,10131
1/1/2016,VA,Virginia,Norfolk City,51710,30891,23462,7429,24559,289,24270,6332,343,5989,27887,20458,7429,18387,11226,7161,6618,1315,286,10168
1/1/2016,VA,Virginia,Northampton,51131,3454,2904,550,2937,29,2908,517,26,491,3219,2669,550,2553,2047,506,890,97,37,1529
1/1/2016,VA,Virginia,Northumberland,51133,4512,3937,575,4184,19,4165,328,*,*,4219,3644,575,2738,2375,363,398,100,31,2209
1/1/2016,VA,Virginia,Norton City,51720,1173,856,317,790,*,*,383,*,*,1093,776,317,874,577,297,352,48,21,453
1/1/2016,VA,Virginia,Nottoway,51135,3607,2950,657,2935,34,2901,672,13,659,3355,2698,657,2607,2168,439,930,128,42,1507
1/1/2016,VA,Virginia,Orange,51137,8260,7317,943,7279,48,7231,981,36,945,7599,6656,943,4862,4164,698,908,230,73,3651
1/1/2016,VA,Virginia,Page,51139,5919,5200,719,4803,21,4782,1116,18,1098,5541,4822,719,4040,3420,620,1116,224,83,2617
1/1/2016,VA,Virginia,Patrick,51141,5036,3810,1226,4140,12,4128,896,14,882,4796,3571,1225,3880,2832,1048,965,212,85,2618
1/1/2016,VA,Virginia,Petersburg City,51730,7050,5373,1677,5227,113,5114,1823,79,1744,6461,4784,1677,4628,2999,1629,1922,363,79,2264
1/1/2016,VA,Virginia,Pittsylvania,51143,15494,12102,3392,12643,118,12525,2851,80,2771,14670,11278,3392,11990,9483,2507,2972,584,227,8207
1/1/2016,VA,Virginia,Poquoson City,51735,2425,2145,280,2260,*,*,165,0,165,2232,1952,280,1096,840,256,92,31,12,961
1/1/2016,VA,Virginia,Portsmouth City,51740,17444,13120,4324,13479,196,13283,3965,212,3753,15654,11332,4322,10196,6045,4151,3712,693,154,5637
1/1/2016,VA,Virginia,Powhatan,51145,5425,4356,1069,4815,21,4794,610,14,596,4993,3924,1069,3855,2904,951,377,109,35,3334
1/1/2016,VA,Virginia,Prince Edward,51147,4500,3706,794,3599,29,3570,901,31,870,4194,3400,794,3215,2602,613,1047,175,46,1947
1/1/2016,VA,Virginia,Prince George,51149,5448,4743,705,4610,32,4578,838,20,818,5020,4315,705,2963,2315,648,540,113,25,2285
1/1/2016,VA,Virginia,Prince William,51153,42475,35373,7102,37707,266,37441,4768,277,4491,36377,29279,7098,20727,14104,6623,4637,997,206,14887
1/1/2016,VA,Virginia,Pulaski,51155,8850,7224,1626,6971,34,6937,1879,29,1850,8270,6644,1626,6335,4802,1533,1610,332,126,4267
1/1/2016,VA,Virginia,Radford City,51750,1969,1596,373,1582,*,*,387,*,*,1810,1437,373,1485,1130,355,324,37,25,1099
1/1/2016,VA,Virginia,Rappahannock,51157,1935,1780,155,1783,*,*,152,*,*,1747,1593,154,1163,1035,128,151,40,11,961
1/1/2016,VA,Virginia,Richmond,51159,1883,1530,353,1634,15,1619,249,13,236,1770,1417,353,1282,1037,245,289,91,20,882
1/1/2016,VA,Virginia,Richmond City,51760,31908,22197,9711,24916,301,24615,6992,348,6644,28729,19018,9711,23639,14293,9346,8094,1448,326,13771
1/1/2016,VA,Virginia,Roanoke,51161,22275,17854,4421,19704,99,19605,2571,49,2522,20654,16234,4420,16129,12103,4026,1863,440,159,13667
1/1/2016,VA,Virginia,Roanoke City,51770,19800,14400,5400,14797,144,14653,5003,146,4857,18182,12784,5398,14558,9398,5160,4563,867,218,8910
1/1/2016,VA,Virginia,Rockbridge,51163,5693,4825,868,4797,23,4774,896,*,*,5309,4441,868,3935,3221,714,825,175,59,2876
1/1/2016,VA,Virginia,Rockingham,51165,16235,13790,2445,14214,52,14162,2021,44,1977,15001,12557,2444,11462,9724,1738,1684,519,157,9102
1/1/2016,VA,Virginia,Russell,51167,7654,5176,2478,5166,14,5152,2488,*,*,7319,4841,2478,6208,4154,2054,1662,313,134,4099
1/1/2016,VA,Virginia,Salem City,51775,5872,4795,1077,4930,31,4899,942,20,922,5393,4316,1077,4197,3205,992,818,155,44,3180
1/1/2016,VA,Virginia,Scott,51169,6516,3345,3171,4862,12,4850,1654,15,1639,6242,3071,3171,5384,2271,3113,1517,257,120,3490
1/1/2016,VA,Virginia,Shenandoah,51171,9949,8798,1151,8744,25,8719,1205,25,1180,9326,8175,1151,6463,5498,965,1244,241,103,4875
1/1/2016,VA,Virginia,Smyth,51173,8723,6765,1958,6464,22,6442,2259,25,2234,8226,6268,1958,6654,4894,1760,2096,429,155,3974
1/1/2016,VA,Virginia,Southampton,51175,3954,3325,629,3281,28,3253,673,26,647,3697,3068,629,2869,2311,558,725,136,33,1975
1/1/2016,VA,Virginia,Spotsylvania,51177,18758,16465,2293,16216,115,16101,2542,91,2451,16724,14432,2292,10061,8083,1978,1809,494,134,7624
1/1/2016,VA,Virginia,Stafford,51179,15161,13731,1430,13299,90,13209,1862,92,1770,13338,11908,1430,6767,5524,1243,1199,370,78,5120
1/1/2016,VA,Virginia,Staunton City,51790,5829,5001,828,4762,24,4738,1067,28,1039,5467,4639,828,4247,3533,714,1023,168,57,2999
1/1/2016,VA,Virginia,Suffolk City,51800,14689,11697,2992,11936,94,11842,2753,94,2659,13466,10474,2992,9311,6549,2762,2587,439,110,6175
1/1/2016,VA,Virginia,Surry,51181,1479,1132,347,1240,13,1227,239,12,227,1371,1024,347,998,672,326,202,76,15,705
1/1/2016,VA,Virginia,Sussex,51183,2309,1803,506,1885,33,1852,424,*,*,2148,1642,506,1654,1177,477,480,145,21,1008
1/1/2016,VA,Virginia,Tazewell,51185,11632,8489,3143,8542,40,8502,3090,38,3052,10985,7844,3141,8640,6657,1983,2191,441,185,5823
1/1/2016,VA,Virginia,Unknown,51999,*,*,*,*,*,*,*,*,*,*,*,*,*,*,*,*,*,*,*
1/1/2016,VA,Virginia,Virginia Beach City,51810,65142,54526,10616,57335,362,56973,7807,322,7485,59700,49091,10609,33320,23396,9924,6317,1361,371,25271
1/1/2016,VA,Virginia,Warren,51187,6930,6243,687,5906,24,5882,1024,25,999,6322,5635,687,4240,3657,583,838,231,73,3098
1/1/2016,VA,Virginia,Washington,51191,14626,9945,4681,11594,59,11535,3032,27,3005,13779,9099,4680,11054,6739,4315,2425,532,179,7918
1/1/2016,VA,Virginia,Waynesboro City,51820,4698,3968,730,3836,20,3816,862,24,838,4396,3666,730,3484,2844,640,841,114,48,2481
1/1/2016,VA,Virginia,Westmoreland,51193,4651,4045,606,4069,27,4042,582,11,571,4257,3651,606,2647,2127,520,725,123,47,1752
1/1/2016,VA,Virginia,Williamsburg City,51830,2478,2100,378,2275,*,*,203,*,*,2260,1883,377,1563,1241,322,209,*,*,1318
1/1/2016,VA,Virginia,Winchester City,51840,4963,4412,551,4228,21,4207,735,18,717,4523,3972,551,3238,2769,469,797,127,51,2263
1/1/2016,VA,Virginia,Wise,51195,10375,6887,3488,6877,20,6857,3498,24,3474,9784,6297,3487,7690,4399,3291,2386,497,162,4645
1/1/2016,VA,Virginia,Wythe,51197,7308,5640,1668,5665,32,5633,1643,22,1621,6917,5249,1668,5341,3871,1470,1449,280,105,3507
1/1/2016,VA,Virginia,York,51199,10860,9525,1335,9975,47,9928,885,29,856,9958,8623,1335,5207,3976,1231,603,164,40,4400
7/1/2016,VA,Virginia,Accomack,51001,8489,7284,1205,7241,46,7195,1248,47,1201,7931,6726,1205,5784,4751,1033,1538,380,98,3768
7/1/2016,VA,Virginia,Albemarle,51003,18852,16846,2006,17261,56,17205,1591,56,1535,16946,14940,2006,12661,10880,1781,1469,278,93,10821
7/1/2016,VA,Virginia,Alexandria City,51510,16654,14457,2197,15242,71,15171,1412,89,1323,13444,11249,2195,7849,5776,2073,2021,321,69,5438
7/1/2016,VA,Virginia,Alleghany,51005,4501,3860,641,3591,18,3573,910,16,894,4284,3643,641,3405,2899,506,815,103,56,2431
7/1/2016,VA,Virginia,Amelia,51007,2931,2286,645,2449,12,2437,482,13,469,2707,2062,645,2088,1490,598,473,77,39,1499
7/1/2016,VA,Virginia,Amherst,51009,7494,6306,1188,6196,46,6150,1298,31,1267,6979,5791,1188,5581,4482,1099,1168,231,79,4103
7/1/2016,VA,Virginia,Appomattox,51011,3728,3167,561,3018,17,3001,710,20,690,3524,2963,561,2800,2287,513,678,93,37,1992
7/1/2016,VA,Virginia,Arlington,51013,22833,19956,2877,21202,84,21118,1631,89,1542,18126,15249,2877,10543,7828,2715,2915,321,114,7193
7/1/2016,VA,Virginia,Augusta,51015,17193,14795,2398,14739,46,14693,2454,43,2411,16149,13751,2398,12220,10226,1994,1846,399,153,9822
7/1/2016,VA,Virginia,Bath,51017,1263,1147,116,1110,*,*,153,*,*,1190,1074,116,927,830,97,177,35,24,691
7/1/2016,VA,Virginia,Bedford,51019,18578,15230,3348,15780,73,15707,2798,45,2753,17367,14021,3346,13382,10620,2762,1977,476,155,10774
7/1/2016,VA,Virginia,Bland,51021,1749,1364,385,1365,*,*,384,*,*,1645,1260,385,1240,1031,209,262,47,20,911
7/1/2016,VA,Virginia,Botetourt,51023,8235,6438,1797,7112,41,7071,1123,21,1102,7611,5814,1797,5895,4256,1639,821,191,60,4823
7/1/2016,VA,Virginia,Bristol City,51520,4409,2664,1745,3411,17,3394,998,*,*,4142,2397,1745,3458,1764,1694,999,149,58,2252
7/1/2016,VA,Virginia,Brunswick,51025,3902,3226,676,3163,28,3135,739,27,712,3666,2990,676,2859,2243,616,1123,110,42,1584
7/1/2016,VA,Virginia,Buchanan,51027,7314,4511,2803,4507,17,4490,2807,11,2796,7018,4215,2803,5793,3801,1992,1631,414,117,3631
7/1/2016,VA,Virginia,Buckingham,51029,3374,2785,589,2715,18,2697,659,15,644,3148,2559,589,2376,1990,386,721,144,45,1466
7/1/2016,VA,Virginia,Buena Vista City,51530,1440,1179,261,1158,*,*,282,*,*,1350,1089,261,1047,831,216,322,63,20,642
7/1/2016,VA,Virginia,Campbell,51031,12283,10314,1969,10059,83,9976,2224,64,2160,11540,9571,1969,9244,7437,1807,2094,372,171,6607
7/1/2016,VA,Virginia,Caroline,51033,5475,4546,929,4558,27,4531,917,39,878,4958,4029,929,3361,2510,851,795,235,53,2278
7/1/2016,VA,Virginia,Carroll,51035,7840,6743,1097,6272,21,6251,1568,18,1550,7426,6329,1097,5713,4818,895,1624,277,103,3709
7/1/2016,VA,Virginia,Charles City,51036,1788,1386,402,1514,17,1497,274,12,262,1647,1245,402,1239,894,345,255,80,18,886
7/1/2016,VA,Virginia,Charlotte,51037,3289,2791,498,2668,15,2653,621,16,605,3117,2619,498,2442,2000,442,793,125,53,1471
7/1/2016,VA,Virginia,Charlottesville City,51540,5993,5234,759,4880,25,4855,1113,49,1064,5397,4638,759,4267,3545,722,1227,157,52,2831
7/1/2016,VA,Virginia,Chesapeake City,51550,34883,28362,6521,29732,244,29488,5151,233,4918,31628,25107,6521,19107,13009,6098,4054,840,241,13972
7/1/2016,VA,Virginia,Chesterfield,51041,54546,42286,12260,47168,162,47006,7378,244,7134,49287,37029,12258,37125,25852,11273,5199,979,287,30660
7/1/2016,VA,Virginia,Clarke,51043,3027,2707,320,2776,14,2762,251,*,*,2748,2428,320,1825,1557,268,261,73,34,1457
7/1/2016,VA,Virginia,Colonial Heights City,51570,4109,3535,574,3533,13,3520,576,13,563,3785,3211,574,2382,1849,533,469,100,23,1790
7/1/2016,VA,Virginia,Covington City,51580,1640,1412,228,1271,*,*,369,*,*,1530,1302,228,1202,987,215,362,54,18,768
7/1/2016,VA,Virginia,Craig,51045,1270,1008,262,989,*,*,281,*,*,1169,907,262,911,659,252,202,40,11,658
7/1/2016,VA,Virginia,Culpeper,51047,8640,7565,1075,7439,45,7394,1201,36,1165,7846,6771,1075,5363,4399,964,1115,254,65,3929
7/1/2016,VA,Virginia,Cumberland,51049,2193,1708,485,1805,*,*,388,*,*,2033,1548,485,1572,1129,443,427,84,25,1036
7/1/2016,VA,Virginia,Danville City,51590,11057,8808,2249,8641,79,8562,2416,121,2295,10489,8240,2249,8655,7286,1369,3211,429,159,4856
7/1/2016,VA,Virginia,Dickenson,51051,4673,2986,1687,2866,*,*,1807,14,1793,4460,2773,1687,3619,2102,1517,1088,215,82,2234
7/1/2016,VA,Virginia,Dinwiddie,51053,5582,4445,1137,4466,34,4432,1116,34,1082,5145,4008,1137,3756,2667,1089,892,181,54,2629
7/1/2016,VA,Virginia,Emporia City,51595,1139,859,280,865,13,852,274,14,260,1069,789,280,869,637,232,421,*,*,371
7/1/2016,VA,Virginia,Essex,51057,2756,2282,474,2341,18,2323,415,11,404,2582,2108,474,1905,1550,355,419,91,23,1372
7/1/2016,VA,Virginia,Fairfax,51059,139483,121341,18142,131400,503,130897,8083,413,7670,113257,95142,18115,63887,47052,16835,12947,2613,469,47858
7/1/2016,VA,Virginia,Fairfax City,51600,3648,3130,518,3376,15,3361,272,*,*,3065,2547,518,1825,1347,478,380,58,11,1376
7/1/2016,VA,Virginia,Falls Church City,51610,1780,1546,234,1695,*,*,85,*,*,1396,1162,234,830,616,214,130,*,*,678
7/1/2016,VA,Virginia,Fauquier,51061,11569,10392,1177,10465,51,10414,1104,44,1060,10246,9070,1176,6382,5347,1035,919,206,59,5198
7/1/2016,VA,Virginia,Floyd,51063,3863,3122,741,3317,*,*,546,*,*,3605,2864,741,2784,2100,684,549,97,50,2088
7/1/2016,VA,Virginia,Fluvanna,51065,5469,4733,736,4892,21,4871,577,22,555,5013,4277,736,3610,2958,652,486,126,21,2977
7/1/2016,VA,Virginia,Franklin,51067,13944,10318,3626,11522,47,11475,2422,28,2394,13115,9489,3626,10544,7108,3436,1962,474,161,7947
7/1/2016,VA,Virginia,Franklin City,51620,1877,1582,295,1463,18,1445,414,19,395,1764,1469,295,1434,1161,273,538,66,15,815
7/1/2016,VA,Virginia,Frederick,51069,14982,13252,1730,13244,48,13196,1738,48,1690,13679,11949,1730,9270,7795,1475,1432,341,136,7361
7/1/2016,VA,Virginia,Fredericksburg City,51630,3818,3362,456,3123,18,3105,695,26,669,3449,2993,456,2328,1896,432,765,89,38,1436
7/1/2016,VA,Virginia,Galax City,51640,1936,1799,137,1488,*,*,448,*,*,1834,1697,137,1448,1333,115,678,62,31,677
7/1/2016,VA,Virginia,Giles,51071,4490,3424,1066,3528,19,3509,962,16,946,4227,3162,1065,3395,2690,705,792,132,35,2436
7/1/2016,VA,Virginia,Gloucester,51073,7907,6651,1256,6737,34,6703,1170,20,1150,7335,6079,1256,4616,3476,1140,938,174,47,3457
7/1/2016,VA,Virginia,Goochland,51075,5239,4247,992,4755,19,4736,484,19,465,4752,3760,992,3812,2966,846,413,92,30,3277
7/1/2016,VA,Virginia,Grayson,51077,4569,3978,591,3715,*,*,854,*,*,4368,3777,591,3239,2751,488,986,174,86,1993
7/1/2016,VA,Virginia,Greene,51079,3500,3032,468,3052,*,*,448,*,*,3214,2746,468,2307,1877,430,446,83,23,1755
7/1/2016,VA,Virginia,Greensville,51081,2414,1816,598,1915,22,1893,499,18,481,2259,1661,598,1843,1332,511,567,129,27,1120
7/1/2016,VA,Virginia,Halifax,51083,9411,8150,1261,7614,59,7555,1797,67,1730,8912,7651,1261,7105,5982,1123,2141,462,143,4359
7/1/2016,VA,Virginia,Hampton City,51650,23905,18462,5443,19574,199,19375,4331,202,4129,21874,16431,5443,13038,7803,5235,3531,796,182,8529
7/1/2016,VA,Virginia,Hanover,51085,19351,15232,4119,17422,78,17344,1929,53,1876,17628,13509,4119,13797,10228,3569,1387,349,95,11966
7/1/2016,VA,Virginia,Harrisonburg City,51660,5102,4524,578,4282,15,4267,820,23,797,4645,4067,578,3616,3192,424,935,132,39,2510
7/1/2016,VA,Virginia,Henrico,51087,52475,40098,12377,45529,316,45213,6946,291,6655,47601,35224,12377,37426,26388,11038,5989,1346,393,29698
7/1/2016,VA,Virginia,Henry,51089,14895,10793,4102,11754,69,11685,3141,60,3081,14207,10105,4102,11944,8657,3287,3017,694,252,7981
7/1/2016,VA,Virginia,Highland,51091,717,657,60,661,*,*,56,*,*,677,617,60,498,440,58,63,*,*,411
7/1/2016,VA,Virginia,Hopewell City,51670,4389,3546,843,3377,30,3347,1012,37,975,4110,3267,843,2765,1941,824,923,159,42,1641
7/1/2016,VA,Virginia,Isle of Wight,51093,7580,5957,1623,6617,52,6565,963,28,935,7045,5422,1623,4952,3429,1523,899,192,75,3786
7/1/2016,VA,Virginia,James City,51095,18961,16724,2237,17801,60,17741,1160,47,1113,17549,15315,2234,10999,9116,1883,848,194,48,9909
7/1/2016,VA,Virginia,King and Queen,51097,1685,1407,278,1409,*,*,276,*,*,1573,1295,278,1168,920,248,268,73,13,814
7/1/2016,VA,Virginia,King George,51099,3603,3241,362,3079,13,3066,524,22,502,3136,2774,362,1578,1243,335,446,78,15,1039
7/1/2016,VA,Virginia,King William,51101,3119,2682,437,2657,23,2634,462,24,438,2884,2447,437,2275,1882,393,377,104,20,1774
7/1/2016,VA,Virginia,Lancaster,51103,4225,3693,532,3891,16,3875,334,11,323,4037,3505,532,2855,2487,368,476,92,25,2262
7/1/2016,VA,Virginia,Lee,51105,6305,4043,2262,4244,16,4228,2061,12,2049,6000,3739,2261,4845,2709,2136,1921,251,74,2599
7/1/2016,VA,Virginia,Lexington City,51678,1596,1439,157,1461,15,1446,135,*,*,1491,1334,157,1123,993,130,213,*,*,872
7/1/2016,VA,Virginia,Loudoun,51107,32803,28048,4755,30509,112,30397,2294,110,2184,27332,22585,4747,17598,13264,4334,2824,615,138,14021
7/1/2016,VA,Virginia,Louisa,51109,7380,6160,1220,6170,38,6132,1210,34,1176,6806,5586,1220,4975,3847,1128,1064,242,71,3598
7/1/2016,VA,Virginia,Lunenburg,51111,2961,2566,395,2403,16,2387,558,21,537,2735,2340,395,2027,1662,365,691,124,46,1166
7/1/2016,VA,Virginia,Lynchburg City,51680,14553,12367,2186,11575,90,11485,2978,103,2875,13565,11380,2185,10927,8937,1990,3276,430,143,7078
7/1/2016,VA,Virginia,Madison,51113,2838,2457,381,2499,*,*,339,*,*,2640,2259,381,1903,1562,341,375,89,27,1412
7/1/2016,VA,Virginia,Manassas City,51683,4199,3508,691,3650,33,3617,549,39,510,3546,2855,691,2414,1762,652,522,90,35,1767
7/1/2016,VA,Virginia,Manassas Park City,51685,1174,968,206,1007,11,996,167,15,152,989,784,205,683,494,189,177,55,13,438
7/1/2016,VA,Virginia,Martinsville City,51690,3915,3048,867,2924,27,2897,991,39,952,3705,2838,867,3178,2456,722,1281,169,58,1670
7/1/2016,VA,Virginia,Mathews,51115,2773,2385,388,2540,*,*,233,*,*,2632,2244,388,1776,1448,328,256,40,20,1460
7/1/2016,VA,Virginia,Mecklenburg,51117,8928,7471,1457,7346,53,7293,1582,51,1531,8447,6990,1457,6566,5392,1174,1898,377,112,4179
7/1/2016,VA,Virginia,Middlesex,51119,3480,2982,498,3096,21,3075,384,*,*,3274,2776,498,2477,2110,367,436,91,30,1920
7/1/2016,VA,Virginia,Montgomery,51121,13173,10922,2251,10842,43,10799,2331,38,2293,11952,9701,2251,9551,7415,2136,1833,312,111,7295
7/1/2016,VA,Virginia,Nelson,51125,4307,3750,557,3781,16,3765,526,11,515,3959,3402,557,2873,2364,509,570,97,46,2160
7/1/2016,VA,Virginia,New Kent,51127,4010,3360,650,3555,15,3540,455,*,*,3655,3005,650,2509,1984,525,287,72,15,2135
7/1/2016,VA,Virginia,Newport News City,51700,26716,20255,6461,21832,175,21657,4884,250,4634,24483,18024,6459,15715,9478,6237,4558,820,225,10112
7/1/2016,VA,Virginia,Norfolk City,51710,31332,23774,7558,24794,267,24527,6538,345,6193,28268,20710,7558,18566,11266,7300,6860,1287,280,10139
7/1/2016,VA,Virginia,Northampton,51131,3480,2926,554,2955,27,2928,525,24,501,3256,2702,554,2574,2067,507,904,94,35,1541
7/1/2016,VA,Virginia,Northumberland,51133,4532,3962,570,4192,18,4174,340,*,*,4237,3667,570,2761,2401,360,409,95,35,2222
7/1/2016,VA,Virginia,Norton City,51720,1174,854,320,783,*,*,391,*,*,1094,774,320,870,571,299,352,46,19,453
7/1/2016,VA,Virginia,Nottoway,51135,3639,2983,656,2946,32,2914,693,16,677,3388,2732,656,2628,2189,439,940,129,40,1519
7/1/2016,VA,Virginia,Orange,51137,8316,7348,968,7308,40,7268,1008,38,970,7653,6685,968,4886,4167,719,924,214,68,3680
7/1/2016,VA,Virginia,Page,51139,5951,5235,716,4827,19,4808,1124,17,1107,5587,4871,716,4068,3447,621,1132,213,87,2636
7/1/2016,VA,Virginia,Patrick,51141,5069,3826,1243,4160,*,*,909,13,896,4823,3581,1242,3891,2820,1071,994,201,80,2616
7/1/2016,VA,Virginia,Petersburg City,51730,7083,5391,1692,5231,100,5131,1852,78,1774,6493,4801,1692,4619,2969,1650,1974,350,68,2227
7/1/2016,VA,Virginia,Pittsylvania,51143,15649,12246,3403,12733,104,12629,2916,76,2840,14832,11429,3403,12113,9628,2485,3070,565,213,8265
7/1/2016,VA,Virginia,Poquoson City,51735,2458,2177,281,2287,*,*,171,*,*,2263,1982,281,1100,842,258,93,27,13,967
7/1/2016,VA,Virginia,Portsmouth City,51740,17602,13205,4397,13566,177,13389,4036,209,3827,15797,11402,4395,10274,6039,4235,3798,679,148,5649
7/1/2016,VA,Virginia,Powhatan,51145,5516,4445,1071,4893,20,4873,623,15,608,5066,3995,1071,3921,2963,958,386,112,31,3392
7/1/2016,VA,Virginia,Prince Edward,51147,4534,3746,788,3619,25,3594,915,33,882,4216,3428,788,3220,2616,604,1068,169,44,1939
7/1/2016,VA,Virginia,Prince George,51149,5553,4858,695,4682,27,4655,871,22,849,5126,4431,695,3020,2380,640,567,113,23,2317
7/1/2016,VA,Virginia,Prince William,51153,43520,36239,7281,38580,242,38338,4940,288,4652,37302,30026,7276,21158,14348,6810,4909,955,219,15075
7/1/2016,VA,Virginia,Pulaski,51155,8899,7269,1630,6996,30,6966,1903,26,1877,8323,6693,1630,6351,4812,1539,1643,324,116,4268
7/1/2016,VA,Virginia,Radford City,51750,1992,1625,367,1598,*,*,394,*,*,1829,1462,367,1502,1150,352,333,40,23,1106
7/1/2016,VA,Virginia,Rappahannock,51157,1968,1809,159,1813,*,*,155,*,*,1784,1626,158,1183,1051,132,159,37,11,976
7/1/2016,VA,Virginia,Richmond,51159,1910,1556,354,1650,15,1635,260,15,245,1787,1433,354,1305,1057,248,302,88,21,894
7/1/2016,VA,Virginia,Richmond City,51760,32284,22443,9841,25152,277,24875,7132,348,6784,29105,19264,9841,23888,14405,9483,8432,1383,307,13766
7/1/2016,VA,Virginia,Roanoke,51161,22509,18107,4402,19871,91,19780,2638,53,2585,20888,16487,4401,16347,12332,4015,1944,426,153,13824
7/1/2016,VA,Virginia,Roanoke City,51770,19943,14497,5446,14825,136,14689,5118,145,4973,18322,12878,5444,14637,9424,5213,4731,852,212,8842
7/1/2016,VA,Virginia,Rockbridge,51163,5714,4829,885,4808,19,4789,906,*,*,5344,4459,885,3964,3233,731,837,170,60,2897
7/1/2016,VA,Virginia,Rockingham,51165,16436,14017,2419,14353,42,14311,2083,42,2041,15209,12790,2419,11599,9863,1736,1747,504,160,9188
7/1/2016,VA,Virginia,Russell,51167,7670,5187,2483,5141,12,5129,2529,*,*,7345,4862,2483,6213,4143,2070,1671,313,124,4105
7/1/2016,VA,Virginia,Salem City,51775,5884,4829,1055,4926,31,4895,958,21,937,5416,4361,1055,4217,3243,974,835,148,40,3194
7/1/2016,VA,Virginia,Scott,51169,6520,3350,3170,4841,*,*,1679,13,1666,6266,3096,3170,5389,2271,3118,1529,244,123,3493
7/1/2016,VA,Virginia,Shenandoah,51171,10048,8892,1156,8802,22,8780,1246,25,1221,9430,8274,1156,6542,5572,970,1276,240,101,4925
7/1/2016,VA,Virginia,Smyth,51173,8760,6811,1949,6470,20,6450,2290,23,2267,8248,6299,1949,6646,4898,1748,2166,406,147,3927
7/1/2016,VA,Virginia,Southampton,51175,3985,3356,629,3295,28,3267,690,25,665,3732,3103,629,2880,2325,555,745,132,33,1970
7/1/2016,VA,Virginia,Spotsylvania,51177,19098,16824,2274,16481,104,16377,2617,90,2527,17036,14763,2273,10208,8242,1966,1892,476,136,7704
7/1/2016,VA,Virginia,Stafford,51179,15492,14067,1425,13570,79,13491,1922,87,1835,13639,12214,1425,6855,5612,1243,1285,354,78,5138
7/1/2016,VA,Virginia,Staunton City,51790,5875,5040,835,4792,21,4771,1083,25,1058,5519,4684,835,4258,3534,724,1047,149,60,3002
7/1/2016,VA,Virginia,Suffolk City,51800,14890,11905,2985,12070,86,11984,2820,95,2725,13653,10668,2985,9383,6621,2762,2637,440,102,6204
7/1/2016,VA,Virginia,Surry,51181,1507,1161,346,1258,11,1247,249,13,236,1387,1041,346,1012,688,324,203,76,14,719
7/1/2016,VA,Virginia,Sussex,51183,2312,1801,511,1882,28,1854,430,*,*,2154,1643,511,1657,1175,482,491,138,18,1010
7/1/2016,VA,Virginia,Tazewell,51185,11702,8547,3155,8546,32,8514,3156,37,3119,11070,7917,3153,8672,6666,2006,2238,438,181,5815
7/1/2016,VA,Virginia,Unknown,51999,*,*,*,*,*,*,*,*,*,*,*,*,*,*,*,*,*,*,*
7/1/2016,VA,Virginia,Virginia Beach City,51810,66127,55401,10726,58097,325,57772,8030,338,7692,60639,49919,10720,33708,23658,10050,6521,1337,362,25488
7/1/2016,VA,Virginia,Warren,51187,7026,6350,676,5980,23,5957,1046,26,1020,6422,5746,676,4276,3702,574,857,231,76,3112
7/1/2016,VA,Virginia,Washington,51191,14711,10031,4680,11641,48,11593,3070,26,3044,13873,9194,4679,11113,6792,4321,2481,523,172,7937
7/1/2016,VA,Virginia,Waynesboro City,51820,4725,3997,728,3840,18,3822,885,22,863,4433,3705,728,3490,2853,637,865,109,44,2472
7/1/2016,VA,Virginia,Westmoreland,51193,4690,4070,620,4094,23,4071,596,11,585,4306,3686,620,2679,2142,537,733,121,51,1774
7/1/2016,VA,Virginia,Williamsburg City,51830,2500,2133,367,2288,*,*,212,*,*,2286,1920,366,1573,1262,311,210,*,*,1328
7/1/2016,VA,Virginia,Winchester City,51840,4995,4453,542,4229,20,4209,766,18,748,4555,4013,542,3255,2792,463,833,124,50,2248
7/1/2016,VA,Virginia,Wise,51195,10406,6910,3496,6860,17,6843,3546,23,3523,9845,6350,3495,7713,4408,3305,2430,474,159,4650
7/1/2016,VA,Virginia,Wythe,51197,7362,5689,1673,5687,30,5657,1675,21,1654,6968,5295,1673,5371,3898,1473,1468,267,107,3529
7/1/2016,VA,Virginia,York,51199,10992,9670,1322,10071,41,10030,921,26,895,10078,8756,1322,5252,4032,1220,606,166,41,4439
6/1/2016,VA,Virginia,Accomack,51001,8465,7263,1202,7223,47,7176,1242,47,1195,7905,6703,1202,5763,4732,1031,1533,378,97,3755
6/1/2016,VA,Virginia,Albemarle,51003,18790,16796,1994,17199,57,17142,1591,60,1531,16850,14856,1994,12616,10846,1770,1465,278,93,10780
6/1/2016,VA,Virginia,Alexandria City,51510,16612,14427,2185,15198,73,15125,1414,92,1322,13333,11150,2183,7816,5758,2058,2010,319,69,5418
6/1/2016,VA,Virginia,Alleghany,51005,4493,3854,639,3586,18,3568,907,16,891,4265,3626,639,3393,2887,506,812,102,55,2424
6/1/2016,VA,Virginia,Amelia,51007,2917,2272,645,2435,12,2423,482,13,469,2689,2044,645,2077,1480,597,471,77,38,1491
6/1/2016,VA,Virginia,Amherst,51009,7482,6296,1186,6188,46,6142,1294,31,1263,6950,5764,1186,5571,4474,1097,1162,230,80,4099
6/1/2016,VA,Virginia,Appomattox,51011,3719,3155,564,3012,17,2995,707,21,686,3514,2950,564,2798,2282,516,672,92,39,1995
6/1/2016,VA,Virginia,Arlington,51013,22740,19882,2858,21114,85,21029,1626,89,1537,17926,15068,2858,10480,7784,2696,2905,319,115,7141
6/1/2016,VA,Virginia,Augusta,51015,17132,14739,2393,14689,47,14642,2443,43,2400,16062,13669,2393,12152,10162,1990,1821,399,151,9781
6/1/2016,VA,Virginia,Bath,51017,1259,1144,115,1107,*,*,152,*,*,1182,1067,115,922,826,96,178,35,23,686
6/1/2016,VA,Virginia,Bedford,51019,18532,15173,3359,15742,74,15668,2790,45,2745,17290,13933,3357,13363,10593,2770,1966,485,153,10759
6/1/2016,VA,Virginia,Bland,51021,1746,1362,384,1363,*,*,383,*,*,1639,1255,384,1229,1022,207,261,48,20,900
6/1/2016,VA,Virginia,Botetourt,51023,8194,6411,1783,7079,41,7038,1115,21,1094,7569,5786,1783,5867,4243,1624,817,192,60,4798
6/1/2016,VA,Virginia,Bristol City,51520,4426,2680,1746,3428,17,3411,998,*,*,4155,2409,1746,3469,1774,1695,1003,151,58,2257
6/1/2016,VA,Virginia,Brunswick,51025,3884,3212,672,3150,28,3122,734,27,707,3645,2973,672,2840,2229,611,1113,109,42,1576
6/1/2016,VA,Virginia,Buchanan,51027,7317,4517,2800,4520,17,4503,2797,*,*,7006,4206,2800,5788,3805,1983,1623,414,118,3633
6/1/2016,VA,Virginia,Buckingham,51029,3371,2784,587,2713,18,2695,658,14,644,3134,2547,587,2369,1985,384,720,144,45,1460
6/1/2016,VA,Virginia,Buena Vista City,51530,1437,1176,261,1155,*,*,282,*,*,1350,1089,261,1049,833,216,319,65,21,644
6/1/2016,VA,Virginia,Campbell,51031,12268,10301,1967,10049,84,9965,2219,64,2155,11511,9544,1967,9226,7421,1805,2087,370,172,6597
6/1/2016,VA,Virginia,Caroline,51033,5461,4536,925,4549,27,4522,912,39,873,4934,4009,925,3348,2501,847,791,236,53,2268
6/1/2016,VA,Virginia,Carroll,51035,7821,6729,1092,6263,21,6242,1558,18,1540,7408,6316,1092,5698,4804,894,1619,276,103,3700
6/1/2016,VA,Virginia,Charles City,51036,1784,1380,404,1510,17,1493,274,11,263,1643,1239,404,1235,888,347,252,80,18,885
6/1/2016,VA,Virginia,Charlotte,51037,3290,2788,502,2669,16,2653,621,16,605,3105,2603,502,2431,1985,446,792,126,52,1461
6/1/2016,VA,Virginia,Charlottesville City,51540,5960,5199,761,4853,25,4828,1107,49,1058,5342,4581,761,4236,3512,724,1214,156,54,2812
6/1/2016,VA,Virginia,Chesapeake City,51550,34779,28301,6478,29657,247,29410,5122,231,4891,31389,24911,6478,19006,12949,6057,4019,846,238,13903
6/1/2016,VA,Virginia,Chesterfield,51041,54366,42183,12183,47026,165,46861,7340,247,7093,48938,36757,12181,36913,25720,11193,5167,981,287,30478
6/1/2016,VA,Virginia,Clarke,51043,3025,2703,322,2775,14,2761,250,*,*,2737,2415,322,1828,1558,270,262,75,33,1458
6/1/2016,VA,Virginia,Colonial Heights City,51570,4102,3528,574,3527,13,3514,575,13,562,3769,3195,574,2364,1831,533,460,100,23,1781
6/1/2016,VA,Virginia,Covington City,51580,1635,1412,223,1268,*,*,367,*,*,1521,1298,223,1197,987,210,362,55,18,762
6/1/2016,VA,Virginia,Craig,51045,1265,1006,259,986,*,*,279,*,*,1166,907,259,910,661,249,204,39,11,656
6/1/2016,VA,Virginia,Culpeper,51047,8617,7551,1066,7423,49,7374,1194,36,1158,7806,6740,1066,5339,4384,955,1109,249,67,3914
6/1/2016,VA,Virginia,Cumberland,51049,2193,1705,488,1804,*,*,389,*,*,2031,1543,488,1572,1125,447,428,84,25,1035
6/1/2016,VA,Virginia,Danville City,51590,11061,8813,2248,8653,82,8571,2408,119,2289,10481,8233,2248,8656,7285,1371,3198,435,157,4866
6/1/2016,VA,Virginia,Dickenson,51051,4666,2980,1686,2871,*,*,1795,14,1781,4446,2760,1686,3616,2100,1516,1088,215,82,2231
6/1/2016,VA,Virginia,Dinwiddie,51053,5581,4446,1135,4464,35,4429,1117,35,1082,5134,3999,1135,3760,2673,1087,892,183,54,2631
6/1/2016,VA,Virginia,Emporia City,51595,1137,859,278,864,13,851,273,14,259,1060,782,278,865,635,230,418,*,*,371
6/1/2016,VA,Virginia,Essex,51057,2752,2286,466,2338,17,2321,414,11,403,2572,2106,466,1901,1555,346,414,89,25,1373
6/1/2016,VA,Virginia,Fairfax,51059,138749,120750,17999,130715,508,130207,8034,415,7619,111917,93947,17970,63396,46698,16698,12845,2609,467,47475
6/1/2016,VA,Virginia,Fairfax City,51600,3628,3120,508,3356,15,3341,272,*,*,3028,2520,508,1805,1336,469,378,*,*,1360
6/1/2016,VA,Virginia,Falls Church City,51610,1778,1544,234,1694,*,*,84,*,*,1383,1149,234,824,610,214,128,*,*,673
6/1/2016,VA,Virginia,Fauquier,51061,11535,10521,1014,10434,51,10383,1101,44,1057,10167,9154,1013,6369,5500,869,916,204,59,5190
6/1/2016,VA,Virginia,Floyd,51063,3852,3115,737,3308,*,*,544,*,*,3586,2849,737,2776,2096,680,542,98,52,2084
6/1/2016,VA,Virginia,Fluvanna,51065,5448,4715,733,4876,22,4854,572,22,550,4979,4246,733,3595,2944,651,478,125,21,2971
6/1/2016,VA,Virginia,Franklin,51067,13918,10300,3618,11504,48,11456,2414,28,2386,13053,9435,3618,10522,7096,3426,1955,474,162,7931
6/1/2016,VA,Virginia,Franklin City,51620,1879,1583,296,1466,18,1448,413,19,394,1759,1463,296,1430,1156,274,540,64,14,812
6/1/2016,VA,Virginia,Frederick,51069,14949,13222,1727,13221,49,13172,1728,47,1681,13607,11880,1727,9228,7754,1474,1419,346,135,7328
6/1/2016,VA,Virginia,Fredericksburg City,51630,3806,3356,450,3113,18,3095,693,26,667,3420,2970,450,2313,1887,426,756,87,41,1429
6/1/2016,VA,Virginia,Galax City,51640,1937,1801,136,1491,*,*,446,11,435,1833,1697,136,1443,1330,113,674,62,30,677
6/1/2016,VA,Virginia,Giles,51071,4476,3411,1065,3520,19,3501,956,16,940,4204,3140,1064,3385,2681,704,787,132,36,2430
6/1/2016,VA,Virginia,Gloucester,51073,7883,6641,1242,6721,34,6687,1162,19,1143,7286,6044,1242,4597,3468,1129,928,177,46,3446
6/1/2016,VA,Virginia,Goochland,51075,5218,4222,996,4734,19,4715,484,19,465,4733,3737,996,3801,2950,851,410,94,30,3267
6/1/2016,VA,Virginia,Grayson,51077,4568,3983,585,3717,*,*,851,*,*,4358,3773,585,3237,2756,481,991,175,85,1986
6/1/2016,VA,Virginia,Greene,51079,3485,3019,466,3040,*,*,445,*,*,3189,2723,466,2283,1854,429,443,84,23,1733
6/1/2016,VA,Virginia,Greensville,51081,2408,1807,601,1912,22,1890,496,18,478,2247,1646,601,1838,1324,514,565,127,27,1119
6/1/2016,VA,Virginia,Halifax,51083,9398,8140,1258,7603,59,7544,1795,67,1728,8875,7617,1258,7096,5976,1120,2133,459,143,4361
6/1/2016,VA,Virginia,Hampton City,51650,23849,18432,5417,19527,203,19324,4322,201,4121,21751,16334,5417,13012,7801,5211,3519,798,183,8512
6/1/2016,VA,Virginia,Hanover,51085,19298,15185,4113,17385,77,17308,1913,52,1861,17536,13423,4113,13733,10168,3565,1371,351,95,11916
6/1/2016,VA,Virginia,Harrisonburg City,51660,5092,4517,575,4277,15,4262,815,23,792,4622,4047,575,3607,3187,420,933,133,39,2502
6/1/2016,VA,Virginia,Henrico,51087,52313,40013,12300,45393,320,45073,6920,292,6628,47316,35016,12300,37245,26286,10959,5959,1354,391,29541
6/1/2016,VA,Virginia,Henry,51089,14884,10784,4100,11757,75,11682,3127,58,3069,14177,10077,4100,11944,8666,3278,3017,700,250,7977
6/1/2016,VA,Virginia,Highland,51091,715,655,60,659,*,*,56,*,*,672,612,60,496,438,58,63,*,*,409
6/1/2016,VA,Virginia,Hopewell City,51670,4397,3555,842,3382,30,3352,1015,38,977,4106,3264,842,2768,1945,823,925,157,41,1645
6/1/2016,VA,Virginia,Isle of Wight,51093,7557,5937,1620,6603,52,6551,954,26,928,7002,5382,1620,4945,3426,1519,896,192,76,3781
6/1/2016,VA,Virginia,James City,51095,18910,16667,2243,17753,61,17692,1157,46,1111,17467,15227,2240,10954,9067,1887,841,193,47,9873
6/1/2016,VA,Virginia,King and Queen,51097,1682,1411,271,1409,*,*,273,*,*,1565,1294,271,1167,926,241,264,74,13,816
6/1/2016,VA,Virginia,King George,51099,3575,3216,359,3055,14,3041,520,22,498,3102,2743,359,1573,1243,330,442,81,15,1035
6/1/2016,VA,Virginia,King William,51101,3108,2674,434,2647,23,2624,461,25,436,2861,2427,434,2267,1877,390,376,101,19,1771
6/1/2016,VA,Virginia,Lancaster,51103,4217,3681,536,3882,16,3866,335,11,324,4026,3490,536,2855,2481,374,473,94,25,2263
6/1/2016,VA,Virginia,Lee,51105,6310,4050,2260,4249,16,4233,2061,12,2049,5993,3735,2258,4851,2719,2132,1926,251,74,2600
6/1/2016,VA,Virginia,Lexington City,51678,1592,1437,155,1459,15,1444,133,*,*,1482,1327,155,1115,986,129,212,*,*,864
6/1/2016,VA,Virginia,Loudoun,51107,32670,27939,4731,30386,115,30271,2284,110,2174,27080,22355,4725,17485,13172,4313,2798,614,136,13937
6/1/2016,VA,Virginia,Louisa,51109,7358,6142,1216,6155,39,6116,1203,34,1169,6765,5549,1216,4957,3832,1125,1054,245,73,3585
6/1/2016,VA,Virginia,Lunenburg,51111,2952,2557,395,2397,16,2381,555,20,535,2723,2328,395,2020,1654,366,687,125,47,1161
6/1/2016,VA,Virginia,Lynchburg City,51680,14534,12352,2182,11572,91,11481,2962,104,2858,13529,11348,2181,10923,8936,1987,3273,427,144,7079
6/1/2016,VA,Virginia,Madison,51113,2839,2457,382,2500,*,*,339,*,*,2631,2249,382,1906,1563,343,380,87,27,1412
6/1/2016,VA,Virginia,Manassas City,51683,4191,3505,686,3643,33,3610,548,40,508,3522,2836,686,2405,1758,647,521,87,37,1760
6/1/2016,VA,Virginia,Manassas Park City,51685,1166,959,207,1000,11,989,166,15,151,975,769,206,681,492,189,175,55,13,438
6/1/2016,VA,Virginia,Martinsville City,51690,3916,3049,867,2930,27,2903,986,39,947,3704,2837,867,3179,2458,721,1279,171,57,1672
6/1/2016,VA,Virginia,Mathews,51115,2772,2385,387,2539,*,*,233,*,*,2626,2239,387,1772,1444,328,250,42,20,1460
6/1/2016,VA,Virginia,Mecklenburg,51117,8909,7456,1453,7335,53,7282,1574,51,1523,8406,6953,1453,6544,5373,1171,1892,377,113,4162
6/1/2016,VA,Virginia,Middlesex,51119,3468,2969,499,3083,22,3061,385,*,*,3258,2759,499,2467,2098,369,435,88,31,1913
6/1/2016,VA,Virginia,Montgomery,51121,13128,10869,2259,10809,44,10765,2319,37,2282,11914,9655,2259,9530,7387,2143,1820,312,113,7285
6/1/2016,VA,Virginia,Nelson,51125,4287,3728,559,3760,16,3744,527,12,515,3945,3386,559,2867,2354,513,572,100,45,2150
6/1/2016,VA,Virginia,New Kent,51127,3988,3342,646,3539,15,3524,449,*,*,3629,2983,646,2500,1980,520,282,73,14,2131
6/1/2016,VA,Virginia,Newport News City,51700,26665,20226,6439,21792,176,21616,4873,251,4622,24392,17955,6437,15684,9467,6217,4532,819,220,10113
6/1/2016,VA,Virginia,Norfolk City,51710,31239,23721,7518,24727,275,24452,6512,345,6167,28098,20580,7518,18520,11263,7257,6818,1284,278,10140
6/1/2016,VA,Virginia,Northampton,51131,3482,2922,560,2954,28,2926,528,24,504,3245,2685,560,2579,2065,514,909,93,35,1542
6/1/2016,VA,Virginia,Northumberland,51133,4525,3956,569,4185,18,4167,340,*,*,4225,3656,569,2757,2398,359,412,95,33,2217
6/1/2016,VA,Virginia,Norton City,51720,1178,861,317,786,*,*,392,*,*,1094,777,317,873,576,297,355,45,19,454
6/1/2016,VA,Virginia,Nottoway,51135,3627,2972,655,2936,32,2904,691,16,675,3363,2708,655,2616,2176,440,938,129,39,1510
6/1/2016,VA,Virginia,Orange,51137,8302,7350,952,7302,42,7260,1000,38,962,7616,6664,952,4878,4173,705,923,215,69,3671
6/1/2016,VA,Virginia,Page,51139,5933,5217,716,4812,19,4793,1121,18,1103,5557,4841,716,4054,3435,619,1126,212,88,2628
6/1/2016,VA,Virginia,Patrick,51141,5063,3824,1239,4157,*,*,906,14,892,4818,3580,1238,3890,2823,1067,991,203,82,2614
6/1/2016,VA,Virginia,Petersburg City,51730,7071,5392,1679,5225,102,5123,1846,80,1766,6464,4785,1679,4605,2970,1635,1972,347,68,2218
6/1/2016,VA,Virginia,Pittsylvania,51143,15610,12213,3397,12695,106,12589,2915,76,2839,14773,11376,3397,12074,9587,2487,3059,573,210,8232
6/1/2016,VA,Virginia,Poquoson City,51735,2453,2170,283,2284,*,*,169,*,*,2257,1974,283,1100,840,260,91,28,12,969
6/1/2016,VA,Virginia,Portsmouth City,51740,17569,13188,4381,13542,179,13363,4027,208,3819,15715,11336,4379,10244,6028,4216,3785,683,150,5626
6/1/2016,VA,Virginia,Powhatan,51145,5499,4432,1067,4879,20,4859,620,15,605,5045,3978,1067,3901,2948,953,386,109,31,3375
6/1/2016,VA,Virginia,Prince Edward,51147,4524,3736,788,3607,25,3582,917,33,884,4201,3413,788,3209,2603,606,1067,167,44,1931
6/1/2016,VA,Virginia,Prince George,51149,5531,4844,687,4671,27,4644,860,21,839,5087,4400,687,2994,2362,632,565,113,22,2294
6/1/2016,VA,Virginia,Prince William,51153,43349,36146,7203,38432,247,38185,4917,287,4630,36939,29739,7200,21068,14335,6733,4878,957,217,15016
6/1/2016,VA,Virginia,Pulaski,51155,8891,7265,1626,6989,31,6958,1902,26,1876,8303,6677,1626,6342,4805,1537,1640,324,116,4262
6/1/2016,VA,Virginia,Radford City,51750,1991,1625,366,1597,*,*,394,*,*,1820,1454,366,1492,1141,351,327,37,23,1105
6/1/2016,VA,Virginia,Rappahannock,51157,1957,1801,156,1803,*,*,154,*,*,1772,1617,155,1179,1050,129,157,39,11,972
6/1/2016,VA,Virginia,Richmond,51159,1906,1552,354,1648,15,1633,258,15,243,1784,1430,354,1301,1053,248,303,87,21,890
6/1/2016,VA,Virginia,Richmond City,51760,32228,22414,9814,25117,281,24836,7111,348,6763,28930,19116,9814,23799,14344,9455,8386,1383,306,13724
6/1/2016,VA,Virginia,Roanoke,51161,22459,18062,4397,19831,92,19739,2628,53,2575,20813,16417,4396,16298,12290,4008,1931,433,152,13782
6/1/2016,VA,Virginia,Roanoke City,51770,19909,14500,5409,14804,137,14667,5105,145,4960,18251,12844,5407,14589,9413,5176,4685,845,211,8848
6/1/2016,VA,Virginia,Rockbridge,51163,5713,4829,884,4809,19,4790,904,*,*,5331,4447,884,3952,3222,730,830,171,60,2891
6/1/2016,VA,Virginia,Rockingham,51165,16378,13968,2410,14298,44,14254,2080,41,2039,15104,12694,2410,11552,9824,1728,1742,509,158,9143
6/1/2016,VA,Virginia,Russell,51167,7662,5176,2486,5138,13,5125,2524,*,*,7332,4846,2486,6218,4146,2072,1671,314,124,4109
6/1/2016,VA,Virginia,Salem City,51775,5874,4814,1060,4918,31,4887,956,21,935,5395,4335,1060,4210,3232,978,833,152,40,3185
6/1/2016,VA,Virginia,Scott,51169,6518,3345,3173,4842,*,*,1676,13,1663,6252,3079,3173,5385,2265,3120,1532,245,124,3484
6/1/2016,VA,Virginia,Shenandoah,51171,10014,8867,1147,8780,22,8758,1234,25,1209,9382,8235,1147,6511,5548,963,1271,238,101,4901
6/1/2016,VA,Virginia,Smyth,51173,8740,6788,1952,6462,20,6442,2278,22,2256,8216,6264,1952,6629,4880,1749,2151,407,146,3925
6/1/2016,VA,Virginia,Southampton,51175,3978,3348,630,3295,28,3267,683,25,658,3720,3090,630,2872,2317,555,738,131,34,1969
6/1/2016,VA,Virginia,Spotsylvania,51177,19041,16762,2279,16433,107,16326,2608,89,2519,16919,14641,2278,10159,8191,1968,1883,483,135,7658
6/1/2016,VA,Virginia,Stafford,51179,15416,14004,1412,13514,79,13435,1902,86,1816,13530,12118,1412,6806,5576,1230,1268,354,77,5107
6/1/2016,VA,Virginia,Staunton City,51790,5869,5035,834,4790,21,4769,1079,26,1053,5503,4669,834,4258,3535,723,1043,152,61,3002
6/1/2016,VA,Virginia,Suffolk City,51800,14830,11857,2973,12023,86,11937,2807,93,2714,13555,10582,2973,9352,6600,2752,2630,437,103,6182
6/1/2016,VA,Virginia,Surry,51181,1503,1157,346,1253,12,1241,250,13,237,1387,1041,346,1013,689,324,204,77,15,717
6/1/2016,VA,Virginia,Sussex,51183,2315,1799,516,1883,29,1854,432,*,*,2153,1637,516,1657,1170,487,494,139,18,1006
6/1/2016,VA,Virginia,Tazewell,51185,11683,8535,3148,8540,32,8508,3143,38,3105,11030,7884,3146,8647,6653,1994,2220,437,179,5811
6/1/2016,VA,Virginia,Unknown,51999,*,*,*,*,*,*,*,*,*,*,*,*,*,*,*,*,*,*,*
6/1/2016,VA,Virginia,Virginia Beach City,51810,65897,55204,10693,57911,332,57579,7986,340,7646,60266,49579,10687,33601,23582,10019,6492,1333,364,25412
6/1/2016,VA,Virginia,Warren,51187,7007,6332,675,5963,23,5940,1044,26,1018,6378,5703,675,4254,3681,573,851,232,75,3096
6/1/2016,VA,Virginia,Washington,51191,14684,10019,4665,11621,51,11570,3063,26,3037,13822,9158,4664,11081,6774,4307,2476,519,176,7910
6/1/2016,VA,Virginia,Waynesboro City,51820,4711,3984,727,3830,18,3812,881,21,860,4408,3681,727,3476,2841,635,858,109,43,2466
6/1/2016,VA,Virginia,Westmoreland,51193,4681,4065,616,4087,23,4064,594,11,583,4281,3665,616,2668,2136,532,731,121,53,1763
6/1/2016,VA,Virginia,Williamsburg City,51830,2491,2125,366,2281,*,*,210,*,*,2268,1903,365,1573,1263,310,212,*,*,1326
6/1/2016,VA,Virginia,Winchester City,51840,4985,4439,546,4222,20,4202,763,19,744,4532,3986,546,3252,2784,468,829,122,49,2252
6/1/2016,VA,Virginia,Wise,51195,10397,6894,3503,6859,17,6842,3538,23,3515,9813,6311,3502,7697,4386,3311,2424,472,159,4642
6/1/2016,VA,Virginia,Wythe,51197,7342,5675,1667,5676,30,5646,1666,20,1646,6948,5281,1667,5349,3881,1468,1464,268,106,3511
6/1/2016,VA,Virginia,York,51199,10983,9667,1316,10069,42,10027,914,27,887,10059,8743,1316,5251,4037,1214,603,166,39,4443
3/1/2016,VA,Virginia,Accomack,51001,8425,7221,1204,7204,49,7155,1221,45,1176,7871,6667,1204,5754,4722,1032,1523,383,99,3749
3/1/2016,VA,Virginia,Albemarle,51003,18623,16612,2011,17055,60,16995,1568,61,1507,16741,14730,2011,12548,10758,1790,1447,288,93,10720
3/1/2016,VA,Virginia,Alexandria City,51510,16410,14214,2196,15023,77,14946,1387,91,1296,13224,11030,2194,7753,5684,2069,1961,336,70,5386
3/1/2016,VA,Virginia,Alleghany,51005,4510,3851,659,3605,18,3587,905,16,889,4279,3620,659,3422,2904,518,811,112,54,2445
3/1/2016,VA,Virginia,Amelia,51007,2916,2275,641,2436,12,2424,480,13,467,2689,2048,641,2082,1489,593,469,77,42,1494
3/1/2016,VA,Virginia,Amherst,51009,7445,6260,1185,6161,48,6113,1284,33,1251,6924,5739,1185,5541,4445,1096,1146,241,85,4069
3/1/2016,VA,Virginia,Appomattox,51011,3706,3140,566,3009,18,2991,697,21,676,3501,2935,566,2795,2277,518,670,96,44,1985
3/1/2016,VA,Virginia,Arlington,51013,22531,19666,2865,20931,86,20845,1600,88,1512,17842,14977,2865,10405,7701,2704,2848,337,119,7101
3/1/2016,VA,Virginia,Augusta,51015,17028,14636,2392,14618,49,14569,2410,44,2366,15968,13576,2392,12082,10093,1989,1785,405,159,9733
3/1/2016,VA,Virginia,Bath,51017,1258,1145,113,1106,*,*,152,*,*,1182,1069,113,923,829,94,179,35,23,686
3/1/2016,VA,Virginia,Bedford,51019,18409,15044,3365,15653,76,15577,2756,46,2710,17191,13828,3363,13293,10515,2778,1960,490,163,10680
3/1/2016,VA,Virginia,Bland,51021,1741,1365,376,1362,*,*,379,*,*,1632,1256,376,1237,1035,202,262,49,21,905
3/1/2016,VA,Virginia,Botetourt,51023,8150,6366,1784,7051,43,7008,1099,21,1078,7525,5741,1784,5842,4218,1624,805,198,63,4776
3/1/2016,VA,Virginia,Bristol City,51520,4416,2676,1740,3430,18,3412,986,*,*,4151,2411,1740,3474,1784,1690,1009,157,63,2245
3/1/2016,VA,Virginia,Brunswick,51025,3868,3183,685,3145,28,3117,723,27,696,3642,2957,685,2842,2220,622,1105,116,42,1579
3/1/2016,VA,Virginia,Buchanan,51027,7327,4508,2819,4548,17,4531,2779,*,*,7002,4183,2819,5801,3809,1992,1600,426,124,3651
3/1/2016,VA,Virginia,Buckingham,51029,3346,2752,594,2696,20,2676,650,13,637,3118,2524,594,2365,1979,386,711,150,45,1459
3/1/2016,VA,Virginia,Buena Vista City,51530,1434,1174,260,1156,*,*,278,*,*,1346,1086,260,1045,831,214,317,65,20,643
3/1/2016,VA,Virginia,Campbell,51031,12230,10258,1972,10037,87,9950,2193,65,2128,11477,9505,1972,9213,7400,1813,2061,385,180,6587
3/1/2016,VA,Virginia,Caroline,51033,5414,4488,926,4512,29,4483,902,39,863,4911,3985,926,3345,2497,848,772,248,52,2273
3/1/2016,VA,Virginia,Carroll,51035,7789,6697,1092,6244,22,6222,1545,19,1526,7387,6295,1092,5696,4802,894,1612,278,105,3701
3/1/2016,VA,Virginia,Charles City,51036,1771,1367,404,1504,17,1487,267,11,256,1632,1228,404,1230,883,347,247,81,20,882
3/1/2016,VA,Virginia,Charlotte,51037,3274,2769,505,2664,16,2648,610,15,595,3091,2586,505,2423,1974,449,774,130,52,1467
3/1/2016,VA,Virginia,Charlottesville City,51540,5915,5157,758,4812,25,4787,1103,50,1053,5305,4548,757,4209,3488,721,1200,152,55,2802
3/1/2016,VA,Virginia,Chesapeake City,51550,34517,28058,6459,29475,260,29215,5042,230,4812,31179,24720,6459,18947,12909,6038,3935,874,244,13894
3/1/2016,VA,Virginia,Chesterfield,51041,53807,41688,12119,46547,174,46373,7260,248,7012,48523,36406,12117,36593,25469,11124,5078,987,297,30231
3/1/2016,VA,Virginia,Clarke,51043,3004,2684,320,2753,16,2737,251,*,*,2731,2411,320,1825,1558,267,261,77,33,1454
3/1/2016,VA,Virginia,Colonial Heights City,51570,4118,3549,569,3553,13,3540,565,12,553,3783,3214,569,2364,1836,528,445,105,23,1791
3/1/2016,VA,Virginia,Covington City,51580,1639,1418,221,1272,*,*,367,*,*,1524,1303,221,1202,994,208,359,51,15,777
3/1/2016,VA,Virginia,Craig,51045,1257,997,260,981,*,*,276,*,*,1161,901,260,907,656,251,202,40,13,652
3/1/2016,VA,Virginia,Culpeper,51047,8564,7487,1077,7379,51,7328,1185,37,1148,7778,6701,1077,5333,4369,964,1094,256,69,3914
3/1/2016,VA,Virginia,Cumberland,51049,2181,1699,482,1801,*,*,380,*,*,2024,1542,482,1570,1130,440,424,87,27,1032
3/1/2016,VA,Virginia,Danville City,51590,11049,8804,2245,8675,84,8591,2374,118,2256,10474,8229,2245,8675,7306,1369,3167,446,163,4899
3/1/2016,VA,Virginia,Dickenson,51051,4670,2989,1681,2881,*,*,1789,12,1777,4449,2768,1681,3623,2116,1507,1087,224,87,2225
3/1/2016,VA,Virginia,Dinwiddie,51053,5554,4421,1133,4451,36,4415,1103,34,1069,5113,3980,1133,3752,2666,1086,884,190,57,2621
3/1/2016,VA,Virginia,Emporia City,51595,1131,854,277,860,15,845,271,14,257,1059,782,277,869,641,228,414,*,*,377
3/1/2016,VA,Virginia,Essex,51057,2729,2262,467,2321,17,2304,408,12,396,2550,2083,467,1895,1546,349,411,96,28,1360
3/1/2016,VA,Virginia,Fairfax,51059,137106,119274,17832,129179,534,128645,7927,414,7513,110984,93183,17801,62929,46403,16526,12638,2711,483,47097
3/1/2016,VA,Virginia,Fairfax City,51600,3595,3092,503,3321,15,3306,274,*,*,3013,2510,503,1788,1323,465,375,57,11,1345
3/1/2016,VA,Virginia,Falls Church City,51610,1760,1528,232,1676,*,*,84,*,*,1385,1153,232,825,613,212,127,*,*,675
3/1/2016,VA,Virginia,Fauquier,51061,11430,10410,1020,10342,51,10291,1088,44,1044,10104,9085,1019,6328,5452,876,898,209,61,5160
3/1/2016,VA,Virginia,Floyd,51063,3810,3073,737,3268,11,3257,542,*,*,3550,2813,737,2755,2075,680,535,98,53,2069
3/1/2016,VA,Virginia,Fluvanna,51065,5406,4674,732,4842,23,4819,564,22,542,4941,4209,732,3566,2915,651,474,128,22,2942
3/1/2016,VA,Virginia,Franklin,51067,13854,10254,3600,11466,50,11416,2388,27,2361,13009,9409,3600,10478,7072,3406,1926,485,164,7903
3/1/2016,VA,Virginia,Franklin City,51620,1877,1570,307,1474,20,1454,403,18,385,1759,1452,307,1442,1157,285,536,65,16,825
3/1/2016,VA,Virginia,Frederick,51069,14870,13139,1731,13183,49,13134,1687,47,1640,13571,11840,1731,9213,7739,1474,1402,357,134,7320
3/1/2016,VA,Virginia,Fredericksburg City,51630,3770,3315,455,3093,18,3075,677,25,652,3401,2946,455,2300,1870,430,740,88,43,1429
3/1/2016,VA,Virginia,Galax City,51640,1947,1808,139,1499,*,*,448,11,437,1842,1703,139,1456,1341,115,672,66,34,684
3/1/2016,VA,Virginia,Giles,51071,4469,3407,1062,3522,21,3501,947,15,932,4208,3147,1061,3400,2705,695,782,139,37,2442
3/1/2016,VA,Virginia,Gloucester,51073,7857,6615,1242,6704,36,6668,1153,20,1133,7259,6017,1242,4592,3466,1126,925,181,52,3434
3/1/2016,VA,Virginia,Goochland,51075,5175,4190,985,4700,19,4681,475,19,456,4688,3703,985,3763,2921,842,410,100,35,3218
3/1/2016,VA,Virginia,Grayson,51077,4544,3959,585,3702,12,3690,842,*,*,4347,3762,585,3237,2756,481,983,185,86,1983
3/1/2016,VA,Virginia,Greene,51079,3446,2984,462,3006,*,*,440,*,*,3156,2694,462,2264,1838,426,435,80,24,1725
3/1/2016,VA,Virginia,Greensville,51081,2406,1810,596,1914,21,1893,492,18,474,2252,1656,596,1851,1341,510,565,135,27,1124
3/1/2016,VA,Virginia,Halifax,51083,9381,8128,1253,7610,66,7544,1771,68,1703,8847,7594,1253,7101,5985,1116,2122,471,144,4364
3/1/2016,VA,Virginia,Hampton City,51650,23701,18309,5392,19445,213,19232,4256,199,4057,21658,16266,5392,12986,7805,5181,3474,816,187,8509
3/1/2016,VA,Virginia,Hanover,51085,19163,15092,4071,17274,81,17193,1889,54,1835,17454,13383,4071,13642,10121,3521,1377,356,101,11808
3/1/2016,VA,Virginia,Harrisonburg City,51660,5069,4481,588,4258,17,4241,811,23,788,4606,4018,588,3616,3184,432,928,140,40,2508
3/1/2016,VA,Virginia,Henrico,51087,52091,39843,12248,45224,333,44891,6867,295,6572,47166,34918,12248,37186,26285,10901,5910,1408,399,29469
3/1/2016,VA,Virginia,Henry,51089,14896,10773,4123,11790,80,11710,3106,60,3046,14192,10069,4123,11998,8709,3289,2994,724,258,8022
3/1/2016,VA,Virginia,Highland,51091,711,649,62,655,*,*,56,*,*,670,608,62,492,432,60,65,*,*,403
3/1/2016,VA,Virginia,Hopewell City,51670,4388,3557,831,3383,31,3352,1005,39,966,4093,3262,831,2769,1957,812,917,162,39,1651
3/1/2016,VA,Virginia,Isle of Wight,51093,7495,5871,1624,6554,53,6501,941,26,915,6948,5324,1624,4924,3399,1525,893,204,79,3748
3/1/2016,VA,Virginia,James City,51095,18791,16538,2253,17655,63,17592,1136,45,1091,17373,15123,2250,10871,8974,1897,825,198,45,9803
3/1/2016,VA,Virginia,King and Queen,51097,1673,1398,275,1406,*,*,267,*,*,1560,1285,275,1164,920,244,261,78,15,810
3/1/2016,VA,Virginia,King George,51099,3539,3178,361,3032,18,3014,507,23,484,3077,2716,361,1572,1238,334,445,89,16,1022
3/1/2016,VA,Virginia,King William,51101,3107,2664,443,2653,24,2629,454,26,428,2862,2419,443,2272,1874,398,371,104,21,1776
3/1/2016,VA,Virginia,Lancaster,51103,4185,3643,542,3858,17,3841,327,11,316,4002,3460,542,2839,2462,377,468,94,26,2251
3/1/2016,VA,Virginia,Lee,51105,6288,4043,2245,4250,16,4234,2038,12,2026,5978,3735,2243,4847,2729,2118,1897,257,80,2613
3/1/2016,VA,Virginia,Lexington City,51678,1584,1427,157,1450,15,1435,134,*,*,1479,1322,157,1116,985,131,216,*,*,860
3/1/2016,VA,Virginia,Loudoun,51107,32349,27595,4754,30091,120,29971,2258,111,2147,26883,22135,4748,17355,13022,4333,2735,623,143,13854
3/1/2016,VA,Virginia,Louisa,51109,7285,6070,1215,6103,39,6064,1182,34,1148,6709,5494,1215,4927,3807,1120,1037,252,72,3566
3/1/2016,VA,Virginia,Lunenburg,51111,2939,2544,395,2390,16,2374,549,20,529,2716,2321,395,2011,1645,366,679,132,45,1155
3/1/2016,VA,Virginia,Lynchburg City,51680,14472,12306,2166,11547,96,11451,2925,105,2820,13480,11315,2165,10919,8949,1970,3226,449,152,7092
3/1/2016,VA,Virginia,Madison,51113,2823,2444,379,2487,*,*,336,*,*,2624,2245,379,1907,1564,343,379,86,28,1414
3/1/2016,VA,Virginia,Manassas City,51683,4144,3458,686,3601,35,3566,543,41,502,3494,2808,686,2395,1748,647,512,95,36,1752
3/1/2016,VA,Virginia,Manassas Park City,51685,1148,941,207,986,11,975,162,15,147,959,753,206,670,480,190,167,57,14,432
3/1/2016,VA,Virginia,Martinsville City,51690,3922,3058,864,2945,28,2917,977,41,936,3717,2853,864,3211,2492,719,1273,178,57,1703
3/1/2016,VA,Virginia,Mathews,51115,2764,2378,386,2533,*,*,231,*,*,2623,2237,386,1768,1443,325,253,43,20,1452
3/1/2016,VA,Virginia,Mecklenburg,51117,8885,7421,1464,7327,55,7272,1558,49,1509,8389,6925,1464,6543,5366,1177,1877,383,117,4166
3/1/2016,VA,Virginia,Middlesex,51119,3455,2961,494,3074,22,3052,381,*,*,3246,2752,494,2454,2092,362,429,93,32,1900
3/1/2016,VA,Virginia,Montgomery,51121,13021,10761,2260,10716,47,10669,2305,36,2269,11833,9573,2260,9486,7344,2142,1800,313,116,7257
3/1/2016,VA,Virginia,Nelson,51125,4263,3700,563,3742,18,3724,521,13,508,3934,3371,563,2861,2345,516,567,103,44,2147
3/1/2016,VA,Virginia,New Kent,51127,3933,3281,652,3491,15,3476,442,*,*,3596,2944,652,2464,1941,523,275,76,15,2098
3/1/2016,VA,Virginia,Newport News City,51700,26551,20104,6447,21765,180,21585,4786,250,4536,24354,17908,6446,15658,9436,6222,4448,856,227,10127
3/1/2016,VA,Virginia,Norfolk City,51710,31025,23562,7463,24619,286,24333,6406,345,6061,27966,20503,7463,18465,11265,7200,6683,1326,290,10166
3/1/2016,VA,Virginia,Northampton,51131,3462,2909,553,2936,29,2907,526,25,501,3225,2672,553,2566,2057,509,898,98,36,1534
3/1/2016,VA,Virginia,Northumberland,51133,4510,3941,569,4180,18,4162,330,*,*,4212,3643,569,2735,2374,361,405,93,31,2206
3/1/2016,VA,Virginia,Norton City,51720,1175,858,317,788,*,*,387,*,*,1094,777,317,876,578,298,357,47,20,452
3/1/2016,VA,Virginia,Nottoway,51135,3613,2960,653,2938,32,2906,675,13,662,3354,2701,653,2614,2179,435,931,128,44,1511
3/1/2016,VA,Virginia,Orange,51137,8287,7340,947,7303,48,7255,984,35,949,7616,6669,947,4875,4172,703,911,224,73,3667
3/1/2016,VA,Virginia,Page,51139,5930,5220,710,4812,20,4792,1118,18,1100,5555,4845,710,4059,3446,613,1128,220,86,2625
3/1/2016,VA,Virginia,Patrick,51141,5049,3821,1228,4152,11,4141,897,14,883,4805,3578,1227,3889,2837,1052,975,208,83,2623
3/1/2016,VA,Virginia,Petersburg City,51730,7051,5380,1671,5224,108,5116,1827,79,1748,6452,4781,1671,4609,2984,1625,1934,357,77,2241
3/1/2016,VA,Virginia,Pittsylvania,51143,15530,12139,3391,12652,113,12539,2878,78,2800,14704,11313,3391,12041,9545,2496,3011,581,227,8222
3/1/2016,VA,Virginia,Poquoson City,51735,2436,2153,283,2270,*,*,166,*,*,2245,1962,283,1101,842,259,91,30,12,968
3/1/2016,VA,Virginia,Portsmouth City,51740,17496,13133,4363,13519,191,13328,3977,206,3771,15690,11329,4361,10247,6050,4197,3746,699,158,5644
3/1/2016,VA,Virginia,Powhatan,51145,5467,4400,1067,4851,20,4831,616,15,601,5024,3957,1067,3876,2926,950,377,109,35,3355
3/1/2016,VA,Virginia,Prince Edward,51147,4506,3714,792,3596,27,3569,910,32,878,4192,3400,792,3211,2601,610,1055,177,46,1933
3/1/2016,VA,Virginia,Prince George,51149,5483,4780,703,4639,28,4611,844,20,824,5056,4353,703,2983,2337,646,548,115,24,2296
3/1/2016,VA,Virginia,Prince William,51153,42804,35655,7149,37987,259,37728,4817,280,4537,36579,29433,7146,20892,14215,6677,4743,999,217,14933
3/1/2016,VA,Virginia,Pulaski,51155,8859,7223,1636,6976,33,6943,1883,27,1856,8286,6650,1636,6345,4799,1546,1623,328,125,4269
3/1/2016,VA,Virginia,Radford City,51750,1978,1608,370,1589,*,*,389,*,*,1814,1444,370,1488,1136,352,329,38,25,1096
3/1/2016,VA,Virginia,Rappahannock,51157,1946,1791,155,1794,*,*,152,*,*,1758,1604,154,1172,1044,128,151,41,11,969
3/1/2016,VA,Virginia,Richmond,51159,1890,1538,352,1635,15,1620,255,13,242,1778,1426,352,1287,1043,244,294,93,19,881
3/1/2016,VA,Virginia,Richmond City,51760,32020,22236,9784,24992,295,24697,7028,348,6680,28780,18996,9784,23749,14326,9423,8250,1425,323,13751
3/1/2016,VA,Virginia,Roanoke,51161,22331,17930,4401,19746,94,19652,2585,51,2534,20694,16294,4400,16181,12171,4010,1885,444,156,13696
3/1/2016,VA,Virginia,Roanoke City,51770,19857,14440,5417,14805,139,14666,5052,146,4906,18203,12788,5415,14591,9407,5184,4617,874,220,8880
3/1/2016,VA,Virginia,Rockbridge,51163,5702,4826,876,4804,21,4783,898,*,*,5316,4440,876,3946,3222,724,824,174,60,2888
3/1/2016,VA,Virginia,Rockingham,51165,16290,13870,2420,14243,46,14197,2047,43,2004,15045,12625,2420,11491,9759,1732,1705,524,160,9102
3/1/2016,VA,Virginia,Russell,51167,7647,5159,2488,5155,14,5141,2492,*,*,7317,4829,2488,6212,4144,2068,1669,315,130,4098
3/1/2016,VA,Virginia,Salem City,51775,5862,4793,1069,4919,31,4888,943,21,922,5380,4311,1069,4200,3216,984,823,160,43,3174
3/1/2016,VA,Virginia,Scott,51169,6521,3341,3180,4857,11,4846,1664,14,1650,6247,3067,3180,5393,2270,3123,1528,253,119,3493
3/1/2016,VA,Virginia,Shenandoah,51171,9988,8840,1148,8769,24,8745,1219,25,1194,9362,8214,1148,6501,5539,962,1256,242,104,4899
3/1/2016,VA,Virginia,Smyth,51173,8734,6774,1960,6475,21,6454,2259,24,2235,8231,6271,1960,6647,4886,1761,2122,428,151,3946
3/1/2016,VA,Virginia,Southampton,51175,3967,3337,630,3285,28,3257,682,26,656,3707,3077,630,2871,2315,556,731,138,34,1968
3/1/2016,VA,Virginia,Spotsylvania,51177,18860,16566,2294,16292,114,16178,2568,91,2477,16797,14504,2293,10111,8129,1982,1844,488,134,7645
3/1/2016,VA,Virginia,Stafford,51179,15251,13824,1427,13374,85,13289,1877,88,1789,13398,11971,1427,6781,5540,1241,1224,374,75,5108
3/1/2016,VA,Virginia,Staunton City,51790,5869,5031,838,4791,24,4767,1078,27,1051,5498,4660,838,4267,3542,725,1038,162,60,3007
3/1/2016,VA,Virginia,Suffolk City,51800,14750,11767,2983,11975,90,11885,2775,94,2681,13497,10514,2983,9328,6570,2758,2596,442,111,6179
3/1/2016,VA,Virginia,Surry,51181,1485,1139,346,1244,12,1232,241,12,229,1371,1025,346,999,675,324,200,77,15,707
3/1/2016,VA,Virginia,Sussex,51183,2320,1810,510,1892,32,1860,428,*,*,2155,1645,510,1653,1172,481,488,142,19,1004
3/1/2016,VA,Virginia,Tazewell,51185,11644,8505,3139,8539,36,8503,3105,38,3067,10995,7858,3137,8650,6666,1984,2202,443,185,5820
3/1/2016,VA,Virginia,Unknown,51999,*,*,*,*,*,*,*,*,*,*,*,*,*,*,*,*,*,*,*
3/1/2016,VA,Virginia,Virginia Beach City,51810,65461,54822,10639,57575,355,57220,7886,333,7553,59958,49325,10633,33478,23526,9952,6387,1348,377,25366
3/1/2016,VA,Virginia,Warren,51187,6955,6281,674,5926,24,5902,1029,24,1005,6336,5662,674,4239,3666,573,841,234,74,3090
3/1/2016,VA,Virginia,Washington,51191,14643,9977,4666,11599,53,11546,3044,27,3017,13791,9126,4665,11069,6763,4306,2455,521,181,7912
3/1/2016,VA,Virginia,Waynesboro City,51820,4701,3966,735,3828,19,3809,873,25,848,4405,3670,735,3492,2849,643,851,113,46,2482
3/1/2016,VA,Virginia,Westmoreland,51193,4663,4056,607,4078,27,4051,585,11,574,4273,3666,607,2667,2144,523,725,126,51,1765
3/1/2016,VA,Virginia,Williamsburg City,51830,2487,2108,379,2279,*,*,208,*,*,2263,1885,378,1566,1243,323,215,*,*,1314
3/1/2016,VA,Virginia,Winchester City,51840,4962,4417,545,4220,21,4199,742,18,724,4518,3973,545,3239,2773,466,807,126,50,2256
3/1/2016,VA,Virginia,Wise,51195,10391,6895,3496,6881,17,6864,3510,23,3487,9796,6301,3495,7704,4402,3302,2399,498,161,4646
3/1/2016,VA,Virginia,Wythe,51197,7328,5663,1665,5674,31,5643,1654,22,1632,6936,5271,1665,5352,3883,1469,1465,277,107,3503
3/1/2016,VA,Virginia,York,51199,10922,9599,1323,10024,45,9979,898,28,870,10018,8695,1323,5233,4014,1219,600,168,40,4425
5/1/2016,VA,Virginia,Accomack,51001,8443,7238,1205,7211,47,7164,1232,46,1186,7883,6678,1205,5756,4723,1033,1530,381,96,3749
5/1/2016,VA,Virginia,Albemarle,51003,18755,16761,1994,17171,60,17111,1584,60,1524,16822,14828,1994,12589,10817,1772,1465,280,93,10751
5/1/2016,VA,Virginia,Alexandria City,51510,16542,14368,2174,15142,73,15069,1400,91,1309,13289,11117,2172,7772,5724,2048,1990,318,69,5395
5/1/2016,VA,Virginia,Alleghany,51005,4493,3857,636,3587,18,3569,906,17,889,4263,3627,636,3387,2885,502,812,104,55,2416
5/1/2016,VA,Virginia,Amelia,51007,2916,2275,641,2434,12,2422,482,14,468,2690,2049,641,2079,1486,593,471,76,38,1494
5/1/2016,VA,Virginia,Amherst,51009,7491,6307,1184,6197,48,6149,1294,34,1260,6961,5777,1184,5578,4483,1095,1157,230,81,4110
5/1/2016,VA,Virginia,Appomattox,51011,3722,3160,562,3018,17,3001,704,21,683,3516,2954,562,2803,2289,514,676,93,39,1995
5/1/2016,VA,Virginia,Arlington,51013,22656,19798,2858,21043,85,20958,1613,89,1524,17891,15033,2858,10447,7751,2696,2883,317,113,7134
5/1/2016,VA,Virginia,Augusta,51015,17071,14687,2384,14640,47,14593,2431,43,2388,16014,13630,2384,12097,10115,1982,1808,395,152,9742
5/1/2016,VA,Virginia,Bath,51017,1255,1138,117,1105,*,*,150,*,*,1177,1060,117,921,823,98,179,35,23,684
5/1/2016,VA,Virginia,Bedford,51019,18482,15136,3346,15706,75,15631,2776,45,2731,17259,13915,3344,13328,10569,2759,1967,484,154,10723
5/1/2016,VA,Virginia,Bland,51021,1748,1365,383,1366,*,*,382,*,*,1637,1254,383,1232,1026,206,263,48,19,902
5/1/2016,VA,Virginia,Botetourt,51023,8183,6401,1782,7075,42,7033,1108,21,1087,7569,5787,1782,5870,4249,1621,821,196,60,4793
5/1/2016,VA,Virginia,Bristol City,51520,4420,2686,1734,3427,17,3410,993,*,*,4146,2412,1734,3459,1774,1685,1005,149,59,2246
5/1/2016,VA,Virginia,Brunswick,51025,3883,3208,675,3152,28,3124,731,27,704,3646,2971,675,2847,2231,616,1114,110,42,1581
5/1/2016,VA,Virginia,Buchanan,51027,7313,4510,2803,4525,17,4508,2788,11,2777,7007,4204,2803,5788,3802,1986,1622,413,118,3635
5/1/2016,VA,Virginia,Buckingham,51029,3360,2771,589,2706,18,2688,654,12,642,3123,2534,589,2363,1979,384,715,145,45,1458
5/1/2016,VA,Virginia,Buena Vista City,51530,1440,1177,263,1159,*,*,281,*,*,1353,1090,263,1048,831,217,318,63,21,646
5/1/2016,VA,Virginia,Campbell,51031,12238,10275,1963,10034,84,9950,2204,65,2139,11483,9520,1963,9201,7399,1802,2069,372,168,6592
5/1/2016,VA,Virginia,Caroline,51033,5441,4515,926,4533,28,4505,908,39,869,4927,4001,926,3351,2502,849,786,238,52,2275
5/1/2016,VA,Virginia,Carroll,51035,7808,6715,1093,6258,22,6236,1550,18,1532,7401,6308,1093,5693,4798,895,1613,275,105,3700
5/1/2016,VA,Virginia,Charles City,51036,1781,1376,405,1510,17,1493,271,*,*,1639,1234,405,1231,883,348,250,78,19,884
5/1/2016,VA,Virginia,Charlotte,51037,3283,2780,503,2667,16,2651,616,15,601,3096,2593,503,2423,1976,447,783,128,54,1458
5/1/2016,VA,Virginia,Charlottesville City,51540,5944,5179,765,4837,25,4812,1107,50,1057,5318,4554,764,4214,3486,728,1215,155,51,2793
5/1/2016,VA,Virginia,Chesapeake City,51550,34664,28186,6478,29579,252,29327,5085,229,4856,31287,24809,6478,18975,12917,6058,4003,847,235,13890
5/1/2016,VA,Virginia,Chesterfield,51041,54156,41988,12168,46839,170,46669,7317,251,7066,48799,36633,12166,36792,25620,11172,5149,972,283,30388
5/1/2016,VA,Virginia,Clarke,51043,3023,2699,324,2774,15,2759,249,*,*,2742,2418,324,1835,1564,271,260,76,34,1465
5/1/2016,VA,Virginia,Colonial Heights City,51570,4100,3526,574,3531,13,3518,569,13,556,3766,3192,574,2361,1828,533,457,98,23,1783
5/1/2016,VA,Virginia,Covington City,51580,1642,1423,219,1273,*,*,369,*,*,1525,1306,219,1198,992,206,361,55,17,765
5/1/2016,VA,Virginia,Craig,51045,1262,1004,258,983,*,*,279,*,*,1163,905,258,909,660,249,204,38,11,656
5/1/2016,VA,Virginia,Culpeper,51047,8602,7534,1068,7410,50,7360,1192,37,1155,7796,6728,1068,5328,4371,957,1101,248,66,3913
5/1/2016,VA,Virginia,Cumberland,51049,2184,1701,483,1800,*,*,384,*,*,2026,1543,483,1567,1125,442,426,85,24,1032
5/1/2016,VA,Virginia,Danville City,51590,11058,8812,2246,8661,83,8578,2397,118,2279,10481,8235,2246,8664,7298,1366,3193,434,155,4882
5/1/2016,VA,Virginia,Dickenson,51051,4663,2972,1691,2871,*,*,1792,14,1778,4447,2756,1691,3619,2101,1518,1089,216,78,2236
5/1/2016,VA,Virginia,Dinwiddie,51053,5565,4434,1131,4456,35,4421,1109,34,1075,5125,3994,1131,3747,2663,1084,885,183,54,2625
5/1/2016,VA,Virginia,Emporia City,51595,1140,860,280,868,15,853,272,14,258,1066,786,280,867,635,232,415,*,*,375
5/1/2016,VA,Virginia,Essex,51057,2746,2279,467,2332,17,2315,414,12,402,2563,2096,467,1897,1551,346,412,92,25,1368
5/1/2016,VA,Virginia,Fairfax,51059,138225,120284,17941,130232,515,129717,7993,418,7575,111570,93660,17910,63178,46537,16641,12784,2621,461,47312
5/1/2016,VA,Virginia,Fairfax City,51600,3618,3116,502,3346,15,3331,272,*,*,3025,2523,502,1794,1331,463,376,*,*,1352
5/1/2016,VA,Virginia,Falls Church City,51610,1776,1541,235,1693,*,*,83,*,*,1383,1148,235,827,612,215,127,*,*,677
5/1/2016,VA,Virginia,Fauquier,51061,11498,10483,1015,10405,51,10354,1093,44,1049,10140,9126,1014,6351,5481,870,913,205,58,5175
5/1/2016,VA,Virginia,Floyd,51063,3843,3107,736,3300,11,3289,543,*,*,3577,2841,736,2775,2096,679,545,99,52,2079
5/1/2016,VA,Virginia,Fluvanna,51065,5443,4710,733,4871,22,4849,572,23,549,4969,4236,733,3590,2939,651,483,124,21,2962
5/1/2016,VA,Virginia,Franklin,51067,13903,10299,3604,11500,48,11452,2403,28,2375,13037,9433,3604,10518,7106,3412,1959,476,161,7922
5/1/2016,VA,Virginia,Franklin City,51620,1879,1577,302,1470,18,1452,409,18,391,1761,1459,302,1431,1151,280,536,63,15,817
5/1/2016,VA,Virginia,Frederick,51069,14913,13181,1732,13200,49,13151,1713,47,1666,13582,11850,1732,9206,7728,1478,1412,348,134,7312
5/1/2016,VA,Virginia,Fredericksburg City,51630,3789,3343,446,3105,18,3087,684,26,658,3413,2967,446,2303,1882,421,749,86,40,1428
5/1/2016,VA,Virginia,Galax City,51640,1940,1803,137,1496,*,*,444,11,433,1834,1697,137,1450,1337,113,670,64,31,685
5/1/2016,VA,Virginia,Giles,51071,4475,3397,1078,3526,20,3506,949,15,934,4207,3130,1077,3395,2685,710,788,132,36,2439
5/1/2016,VA,Virginia,Gloucester,51073,7880,6634,1246,6720,35,6685,1160,19,1141,7274,6028,1246,4599,3467,1132,931,177,46,3445
5/1/2016,VA,Virginia,Goochland,51075,5206,4216,990,4726,19,4707,480,19,461,4723,3733,990,3790,2944,846,405,95,30,3260
5/1/2016,VA,Virginia,Grayson,51077,4558,3975,583,3711,11,3700,847,*,*,4354,3771,583,3236,2757,479,988,175,84,1989
5/1/2016,VA,Virginia,Greene,51079,3471,3009,462,3027,*,*,444,*,*,3175,2713,462,2278,1853,425,442,83,23,1730
5/1/2016,VA,Virginia,Greensville,51081,2403,1801,602,1909,21,1888,494,18,476,2246,1644,602,1839,1324,515,566,130,27,1116
5/1/2016,VA,Virginia,Halifax,51083,9397,8138,1259,7611,61,7550,1786,67,1719,8868,7609,1259,7098,5977,1121,2123,461,141,4373
5/1/2016,VA,Virginia,Hampton City,51650,23798,18394,5404,19498,205,19293,4300,199,4101,21724,16320,5404,12998,7801,5197,3508,801,184,8505
5/1/2016,VA,Virginia,Hanover,51085,19252,15169,4083,17348,79,17269,1904,53,1851,17510,13427,4083,13702,10164,3538,1375,349,93,11885
5/1/2016,VA,Virginia,Harrisonburg City,51660,5087,4510,577,4274,15,4259,813,23,790,4620,4043,577,3615,3195,420,933,136,39,2507
5/1/2016,VA,Virginia,Henrico,51087,52230,39964,12266,45334,324,45010,6896,291,6605,47256,34990,12266,37187,26265,10922,5934,1370,387,29496
5/1/2016,VA,Virginia,Henry,51089,14894,10783,4111,11773,77,11696,3121,58,3063,14195,10084,4111,11969,8690,3279,3010,706,251,8002
5/1/2016,VA,Virginia,Highland,51091,715,655,60,659,*,*,56,*,*,672,612,60,496,438,58,63,*,*,409
5/1/2016,VA,Virginia,Hopewell City,51670,4391,3557,834,3383,30,3353,1008,38,970,4100,3266,834,2757,1942,815,921,156,38,1642
5/1/2016,VA,Virginia,Isle of Wight,51093,7538,5919,1619,6590,52,6538,948,26,922,6988,5369,1619,4936,3417,1519,895,193,76,3772
5/1/2016,VA,Virginia,James City,51095,18877,16635,2242,17727,61,17666,1150,45,1105,17438,15199,2239,10946,9062,1884,836,192,46,9872
5/1/2016,VA,Virginia,King and Queen,51097,1678,1409,269,1407,*,*,271,*,*,1564,1295,269,1169,931,238,263,75,13,818
5/1/2016,VA,Virginia,King George,51099,3563,3203,360,3044,15,3029,519,24,495,3089,2729,360,1568,1236,332,442,81,14,1031
5/1/2016,VA,Virginia,King William,51101,3108,2672,436,2652,23,2629,456,25,431,2865,2429,436,2268,1876,392,371,101,18,1778
5/1/2016,VA,Virginia,Lancaster,51103,4201,3666,535,3867,16,3851,334,11,323,4016,3481,535,2849,2475,374,471,91,26,2261
5/1/2016,VA,Virginia,Lee,51105,6310,4056,2254,4264,16,4248,2046,13,2033,5992,3740,2252,4853,2727,2126,1921,249,74,2609
5/1/2016,VA,Virginia,Lexington City,51678,1590,1437,153,1456,15,1441,134,*,*,1481,1328,153,1113,986,127,213,*,*,860
5/1/2016,VA,Virginia,Loudoun,51107,32585,27840,4745,30314,116,30198,2271,109,2162,27049,22310,4739,17440,13116,4324,2774,617,136,13913
5/1/2016,VA,Virginia,Louisa,51109,7332,6113,1219,6138,39,6099,1194,34,1160,6747,5528,1219,4960,3833,1127,1056,246,72,3586
5/1/2016,VA,Virginia,Lunenburg,51111,2953,2561,392,2400,16,2384,553,20,533,2722,2330,392,2019,1657,362,684,128,47,1160
5/1/2016,VA,Virginia,Lynchburg City,51680,14504,12318,2186,11554,92,11462,2950,105,2845,13501,11316,2185,10909,8920,1989,3252,426,146,7085
5/1/2016,VA,Virginia,Madison,51113,2834,2454,380,2495,*,*,339,*,*,2635,2255,380,1911,1568,343,386,86,27,1412
5/1/2016,VA,Virginia,Manassas City,51683,4180,3493,687,3631,34,3597,549,41,508,3514,2827,687,2405,1757,648,518,89,37,1761
5/1/2016,VA,Virginia,Manassas Park City,51685,1162,953,209,997,11,986,165,15,150,973,765,208,681,490,191,171,55,14,441
5/1/2016,VA,Virginia,Martinsville City,51690,3927,3063,864,2945,27,2918,982,40,942,3719,2855,864,3194,2476,718,1282,171,58,1683
5/1/2016,VA,Virginia,Mathews,51115,2771,2386,385,2538,*,*,233,*,*,2625,2240,385,1771,1446,325,253,42,20,1456
5/1/2016,VA,Virginia,Mecklenburg,51117,8897,7442,1455,7331,54,7277,1566,50,1516,8403,6948,1455,6538,5368,1170,1884,378,114,4162
5/1/2016,VA,Virginia,Middlesex,51119,3461,2965,496,3077,22,3055,384,*,*,3255,2759,496,2465,2098,367,434,89,31,1911
5/1/2016,VA,Virginia,Montgomery,51121,13082,10828,2254,10772,45,10727,2310,37,2273,11868,9614,2254,9495,7358,2137,1804,315,114,7262
5/1/2016,VA,Virginia,Nelson,51125,4271,3716,555,3748,16,3732,523,12,511,3930,3375,555,2842,2333,509,561,100,44,2137
5/1/2016,VA,Virginia,New Kent,51127,3966,3316,650,3523,15,3508,443,*,*,3615,2965,650,2492,1970,522,278,72,14,2128
5/1/2016,VA,Virginia,Newport News City,51700,26630,20179,6451,21796,178,21618,4834,252,4582,24387,17937,6450,15681,9454,6227,4509,823,222,10127
5/1/2016,VA,Virginia,Norfolk City,51710,31147,23663,7484,24672,278,24394,6475,345,6130,28036,20552,7484,18463,11242,7221,6775,1285,273,10130
5/1/2016,VA,Virginia,Northampton,51131,3478,2919,559,2949,28,2921,529,25,504,3238,2679,559,2575,2062,513,902,95,34,1544
5/1/2016,VA,Virginia,Northumberland,51133,4513,3945,568,4175,18,4157,338,*,*,4214,3646,568,2743,2384,359,406,93,32,2212
5/1/2016,VA,Virginia,Norton City,51720,1175,859,316,787,*,*,388,*,*,1091,775,316,872,575,297,355,45,19,453
5/1/2016,VA,Virginia,Nottoway,51135,3630,2983,647,2942,32,2910,688,14,674,3368,2721,647,2616,2184,432,939,128,39,1510
5/1/2016,VA,Virginia,Orange,51137,8302,7350,952,7307,45,7262,995,37,958,7620,6668,952,4883,4176,707,918,217,71,3677
5/1/2016,VA,Virginia,Page,51139,5937,5226,711,4817,19,4798,1120,18,1102,5559,4848,711,4059,3445,614,1129,212,85,2633
5/1/2016,VA,Virginia,Patrick,51141,5057,3826,1231,4156,11,4145,901,14,887,4813,3583,1230,3885,2828,1057,988,203,81,2613
5/1/2016,VA,Virginia,Petersburg City,51730,7054,5389,1665,5219,105,5114,1835,78,1757,6452,4787,1665,4599,2979,1620,1960,345,71,2223
5/1/2016,VA,Virginia,Pittsylvania,51143,15590,12187,3403,12683,111,12572,2907,76,2831,14761,11358,3403,12068,9572,2496,3043,572,213,8240
5/1/2016,VA,Virginia,Poquoson City,51735,2440,2160,280,2275,*,*,165,*,*,2247,1967,280,1100,843,257,91,28,12,969
5/1/2016,VA,Virginia,Portsmouth City,51740,17534,13171,4363,13523,182,13341,4011,208,3803,15692,11331,4361,10224,6026,4198,3763,678,153,5630
5/1/2016,VA,Virginia,Powhatan,51145,5490,4422,1068,4871,20,4851,619,15,604,5044,3976,1068,3892,2938,954,385,108,33,3366
5/1/2016,VA,Virginia,Prince Edward,51147,4524,3733,791,3607,27,3580,917,33,884,4203,3412,791,3214,2605,609,1070,167,45,1932
5/1/2016,VA,Virginia,Prince George,51149,5511,4822,689,4656,27,4629,855,21,834,5082,4393,689,2993,2360,633,558,111,22,2302
5/1/2016,VA,Virginia,Prince William,51153,43153,35986,7167,38273,252,38021,4880,285,4595,36799,29635,7164,20972,14276,6696,4829,964,212,14967
5/1/2016,VA,Virginia,Pulaski,51155,8877,7253,1624,6980,32,6948,1897,27,1870,8300,6676,1624,6336,4801,1535,1631,325,115,4265
5/1/2016,VA,Virginia,Radford City,51750,1982,1614,368,1591,*,*,391,*,*,1815,1447,368,1482,1130,352,325,37,23,1097
5/1/2016,VA,Virginia,Rappahannock,51157,1956,1802,154,1802,*,*,154,*,*,1769,1616,153,1172,1045,127,155,39,11,967
5/1/2016,VA,Virginia,Richmond,51159,1898,1545,353,1642,15,1627,256,14,242,1783,1430,353,1298,1053,245,300,89,21,888
5/1/2016,VA,Virginia,Richmond City,51760,32151,22399,9752,25073,287,24786,7078,350,6728,28865,19113,9752,23746,14355,9391,8330,1379,301,13736
5/1/2016,VA,Virginia,Roanoke,51161,22424,18023,4401,19811,92,19719,2613,51,2562,20777,16377,4400,16247,12234,4013,1916,434,151,13746
5/1/2016,VA,Virginia,Roanoke City,51770,19876,14470,5406,14784,136,14648,5092,147,4945,18224,12820,5404,14575,9402,5173,4664,851,214,8846
5/1/2016,VA,Virginia,Rockbridge,51163,5713,4831,882,4811,19,4792,902,*,*,5330,4448,882,3947,3219,728,831,169,59,2888
5/1/2016,VA,Virginia,Rockingham,51165,16354,13945,2409,14291,45,14246,2063,40,2023,15069,12660,2409,11527,9801,1726,1736,504,158,9129
5/1/2016,VA,Virginia,Russell,51167,7642,5163,2479,5134,14,5120,2508,*,*,7310,4831,2479,6205,4141,2064,1667,316,123,4099
5/1/2016,VA,Virginia,Salem City,51775,5875,4808,1067,4923,31,4892,952,21,931,5398,4331,1067,4210,3225,985,832,155,39,3184
5/1/2016,VA,Virginia,Scott,51169,6522,3347,3175,4849,*,*,1673,13,1660,6258,3083,3175,5382,2262,3120,1531,242,122,3487
5/1/2016,VA,Virginia,Shenandoah,51171,9997,8851,1146,8775,23,8752,1222,25,1197,9368,8222,1146,6510,5548,962,1260,240,98,4912
5/1/2016,VA,Virginia,Smyth,51173,8741,6785,1956,6466,20,6446,2275,24,2251,8216,6260,1956,6625,4872,1753,2143,407,145,3930
5/1/2016,VA,Virginia,Southampton,51175,3972,3344,628,3289,27,3262,683,25,658,3712,3084,628,2863,2310,553,731,133,34,1965
5/1/2016,VA,Virginia,Spotsylvania,51177,18980,16689,2291,16383,110,16273,2597,89,2508,16877,14587,2290,10145,8165,1980,1873,479,133,7660
5/1/2016,VA,Virginia,Stafford,51179,15347,13933,1414,13456,81,13375,1891,87,1804,13478,12064,1414,6781,5551,1230,1242,358,76,5105
5/1/2016,VA,Virginia,Staunton City,51790,5867,5022,845,4789,22,4767,1078,26,1052,5496,4651,845,4253,3519,734,1038,154,60,3001
5/1/2016,VA,Virginia,Suffolk City,51800,14814,11835,2979,12018,87,11931,2796,93,2703,13556,10577,2979,9349,6595,2754,2617,435,105,6192
5/1/2016,VA,Virginia,Surry,51181,1496,1148,348,1249,12,1237,247,13,234,1381,1033,348,1007,681,326,202,76,15,714
5/1/2016,VA,Virginia,Sussex,51183,2316,1802,514,1885,30,1855,431,*,*,2155,1641,514,1653,1170,483,490,135,18,1010
5/1/2016,VA,Virginia,Tazewell,51185,11663,8525,3138,8538,35,8503,3125,38,3087,11015,7879,3136,8629,6641,1988,2211,435,178,5805
5/1/2016,VA,Virginia,Unknown,51999,*,*,*,*,*,*,*,*,*,*,*,*,*,*,*,*,*,*,*
5/1/2016,VA,Virginia,Virginia Beach City,51810,65743,55068,10675,57804,337,57467,7939,341,7598,60169,49500,10669,33548,23551,9997,6461,1330,360,25397
5/1/2016,VA,Virginia,Warren,51187,6981,6310,671,5945,24,5921,1036,25,1011,6360,5689,671,4245,3674,571,842,234,73,3096
5/1/2016,VA,Virginia,Washington,51191,14682,10019,4663,11626,52,11574,3056,26,3030,13827,9165,4662,11076,6770,4306,2471,515,173,7917
5/1/2016,VA,Virginia,Waynesboro City,51820,4704,3983,721,3824,18,3806,880,23,857,4404,3683,721,3474,2845,629,859,109,43,2463
5/1/2016,VA,Virginia,Westmoreland,51193,4672,4059,613,4079,23,4056,593,11,582,4275,3662,613,2657,2128,529,727,119,51,1760
5/1/2016,VA,Virginia,Williamsburg City,51830,2487,2116,371,2279,*,*,208,*,*,2263,1893,370,1570,1255,315,212,*,*,1323
5/1/2016,VA,Virginia,Winchester City,51840,4978,4432,546,4229,20,4209,749,19,730,4532,3986,546,3246,2778,468,819,123,49,2255
5/1/2016,VA,Virginia,Wise,51195,10413,6912,3501,6875,17,6858,3538,23,3515,9823,6323,3500,7707,4398,3309,2422,474,154,4657
5/1/2016,VA,Virginia,Wythe,51197,7338,5672,1666,5677,31,5646,1661,20,1641,6950,5284,1666,5354,3885,1469,1463,272,106,3513
5/1/2016,VA,Virginia,York,51199,10956,9639,1317,10048,43,10005,908,28,880,10038,8721,1317,5253,4039,1214,608,165,39,4441
11/1/2016,VA,Virginia,Accomack,51001,8540,7336,1204,7282,43,7239,1258,48,1210,7967,6763,1204,5809,4778,1031,1567,372,98,3772
11/1/2016,VA,Virginia,Albemarle,51003,19086,17078,2008,17474,52,17422,1612,54,1558,17144,15136,2008,12832,11050,1782,1501,277,97,10957
11/1/2016,VA,Virginia,Alexandria City,51510,16925,14665,2260,15484,69,15415,1441,88,1353,13623,11366,2257,7962,5824,2138,2084,317,74,5487
11/1/2016,VA,Virginia,Alleghany,51005,4515,3876,639,3591,17,3574,924,16,908,4285,3646,639,3406,2898,508,828,98,54,2426
11/1/2016,VA,Virginia,Amelia,51007,2943,2306,637,2455,11,2444,488,13,475,2719,2082,637,2106,1516,590,488,76,37,1505
11/1/2016,VA,Virginia,Amherst,51009,7563,6375,1188,6249,45,6204,1314,30,1284,7025,5837,1188,5614,4516,1098,1189,230,78,4117
11/1/2016,VA,Virginia,Appomattox,51011,3732,3167,565,3019,15,3004,713,20,693,3521,2956,565,2790,2274,516,674,92,39,1985
11/1/2016,VA,Virginia,Arlington,51013,23169,20275,2894,21519,82,21437,1650,85,1565,18316,15422,2894,10626,7893,2733,2950,322,115,7239
11/1/2016,VA,Virginia,Augusta,51015,17332,14935,2397,14845,41,14804,2487,39,2448,16277,13880,2397,12325,10328,1997,1873,386,152,9914
11/1/2016,VA,Virginia,Bath,51017,1267,1155,112,1114,*,*,153,*,*,1194,1082,112,924,829,95,176,38,23,687
11/1/2016,VA,Virginia,Bedford,51019,18772,15427,3345,15930,70,15860,2842,46,2796,17504,14161,3343,13496,10742,2754,2002,471,159,10864
11/1/2016,VA,Virginia,Bland,51021,1755,1373,382,1368,*,*,387,*,*,1655,1273,382,1235,1032,203,262,47,19,907
11/1/2016,VA,Virginia,Botetourt,51023,8295,6504,1791,7158,39,7119,1137,19,1118,7665,5874,1791,5947,4308,1639,829,187,59,4872
11/1/2016,VA,Virginia,Bristol City,51520,4437,2685,1752,3429,15,3414,1008,*,*,4159,2407,1752,3479,1777,1702,1016,150,56,2257
11/1/2016,VA,Virginia,Brunswick,51025,3915,3231,684,3162,24,3138,753,27,726,3676,2992,684,2852,2224,628,1126,108,45,1573
11/1/2016,VA,Virginia,Buchanan,51027,7310,4504,2806,4476,16,4460,2834,11,2823,7033,4227,2806,5808,3807,2001,1642,414,116,3636
11/1/2016,VA,Virginia,Buckingham,51029,3400,2812,588,2731,15,2716,669,15,654,3173,2585,588,2393,2004,389,727,141,49,1476
11/1/2016,VA,Virginia,Buena Vista City,51530,1440,1169,271,1157,*,*,283,*,*,1344,1073,271,1046,821,225,325,63,19,639
11/1/2016,VA,Virginia,Campbell,51031,12346,10388,1958,10089,74,10015,2257,64,2193,11579,9621,1958,9255,7458,1797,2114,364,172,6605
11/1/2016,VA,Virginia,Caroline,51033,5536,4604,932,4592,25,4567,944,39,905,5005,4073,932,3381,2528,853,815,225,57,2284
11/1/2016,VA,Virginia,Carroll,51035,7880,6790,1090,6303,20,6283,1577,17,1560,7460,6370,1090,5740,4848,892,1643,278,103,3716
11/1/2016,VA,Virginia,Charles City,51036,1825,1420,405,1543,17,1526,282,13,269,1677,1272,405,1262,914,348,266,78,19,899
11/1/2016,VA,Virginia,Charlotte,51037,3308,2810,498,2673,14,2659,635,16,619,3129,2631,498,2449,2007,442,800,123,53,1473
11/1/2016,VA,Virginia,Charlottesville City,51540,6049,5300,749,4926,24,4902,1123,48,1075,5427,4678,749,4304,3592,712,1255,149,52,2848
11/1/2016,VA,Virginia,Chesapeake City,51550,35330,28721,6609,30058,224,29834,5272,235,5037,31971,25362,6609,19357,13175,6182,4140,852,245,14120
11/1/2016,VA,Virginia,Chesterfield,51041,55271,42865,12406,47798,152,47646,7473,248,7225,49871,37467,12404,37662,26238,11424,5331,998,291,31042
11/1/2016,VA,Virginia,Clarke,51043,3062,2748,314,2808,14,2794,254,*,*,2773,2459,314,1838,1575,263,261,73,33,1471
11/1/2016,VA,Virginia,Colonial Heights City,51570,4117,3532,585,3533,12,3521,584,13,571,3806,3221,585,2404,1860,544,475,105,23,1801
11/1/2016,VA,Virginia,Covington City,51580,1637,1412,225,1265,*,*,372,*,*,1533,1308,225,1199,986,213,363,57,19,760
11/1/2016,VA,Virginia,Craig,51045,1289,1023,266,1000,*,*,289,*,*,1190,924,266,922,666,256,208,39,12,663
11/1/2016,VA,Virginia,Culpeper,51047,8733,7645,1088,7503,41,7462,1230,39,1191,7922,6834,1088,5413,4436,977,1144,255,65,3949
11/1/2016,VA,Virginia,Cumberland,51049,2207,1728,479,1811,*,*,396,*,*,2037,1558,479,1586,1148,438,431,87,27,1041
11/1/2016,VA,Virginia,Danville City,51590,11099,8851,2248,8655,75,8580,2444,115,2329,10513,8265,2248,8687,7317,1370,3239,436,163,4849
11/1/2016,VA,Virginia,Dickenson,51051,4690,2989,1701,2862,*,*,1828,14,1814,4480,2779,1701,3648,2115,1533,1114,212,82,2240
11/1/2016,VA,Virginia,Dinwiddie,51053,5643,4498,1145,4504,32,4472,1139,34,1105,5197,4052,1145,3785,2689,1096,915,179,56,2635
11/1/2016,VA,Virginia,Emporia City,51595,1141,876,265,869,12,857,272,15,257,1071,806,265,876,659,217,425,*,*,374
11/1/2016,VA,Virginia,Essex,51057,2781,2314,467,2361,18,2343,420,11,409,2592,2125,467,1922,1573,349,432,87,22,1381
11/1/2016,VA,Virginia,Fairfax,51059,141812,123332,18480,133531,475,133056,8281,425,7856,114596,96147,18449,64782,47616,17166,13217,2644,489,48432
11/1/2016,VA,Virginia,Fairfax City,51600,3680,3156,524,3404,14,3390,276,*,*,3083,2559,524,1851,1364,487,387,59,11,1394
11/1/2016,VA,Virginia,Falls Church City,51610,1799,1558,241,1709,*,*,90,*,*,1409,1168,241,837,615,222,137,*,*,679
11/1/2016,VA,Virginia,Fauquier,51061,11689,10534,1155,10585,45,10540,1104,43,1061,10355,9201,1154,6464,5452,1012,929,191,59,5285
11/1/2016,VA,Virginia,Floyd,51063,3892,3149,743,3345,*,*,547,*,*,3628,2885,743,2804,2118,686,547,96,47,2114
11/1/2016,VA,Virginia,Fluvanna,51065,5521,4780,741,4934,18,4916,587,22,565,5052,4311,741,3654,2998,656,501,128,28,2997
11/1/2016,VA,Virginia,Franklin,51067,14083,10438,3645,11630,44,11586,2453,30,2423,13236,9592,3644,10653,7198,3455,2004,461,163,8025
11/1/2016,VA,Virginia,Franklin City,51620,1903,1603,300,1480,18,1462,423,18,405,1783,1483,300,1447,1168,279,553,64,15,815
11/1/2016,VA,Virginia,Frederick,51069,15118,13390,1728,13343,46,13297,1775,47,1728,13781,12053,1728,9373,7897,1476,1453,346,140,7434
11/1/2016,VA,Virginia,Fredericksburg City,51630,3830,3377,453,3130,18,3112,700,26,674,3458,3005,453,2340,1912,428,778,89,36,1437
11/1/2016,VA,Virginia,Galax City,51640,1942,1812,130,1485,*,*,457,*,*,1842,1712,130,1452,1343,109,688,59,32,673
11/1/2016,VA,Virginia,Giles,51071,4518,3447,1071,3543,18,3525,975,16,959,4252,3182,1070,3415,2704,711,803,131,33,2448
11/1/2016,VA,Virginia,Gloucester,51073,7988,6717,1271,6795,34,6761,1193,21,1172,7405,6134,1271,4676,3524,1152,952,176,46,3502
11/1/2016,VA,Virginia,Goochland,51075,5326,4330,996,4837,19,4818,489,18,471,4814,3818,996,3860,3011,849,421,102,32,3305
11/1/2016,VA,Virginia,Grayson,51077,4579,3979,600,3710,*,*,869,*,*,4379,3779,600,3256,2757,499,1006,180,88,1982
11/1/2016,VA,Virginia,Greene,51079,3543,3076,467,3088,*,*,455,*,*,3238,2771,467,2327,1898,429,453,83,25,1766
11/1/2016,VA,Virginia,Greensville,51081,2442,1847,595,1932,20,1912,510,18,492,2281,1686,595,1854,1346,508,574,126,27,1127
11/1/2016,VA,Virginia,Halifax,51083,9449,8194,1255,7623,57,7566,1826,68,1758,8943,7688,1255,7121,6002,1119,2169,449,142,4361
11/1/2016,VA,Virginia,Hampton City,51650,24102,18601,5501,19698,183,19515,4404,198,4206,22042,16541,5501,13121,7827,5294,3593,784,178,8566
11/1/2016,VA,Virginia,Hanover,51085,19519,15361,4158,17582,73,17509,1937,52,1885,17788,13630,4158,13952,10338,3614,1402,350,96,12104
11/1/2016,VA,Virginia,Harrisonburg City,51660,5134,4575,559,4307,14,4293,827,25,802,4663,4104,559,3637,3228,409,943,131,37,2526
11/1/2016,VA,Virginia,Henrico,51087,52975,40522,12453,45933,302,45631,7042,285,6757,47949,35496,12453,37766,26634,11132,6109,1342,407,29908
11/1/2016,VA,Virginia,Henry,51089,14924,10435,4489,11752,64,11688,3172,57,3115,14231,9742,4489,11962,8234,3728,3046,699,257,7960
11/1/2016,VA,Virginia,Highland,51091,737,677,60,677,*,*,60,*,*,692,632,60,503,445,58,61,*,*,416
11/1/2016,VA,Virginia,Hopewell City,51670,4412,3546,866,3385,28,3357,1027,35,992,4121,3255,866,2775,1928,847,943,157,42,1633
11/1/2016,VA,Virginia,Isle of Wight,51093,7691,6066,1625,6700,45,6655,991,29,962,7149,5524,1625,5018,3492,1526,918,191,74,3835
11/1/2016,VA,Virginia,James City,51095,19115,16871,2244,17937,53,17884,1178,47,1131,17675,15434,2241,11096,9213,1883,871,193,49,9983
11/1/2016,VA,Virginia,King and Queen,51097,1706,1428,278,1424,*,*,282,*,*,1600,1322,278,1183,933,250,273,71,16,823
11/1/2016,VA,Virginia,King George,51099,3658,3294,364,3123,13,3110,535,24,511,3179,2815,364,1603,1265,338,468,76,15,1044
11/1/2016,VA,Virginia,King William,51101,3148,2704,444,2678,22,2656,470,25,445,2907,2463,444,2290,1889,401,385,105,22,1778
11/1/2016,VA,Virginia,Lancaster,51103,4233,3707,526,3892,13,3879,341,12,329,4033,3507,526,2854,2492,362,488,96,23,2247
11/1/2016,VA,Virginia,Lee,51105,6317,4034,2283,4243,15,4228,2074,13,2061,6020,3738,2282,4849,2690,2159,1941,244,74,2590
11/1/2016,VA,Virginia,Lexington City,51678,1595,1439,156,1460,15,1445,135,*,*,1483,1327,156,1119,990,129,212,*,*,869
11/1/2016,VA,Virginia,Loudoun,51107,33306,28491,4815,30949,107,30842,2357,116,2241,27637,22831,4806,17814,13413,4401,2892,620,141,14161
11/1/2016,VA,Virginia,Louisa,51109,7455,6233,1222,6222,33,6189,1233,31,1202,6855,5633,1222,5013,3878,1135,1080,237,72,3624
11/1/2016,VA,Virginia,Lunenburg,51111,2960,2573,387,2399,16,2383,561,21,540,2738,2351,387,2037,1679,358,698,123,45,1171
11/1/2016,VA,Virginia,Lynchburg City,51680,14653,12468,2185,11622,84,11538,3031,102,2929,13613,11428,2185,10969,8980,1989,3321,434,150,7064
11/1/2016,VA,Virginia,Madison,51113,2879,2501,378,2535,*,*,344,11,333,2690,2312,378,1938,1598,340,385,90,25,1438
11/1/2016,VA,Virginia,Manassas City,51683,4263,3561,702,3706,33,3673,557,39,518,3592,2890,702,2446,1781,665,531,91,36,1788
11/1/2016,VA,Virginia,Manassas Park City,51685,1201,993,208,1028,11,1017,173,15,158,1012,805,207,699,507,192,189,53,13,444
11/1/2016,VA,Virginia,Martinsville City,51690,3936,2808,1128,2931,25,2906,1005,41,964,3719,2591,1128,3171,2175,996,1288,165,59,1659
11/1/2016,VA,Virginia,Mathews,51115,2782,2397,385,2545,*,*,237,*,*,2638,2253,385,1786,1458,328,251,39,21,1475
11/1/2016,VA,Virginia,Mecklenburg,51117,8955,7172,1783,7355,52,7303,1600,51,1549,8479,6696,1783,6595,5066,1529,1925,369,117,4184
11/1/2016,VA,Virginia,Middlesex,51119,3488,2990,498,3100,22,3078,388,*,*,3281,2783,498,2469,2104,365,441,83,30,1915
11/1/2016,VA,Virginia,Montgomery,51121,13262,11008,2254,10908,41,10867,2354,36,2318,12012,9758,2254,9612,7472,2140,1856,320,114,7322
11/1/2016,VA,Virginia,Nelson,51125,4360,3797,563,3825,15,3810,535,11,524,4012,3449,563,2907,2391,516,590,95,45,2177
11/1/2016,VA,Virginia,New Kent,51127,4077,3420,657,3614,15,3599,463,*,*,3712,3055,657,2557,2024,533,290,72,16,2179
11/1/2016,VA,Virginia,Newport News City,51700,26884,20351,6533,21910,166,21744,4974,246,4728,24610,18079,6531,15793,9486,6307,4644,825,230,10094
11/1/2016,VA,Virginia,Norfolk City,51710,31654,23939,7715,24986,253,24733,6668,341,6327,28545,20830,7715,18813,11354,7459,7013,1302,290,10208
11/1/2016,VA,Virginia,Northampton,51131,3498,2922,576,2968,25,2943,530,23,507,3279,2703,576,2602,2078,524,917,93,33,1559
11/1/2016,VA,Virginia,Northumberland,51133,4575,3995,580,4231,15,4216,344,*,*,4267,3687,580,2771,2404,367,413,93,34,2231
11/1/2016,VA,Virginia,Norton City,51720,1173,852,321,776,*,*,397,*,*,1093,772,321,873,572,301,354,45,18,456
11/1/2016,VA,Virginia,Nottoway,51135,3659,3007,652,2952,30,2922,707,16,691,3411,2759,652,2641,2205,436,952,130,40,1519
11/1/2016,VA,Virginia,Orange,51137,8383,7411,972,7356,39,7317,1027,36,991,7718,6746,972,4946,4226,720,954,210,68,3714
11/1/2016,VA,Virginia,Page,51139,5990,5286,704,4853,19,4834,1137,16,1121,5616,4912,704,4095,3486,609,1141,212,88,2654
11/1/2016,VA,Virginia,Patrick,51141,5095,3864,1231,4167,*,*,928,11,917,4850,3620,1230,3903,2842,1061,1017,199,80,2607
11/1/2016,VA,Virginia,Petersburg City,51730,7122,5404,1718,5241,94,5147,1881,81,1800,6508,4790,1718,4644,2970,1674,2012,349,68,2215
11/1/2016,VA,Virginia,Pittsylvania,51143,15789,12385,3404,12822,99,12723,2967,77,2890,14920,11516,3404,12171,9694,2477,3112,554,216,8289
11/1/2016,VA,Virginia,Poquoson City,51735,2469,2198,271,2294,*,*,175,*,*,2272,2001,271,1109,859,250,96,25,13,975
11/1/2016,VA,Virginia,Portsmouth City,51740,17723,13314,4409,13636,165,13471,4087,210,3877,15900,11493,4407,10322,6070,4252,3860,682,145,5635
11/1/2016,VA,Virginia,Powhatan,51145,5599,4516,1083,4968,17,4951,631,14,617,5145,4062,1083,3989,3022,967,397,116,30,3446
11/1/2016,VA,Virginia,Prince Edward,51147,4572,3783,789,3643,24,3619,929,33,896,4240,3451,789,3248,2644,604,1082,173,47,1946
11/1/2016,VA,Virginia,Prince George,51149,5608,4905,703,4723,25,4698,885,23,862,5177,4474,703,3061,2414,647,584,114,23,2340
11/1/2016,VA,Virginia,Prince William,51153,44256,36833,7423,39204,232,38972,5052,286,4766,37800,30382,7418,21489,14533,6956,5044,957,215,15273
11/1/2016,VA,Virginia,Pulaski,51155,8941,7324,1617,7023,27,6996,1918,25,1893,8353,6736,1617,6362,4833,1529,1673,321,116,4252
11/1/2016,VA,Virginia,Radford City,51750,2018,1648,370,1620,*,*,398,*,*,1849,1479,370,1516,1162,354,341,39,20,1116
11/1/2016,VA,Virginia,Rappahannock,51157,1984,1825,159,1828,*,*,156,*,*,1793,1635,158,1179,1047,132,164,*,*,973
11/1/2016,VA,Virginia,Richmond,51159,1905,1551,354,1643,15,1628,262,15,247,1780,1426,354,1308,1063,245,312,86,21,889
11/1/2016,VA,Virginia,Richmond City,51760,32588,22534,10054,25391,259,25132,7197,346,6851,29300,19247,10053,24083,14384,9699,8616,1348,313,13806
11/1/2016,VA,Virginia,Roanoke,51161,22640,18239,4401,19981,83,19898,2659,51,2608,20989,16589,4400,16444,12416,4028,1982,416,149,13897
11/1/2016,VA,Virginia,Roanoke City,51770,20050,14554,5496,14875,129,14746,5175,143,5032,18358,12863,5495,14694,9424,5270,4809,843,209,8833
11/1/2016,VA,Virginia,Rockbridge,51163,5762,4886,876,4845,18,4827,917,*,*,5370,4494,876,3988,3264,724,853,172,64,2899
11/1/2016,VA,Virginia,Rockingham,51165,16592,14166,2426,14475,40,14435,2117,41,2076,15350,12924,2426,11743,10004,1739,1790,507,165,9281
11/1/2016,VA,Virginia,Russell,51167,7685,5210,2475,5139,11,5128,2546,*,*,7359,4884,2475,6234,4169,2065,1696,311,126,4101
11/1/2016,VA,Virginia,Salem City,51775,5919,4855,1064,4959,28,4931,960,20,940,5440,4376,1064,4239,3255,984,834,148,40,3217
11/1/2016,VA,Virginia,Scott,51169,6536,3374,3162,4826,*,*,1710,13,1697,6282,3120,3162,5392,2279,3113,1537,245,122,3488
11/1/2016,VA,Virginia,Shenandoah,51171,10155,9006,1149,8888,22,8866,1267,25,1242,9530,8381,1149,6624,5661,963,1305,242,102,4975
11/1/2016,VA,Virginia,Smyth,51173,8755,6814,1941,6434,18,6416,2321,23,2298,8252,6311,1941,6651,4912,1739,2179,399,141,3932
11/1/2016,VA,Virginia,Southampton,51175,4017,3391,626,3320,28,3292,697,24,673,3754,3128,626,2905,2353,552,761,133,37,1974
11/1/2016,VA,Virginia,Spotsylvania,51177,19346,17013,2333,16670,97,16573,2676,90,2586,17236,14904,2332,10306,8288,2018,1940,480,141,7745
11/1/2016,VA,Virginia,Stafford,51179,15731,14299,1432,13789,78,13711,1942,85,1857,13796,12364,1432,6901,5648,1253,1320,344,78,5159
11/1/2016,VA,Virginia,Staunton City,51790,5906,5075,831,4817,19,4798,1089,26,1063,5555,4724,831,4287,3566,721,1058,149,65,3015
11/1/2016,VA,Virginia,Suffolk City,51800,15018,12057,2961,12149,80,12069,2869,94,2775,13766,10805,2961,9423,6683,2740,2660,442,109,6212
11/1/2016,VA,Virginia,Surry,51181,1524,1180,344,1273,*,*,251,11,240,1406,1062,344,1018,697,321,208,74,13,723
11/1/2016,VA,Virginia,Sussex,51183,2322,1804,518,1885,28,1857,437,*,*,2164,1646,518,1657,1168,489,488,136,18,1015
11/1/2016,VA,Virginia,Tazewell,51185,11787,8604,3183,8557,30,8527,3230,38,3192,11153,7972,3181,8685,6645,2040,2292,432,185,5776
11/1/2016,VA,Virginia,Unknown,51999,*,*,*,*,*,*,*,*,*,*,*,*,*,*,*,*,*,*,*
11/1/2016,VA,Virginia,Virginia Beach City,51810,66937,56079,10858,58728,300,58428,8209,332,7877,61353,50502,10851,34147,23961,10186,6642,1354,370,25781
11/1/2016,VA,Virginia,Warren,51187,7113,6443,670,6055,22,6033,1058,25,1033,6481,5811,670,4321,3756,565,873,228,77,3143
11/1/2016,VA,Virginia,Washington,51191,14753,10050,4703,11659,44,11615,3094,27,3067,13891,9189,4702,11152,6805,4347,2509,517,172,7954
11/1/2016,VA,Virginia,Waynesboro City,51820,4737,4004,733,3848,16,3832,889,22,867,4436,3703,733,3492,2849,643,880,114,42,2456
11/1/2016,VA,Virginia,Westmoreland,51193,4721,4100,621,4117,22,4095,604,13,591,4328,3707,621,2688,2152,536,741,125,48,1774
11/1/2016,VA,Virginia,Williamsburg City,51830,2520,2147,373,2301,*,*,219,*,*,2310,1938,372,1595,1279,316,218,*,*,1340
11/1/2016,VA,Virginia,Winchester City,51840,5041,4507,534,4266,20,4246,775,18,757,4584,4050,534,3270,2813,457,842,130,49,2249
11/1/2016,VA,Virginia,Wise,51195,10432,6926,3506,6858,17,6841,3574,23,3551,9866,6361,3505,7753,4437,3316,2466,467,158,4662
11/1/2016,VA,Virginia,Wythe,51197,7423,5742,1681,5723,30,5693,1700,20,1680,7019,5338,1681,5400,3917,1483,1500,262,111,3527
11/1/2016,VA,Virginia,York,51199,11094,9773,1321,10151,36,10115,943,28,915,10162,8843,1319,5283,4064,1219,623,167,42,4451
10/1/2016,VA,Virginia,Accomack,51001,8529,7329,1200,7278,43,7235,1251,48,1203,7957,6757,1200,5813,4786,1027,1561,373,96,3783
10/1/2016,VA,Virginia,Albemarle,51003,19040,17040,2000,17430,54,17376,1610,57,1553,17112,15112,2000,12822,11047,1775,1501,275,95,10951
10/1/2016,VA,Virginia,Alexandria City,51510,16863,14639,2224,15433,69,15364,1430,88,1342,13576,11355,2221,7930,5829,2101,2060,314,71,5485
10/1/2016,VA,Virginia,Alleghany,51005,4511,3872,639,3590,17,3573,921,16,905,4286,3647,639,3404,2897,507,828,100,53,2423
10/1/2016,VA,Virginia,Amelia,51007,2944,2308,636,2459,12,2447,485,13,472,2722,2086,636,2104,1514,590,486,75,37,1506
10/1/2016,VA,Virginia,Amherst,51009,7544,6358,1186,6235,45,6190,1309,30,1279,7013,5827,1186,5607,4510,1097,1186,231,78,4112
10/1/2016,VA,Virginia,Appomattox,51011,3737,3174,563,3024,15,3009,713,20,693,3524,2961,563,2795,2281,514,676,93,39,1987
10/1/2016,VA,Virginia,Arlington,51013,23104,20220,2884,21460,83,21377,1644,86,1558,18278,15394,2884,10615,7893,2722,2937,315,116,7247
10/1/2016,VA,Virginia,Augusta,51015,17324,14930,2394,14844,44,14800,2480,39,2441,16277,13883,2394,12317,10325,1992,1855,388,151,9923
10/1/2016,VA,Virginia,Bath,51017,1269,1155,114,1117,*,*,152,*,*,1194,1080,114,922,825,97,175,35,23,689
10/1/2016,VA,Virginia,Bedford,51019,18738,15388,3350,15909,71,15838,2829,47,2782,17488,14140,3348,13480,10722,2758,2001,469,157,10853
10/1/2016,VA,Virginia,Bland,51021,1753,1371,382,1367,*,*,386,*,*,1653,1271,382,1240,1034,206,262,47,20,911
10/1/2016,VA,Virginia,Botetourt,51023,8284,6491,1793,7151,41,7110,1133,19,1114,7658,5865,1793,5948,4308,1640,830,188,60,4870
10/1/2016,VA,Virginia,Bristol City,51520,4424,2677,1747,3420,16,3404,1004,*,*,4152,2405,1747,3469,1773,1696,1007,151,56,2255
10/1/2016,VA,Virginia,Brunswick,51025,3919,3228,691,3170,26,3144,749,26,723,3680,2989,691,2857,2222,635,1124,109,45,1579
10/1/2016,VA,Virginia,Buchanan,51027,7317,4516,2801,4491,17,4474,2826,11,2815,7032,4231,2801,5813,3821,1992,1637,414,116,3646
10/1/2016,VA,Virginia,Buckingham,51029,3399,2814,585,2730,16,2714,669,15,654,3174,2589,585,2397,2014,383,731,142,47,1477
10/1/2016,VA,Virginia,Buena Vista City,51530,1441,1174,267,1159,*,*,282,*,*,1345,1078,267,1041,820,221,321,63,20,637
10/1/2016,VA,Virginia,Campbell,51031,12341,10374,1967,10094,75,10019,2247,64,2183,11578,9611,1967,9257,7452,1805,2105,364,173,6615
10/1/2016,VA,Virginia,Caroline,51033,5520,4587,933,4583,25,4558,937,39,898,4992,4059,933,3373,2518,855,809,226,56,2282
10/1/2016,VA,Virginia,Carroll,51035,7876,6786,1090,6301,20,6281,1575,18,1557,7456,6366,1090,5742,4851,891,1632,279,102,3729
10/1/2016,VA,Virginia,Charles City,51036,1817,1418,399,1536,17,1519,281,12,269,1670,1271,399,1258,916,342,266,78,19,895
10/1/2016,VA,Virginia,Charlotte,51037,3294,2798,496,2661,15,2646,633,16,617,3123,2627,496,2443,2003,440,799,122,52,1470
10/1/2016,VA,Virginia,Charlottesville City,51540,6037,5296,741,4920,25,4895,1117,48,1069,5427,4686,741,4291,3587,704,1241,150,54,2846
10/1/2016,VA,Virginia,Chesapeake City,51550,35215,28643,6572,29970,227,29743,5245,239,5006,31881,25309,6572,19299,13153,6146,4117,845,248,14089
10/1/2016,VA,Virginia,Chesterfield,51041,55107,42755,12352,47646,154,47492,7461,250,7211,49736,37386,12350,37544,26179,11365,5285,995,295,30969
10/1/2016,VA,Virginia,Clarke,51043,3060,2747,313,2807,14,2793,253,*,*,2774,2461,313,1839,1577,262,260,73,34,1472
10/1/2016,VA,Virginia,Colonial Heights City,51570,4122,3544,578,3538,12,3526,584,13,571,3809,3231,578,2405,1868,537,471,104,24,1806
10/1/2016,VA,Virginia,Covington City,51580,1639,1416,223,1268,*,*,371,*,*,1534,1311,223,1206,995,211,365,56,19,766
10/1/2016,VA,Virginia,Craig,51045,1284,1018,266,995,*,*,289,*,*,1185,919,266,922,666,256,207,*,*,666
10/1/2016,VA,Virginia,Culpeper,51047,8716,7637,1079,7494,42,7452,1222,39,1183,7912,6833,1079,5404,4436,968,1134,257,65,3948
10/1/2016,VA,Virginia,Cumberland,51049,2206,1721,485,1812,*,*,394,*,*,2038,1553,485,1585,1142,443,434,87,26,1038
10/1/2016,VA,Virginia,Danville City,51590,11103,8854,2249,8663,76,8587,2440,116,2324,10525,8276,2249,8690,7322,1368,3241,428,162,4859
10/1/2016,VA,Virginia,Dickenson,51051,4680,2995,1685,2858,*,*,1822,14,1808,4468,2783,1685,3632,2114,1518,1108,211,83,2230
10/1/2016,VA,Virginia,Dinwiddie,51053,5635,4491,1144,4503,33,4470,1132,34,1098,5187,4043,1144,3777,2683,1094,911,177,55,2634
10/1/2016,VA,Virginia,Emporia City,51595,1143,873,270,868,12,856,275,15,260,1073,803,270,880,658,222,428,*,*,375
10/1/2016,VA,Virginia,Essex,51057,2777,2307,470,2358,18,2340,419,11,408,2592,2122,470,1925,1575,350,433,88,22,1382
10/1/2016,VA,Virginia,Fairfax,51059,141301,122913,18388,133075,488,132587,8226,419,7807,114314,95956,18358,64608,47531,17077,13145,2630,480,48353
10/1/2016,VA,Virginia,Fairfax City,51600,3675,3153,522,3401,14,3387,274,*,*,3078,2556,522,1842,1357,485,383,58,11,1390
10/1/2016,VA,Virginia,Falls Church City,51610,1797,1557,240,1710,*,*,87,*,*,1409,1169,240,835,614,221,135,*,*,679
10/1/2016,VA,Virginia,Fauquier,51061,11676,10524,1152,10567,46,10521,1109,43,1066,10350,9199,1151,6466,5458,1008,928,195,60,5283
10/1/2016,VA,Virginia,Floyd,51063,3890,3151,739,3342,*,*,548,*,*,3625,2886,739,2803,2120,683,549,98,47,2109
10/1/2016,VA,Virginia,Fluvanna,51065,5512,4767,745,4928,19,4909,584,22,562,5051,4306,745,3643,2983,660,499,128,26,2990
10/1/2016,VA,Virginia,Franklin,51067,14060,10423,3637,11612,46,11566,2448,29,2419,13217,9581,3636,10621,7174,3447,1999,459,161,8002
10/1/2016,VA,Virginia,Franklin City,51620,1893,1593,300,1473,18,1455,420,18,402,1777,1477,300,1445,1167,278,549,64,15,817
10/1/2016,VA,Virginia,Frederick,51069,15087,13349,1738,13325,46,13279,1762,48,1714,13759,12021,1738,9362,7877,1485,1447,339,139,7437
10/1/2016,VA,Virginia,Fredericksburg City,51630,3831,3383,448,3137,18,3119,694,26,668,3456,3008,448,2339,1915,424,777,90,36,1436
10/1/2016,VA,Virginia,Galax City,51640,1941,1810,131,1485,*,*,456,*,*,1842,1711,131,1449,1339,110,687,60,31,671
10/1/2016,VA,Virginia,Giles,51071,4504,3440,1064,3536,19,3517,968,16,952,4246,3183,1063,3410,2706,704,800,129,32,2449
10/1/2016,VA,Virginia,Gloucester,51073,7967,6699,1268,6780,34,6746,1187,21,1166,7389,6121,1268,4664,3515,1149,949,176,45,3494
10/1/2016,VA,Virginia,Goochland,51075,5303,4310,993,4815,19,4796,488,18,470,4797,3804,993,3848,3003,845,419,101,32,3296
10/1/2016,VA,Virginia,Grayson,51077,4573,3975,598,3707,*,*,866,*,*,4370,3772,598,3245,2749,496,1001,177,89,1978
10/1/2016,VA,Virginia,Greene,51079,3544,3077,467,3091,*,*,453,*,*,3238,2771,467,2329,1900,429,450,84,25,1770
10/1/2016,VA,Virginia,Greensville,51081,2440,1846,594,1930,20,1910,510,18,492,2279,1685,594,1859,1353,506,577,128,27,1127
10/1/2016,VA,Virginia,Halifax,51083,9453,8195,1258,7631,58,7573,1822,68,1754,8949,7691,1258,7129,6008,1121,2171,451,140,4367
10/1/2016,VA,Virginia,Hampton City,51650,24064,18588,5476,19677,190,19487,4387,201,4186,22015,16539,5476,13114,7844,5270,3584,778,180,8572
10/1/2016,VA,Virginia,Hanover,51085,19490,15336,4154,17555,74,17481,1935,52,1883,17767,13613,4154,13932,10323,3609,1402,349,99,12082
10/1/2016,VA,Virginia,Harrisonburg City,51660,5124,4563,561,4297,14,4283,827,25,802,4664,4103,561,3643,3233,410,946,131,36,2530
10/1/2016,VA,Virginia,Henrico,51087,52850,40455,12395,45839,307,45532,7011,284,6727,47885,35490,12395,37721,26655,11066,6086,1344,406,29885
10/1/2016,VA,Virginia,Henry,51089,14924,10362,4562,11759,65,11694,3165,59,3106,14231,9669,4562,11969,8185,3784,3044,695,253,7977
10/1/2016,VA,Virginia,Highland,51091,733,673,60,674,*,*,59,*,*,688,628,60,500,442,58,61,*,*,415
10/1/2016,VA,Virginia,Hopewell City,51670,4408,3548,860,3385,30,3355,1023,36,987,4122,3262,860,2774,1933,841,941,157,41,1635
10/1/2016,VA,Virginia,Isle of Wight,51093,7657,6035,1622,6678,46,6632,979,29,950,7118,5496,1622,4991,3470,1521,904,189,75,3823
10/1/2016,VA,Virginia,James City,51095,19073,16839,2234,17897,56,17841,1176,47,1129,17643,15412,2231,11075,9196,1879,865,192,50,9968
10/1/2016,VA,Virginia,King and Queen,51097,1703,1424,279,1421,*,*,282,*,*,1595,1316,279,1178,927,251,270,72,16,820
10/1/2016,VA,Virginia,King George,51099,3659,3292,367,3125,13,3112,534,24,510,3183,2816,367,1596,1254,342,459,77,15,1045
10/1/2016,VA,Virginia,King William,51101,3145,2709,436,2679,22,2657,466,25,441,2905,2469,436,2285,1891,394,379,104,22,1780
10/1/2016,VA,Virginia,Lancaster,51103,4229,3701,528,3892,13,3879,337,11,326,4035,3507,528,2856,2492,364,492,95,24,2245
10/1/2016,VA,Virginia,Lee,51105,6322,4038,2284,4251,15,4236,2071,13,2058,6023,3740,2283,4852,2691,2161,1936,240,73,2603
10/1/2016,VA,Virginia,Lexington City,51678,1601,1445,156,1465,15,1450,136,*,*,1489,1333,156,1123,994,129,213,*,*,872
10/1/2016,VA,Virginia,Loudoun,51107,33192,28417,4775,30848,107,30741,2344,112,2232,27555,22789,4766,17762,13399,4363,2878,613,138,14133
10/1/2016,VA,Virginia,Louisa,51109,7444,6230,1214,6216,33,6183,1228,32,1196,6848,5634,1214,5005,3879,1126,1071,242,70,3622
10/1/2016,VA,Virginia,Lunenburg,51111,2964,2579,385,2404,16,2388,560,22,538,2741,2356,385,2038,1682,356,694,122,45,1177
10/1/2016,VA,Virginia,Lynchburg City,51680,14628,12446,2182,11606,85,11521,3022,102,2920,13600,11418,2182,10967,8983,1984,3313,434,150,7070
10/1/2016,VA,Virginia,Madison,51113,2872,2494,378,2528,*,*,344,11,333,2683,2305,378,1933,1593,340,385,89,26,1433
10/1/2016,VA,Virginia,Manassas City,51683,4259,3565,694,3705,33,3672,554,39,515,3591,2897,694,2451,1795,656,532,90,38,1791
10/1/2016,VA,Virginia,Manassas Park City,51685,1199,989,210,1026,11,1015,173,15,158,1014,805,209,701,508,193,185,55,13,448
10/1/2016,VA,Virginia,Martinsville City,51690,3934,2748,1186,2934,25,2909,1000,41,959,3714,2528,1186,3177,2123,1054,1290,165,58,1664
10/1/2016,VA,Virginia,Mathews,51115,2782,2393,389,2546,*,*,236,*,*,2638,2249,389,1788,1457,331,255,38,21,1474
10/1/2016,VA,Virginia,Mecklenburg,51117,8969,7143,1826,7369,52,7317,1600,52,1548,8490,6664,1826,6606,5040,1566,1927,371,115,4193
10/1/2016,VA,Virginia,Middlesex,51119,3494,2993,501,3106,22,3084,388,*,*,3287,2786,501,2471,2103,368,443,83,31,1914
10/1/2016,VA,Virginia,Montgomery,51121,13248,10996,2252,10903,42,10861,2345,37,2308,12010,9758,2252,9609,7472,2137,1845,317,112,7335
10/1/2016,VA,Virginia,Nelson,51125,4345,3785,560,3811,15,3796,534,11,523,3997,3437,560,2898,2385,513,587,92,44,2175
10/1/2016,VA,Virginia,New Kent,51127,4050,3397,653,3590,15,3575,460,*,*,3695,3042,653,2534,2005,529,289,73,16,2156
10/1/2016,VA,Virginia,Newport News City,51700,26842,20342,6500,21868,168,21700,4974,249,4725,24582,18084,6498,15772,9500,6272,4635,808,231,10098
10/1/2016,VA,Virginia,Norfolk City,51710,31611,23940,7671,24973,257,24716,6638,344,6294,28497,20826,7671,18735,11322,7413,6965,1301,288,10181
10/1/2016,VA,Virginia,Northampton,51131,3499,2928,571,2968,25,2943,531,23,508,3280,2709,571,2599,2080,519,915,93,32,1559
10/1/2016,VA,Virginia,Northumberland,51133,4566,3991,575,4224,15,4209,342,*,*,4261,3686,575,2771,2407,364,408,91,35,2237
10/1/2016,VA,Virginia,Norton City,51720,1175,856,319,779,*,*,396,*,*,1094,775,319,874,575,299,355,45,19,455
10/1/2016,VA,Virginia,Nottoway,51135,3653,3006,647,2947,31,2916,706,16,690,3406,2759,647,2630,2196,434,943,130,42,1515
10/1/2016,VA,Virginia,Orange,51137,8368,7393,975,7347,39,7308,1021,37,984,7703,6728,975,4940,4214,726,952,212,68,3708
10/1/2016,VA,Virginia,Page,51139,5990,5279,711,4855,19,4836,1135,16,1119,5616,4905,711,4092,3475,617,1142,211,89,2650
10/1/2016,VA,Virginia,Patrick,51141,5086,3853,1233,4164,*,*,922,11,911,4840,3608,1232,3897,2834,1063,1010,200,82,2605
10/1/2016,VA,Virginia,Petersburg City,51730,7113,5403,1710,5236,98,5138,1877,81,1796,6512,4802,1710,4629,2962,1667,2001,342,67,2219
10/1/2016,VA,Virginia,Pittsylvania,51143,15779,12366,3413,12821,100,12721,2958,77,2881,14924,11511,3413,12187,9698,2489,3104,560,214,8309
10/1/2016,VA,Virginia,Poquoson City,51735,2462,2185,277,2290,*,*,172,*,*,2268,1991,277,1107,852,255,93,27,13,974
10/1/2016,VA,Virginia,Portsmouth City,51740,17681,13293,4388,13612,169,13443,4069,209,3860,15858,11472,4386,10290,6060,4230,3845,675,145,5625
10/1/2016,VA,Virginia,Powhatan,51145,5573,4494,1079,4947,17,4930,626,14,612,5124,4045,1079,3971,3006,965,392,113,30,3436
10/1/2016,VA,Virginia,Prince Edward,51147,4567,3782,785,3641,25,3616,926,33,893,4235,3450,785,3236,2635,601,1072,171,46,1947
10/1/2016,VA,Virginia,Prince George,51149,5609,4905,704,4730,26,4704,879,23,856,5174,4470,704,3062,2414,648,584,115,23,2340
10/1/2016,VA,Virginia,Prince William,51153,44086,36690,7396,39051,235,38816,5035,290,4745,37694,30303,7391,21433,14503,6930,5028,950,215,15240
10/1/2016,VA,Virginia,Pulaski,51155,8941,7318,1623,7025,28,6997,1916,25,1891,8362,6739,1623,6367,4835,1532,1666,322,117,4262
10/1/2016,VA,Virginia,Radford City,51750,2014,1645,369,1618,*,*,396,*,*,1847,1478,369,1519,1166,353,341,39,20,1119
10/1/2016,VA,Virginia,Rappahannock,51157,1978,1820,158,1823,*,*,155,*,*,1791,1634,157,1183,1052,131,164,35,11,973
10/1/2016,VA,Virginia,Richmond,51159,1906,1551,355,1646,15,1631,260,15,245,1780,1425,355,1308,1062,246,308,86,21,893
10/1/2016,VA,Virginia,Richmond City,51760,32536,22557,9979,25346,263,25083,7190,349,6841,29255,19276,9979,24051,14428,9623,8579,1358,315,13799
10/1/2016,VA,Virginia,Roanoke,51161,22633,18223,4410,19974,85,19889,2659,52,2607,20973,16564,4409,16416,12385,4031,1961,423,150,13882
10/1/2016,VA,Virginia,Roanoke City,51770,20014,14548,5466,14865,132,14733,5149,141,5008,18342,12878,5464,14680,9441,5239,4799,841,210,8830
10/1/2016,VA,Virginia,Rockbridge,51163,5752,4878,874,4840,18,4822,912,*,*,5361,4487,874,3984,3263,721,850,173,62,2899
10/1/2016,VA,Virginia,Rockingham,51165,16566,14152,2414,14459,41,14418,2107,42,2065,15330,12916,2414,11724,9997,1727,1782,502,166,9274
10/1/2016,VA,Virginia,Russell,51167,7683,5206,2477,5140,11,5129,2543,*,*,7359,4882,2477,6231,4165,2066,1685,312,126,4108
10/1/2016,VA,Virginia,Salem City,51775,5902,4841,1061,4945,28,4917,957,20,937,5432,4371,1061,4233,3253,980,833,147,39,3214
10/1/2016,VA,Virginia,Scott,51169,6529,3367,3162,4828,*,*,1701,13,1688,6274,3112,3162,5388,2275,3113,1541,247,122,3478
10/1/2016,VA,Virginia,Shenandoah,51171,10115,8969,1146,8855,22,8833,1260,25,1235,9500,8354,1146,6596,5634,962,1289,239,101,4967
10/1/2016,VA,Virginia,Smyth,51173,8761,6824,1937,6452,18,6434,2309,23,2286,8256,6319,1937,6650,4915,1735,2179,399,139,3933
10/1/2016,VA,Virginia,Southampton,51175,4024,3401,623,3328,28,3300,696,25,671,3758,3135,623,2907,2358,549,762,135,35,1975
10/1/2016,VA,Virginia,Spotsylvania,51177,19289,16976,2313,16634,100,16534,2655,89,2566,17180,14868,2312,10281,8281,2000,1928,482,141,7730
10/1/2016,VA,Virginia,Stafford,51179,15679,14252,1427,13742,78,13664,1937,85,1852,13773,12346,1427,6907,5659,1248,1315,345,78,5169
10/1/2016,VA,Virginia,Staunton City,51790,5904,5076,828,4816,19,4797,1088,25,1063,5549,4721,828,4287,3569,718,1059,148,62,3018
10/1/2016,VA,Virginia,Suffolk City,51800,15012,12042,2970,12149,82,12067,2863,95,2768,13763,10793,2970,9421,6672,2749,2653,439,109,6220
10/1/2016,VA,Virginia,Surry,51181,1523,1177,346,1273,*,*,250,11,239,1407,1061,346,1017,694,323,206,75,13,723
10/1/2016,VA,Virginia,Sussex,51183,2321,1809,512,1884,28,1856,437,*,*,2162,1650,512,1658,1176,482,491,136,18,1013
10/1/2016,VA,Virginia,Tazewell,51185,11753,8585,3168,8545,30,8515,3208,38,3170,11125,7959,3166,8708,6686,2022,2275,430,180,5823
10/1/2016,VA,Virginia,Unknown,51999,*,*,*,*,*,*,*,*,*,*,*,*,*,*,*,*,*,*,*
10/1/2016,VA,Virginia,Virginia Beach City,51810,66761,55966,10795,58593,307,58286,8168,332,7836,61201,50412,10789,34041,23919,10122,6621,1342,364,25714
10/1/2016,VA,Virginia,Warren,51187,7094,6425,669,6041,22,6019,1053,26,1027,6466,5797,669,4306,3742,564,863,227,79,3137
10/1/2016,VA,Virginia,Washington,51191,14746,10052,4694,11655,44,11611,3091,27,3064,13886,9193,4693,11129,6788,4341,2491,522,170,7946
10/1/2016,VA,Virginia,Waynesboro City,51820,4736,4009,727,3848,17,3831,888,22,866,4441,3714,727,3494,2859,635,874,113,44,2463
10/1/2016,VA,Virginia,Westmoreland,51193,4720,4102,618,4119,23,4096,601,12,589,4330,3712,618,2682,2149,533,737,124,48,1773
10/1/2016,VA,Virginia,Williamsburg City,51830,2517,2148,369,2298,*,*,219,*,*,2304,1936,368,1589,1277,312,216,*,*,1336
10/1/2016,VA,Virginia,Winchester City,51840,5028,4488,540,4259,20,4239,769,18,751,4575,4035,540,3265,2804,461,836,124,49,2256
10/1/2016,VA,Virginia,Wise,51195,10436,6934,3502,6867,17,6850,3569,23,3546,9863,6362,3501,7743,4430,3313,2462,463,157,4661
10/1/2016,VA,Virginia,Wythe,51197,7407,5732,1675,5713,30,5683,1694,20,1674,7007,5332,1675,5396,3920,1476,1490,264,110,3532
10/1/2016,VA,Virginia,York,51199,11076,9760,1316,10139,36,10103,937,27,910,10148,8834,1314,5276,4063,1213,614,166,41,4455
9/1/2016,VA,Virginia,Accomack,51001,8512,7307,1205,7264,43,7221,1248,48,1200,7948,6743,1205,5796,4765,1031,1551,375,96,3774
9/1/2016,VA,Virginia,Albemarle,51003,18981,16979,2002,17376,55,17321,1605,58,1547,17057,15055,2002,12756,10979,1777,1491,275,92,10898
9/1/2016,VA,Virginia,Alexandria City,51510,16774,14564,2210,15355,69,15286,1419,87,1332,13511,11304,2207,7894,5809,2085,2046,315,73,5460
9/1/2016,VA,Virginia,Alleghany,51005,4508,3877,631,3590,17,3573,918,16,902,4285,3654,631,3406,2907,499,825,100,53,2428
9/1/2016,VA,Virginia,Amelia,51007,2941,2301,640,2459,12,2447,482,12,470,2718,2078,640,2098,1504,594,480,78,37,1503
9/1/2016,VA,Virginia,Amherst,51009,7526,6337,1189,6226,46,6180,1300,30,1270,6995,5806,1189,5598,4497,1101,1179,231,79,4109
9/1/2016,VA,Virginia,Appomattox,51011,3725,3164,561,3017,15,3002,708,20,688,3515,2954,561,2793,2281,512,678,93,37,1985
9/1/2016,VA,Virginia,Arlington,51013,23007,20133,2874,21371,83,21288,1636,87,1549,18213,15339,2874,10592,7882,2710,2925,322,114,7231
9/1/2016,VA,Virginia,Augusta,51015,17284,14893,2391,14820,44,14776,2464,40,2424,16235,13844,2391,12271,10283,1988,1854,392,151,9874
9/1/2016,VA,Virginia,Bath,51017,1267,1154,113,1114,*,*,153,*,*,1194,1081,113,922,826,96,177,34,24,687
9/1/2016,VA,Virginia,Bedford,51019,18684,15346,3338,15870,73,15797,2814,45,2769,17448,14112,3336,13436,10685,2751,1993,468,155,10820
9/1/2016,VA,Virginia,Bland,51021,1751,1367,384,1365,*,*,386,*,*,1652,1268,384,1239,1030,209,260,48,20,911
9/1/2016,VA,Virginia,Botetourt,51023,8259,6464,1795,7127,41,7086,1132,19,1113,7637,5842,1795,5936,4294,1642,829,189,62,4856
9/1/2016,VA,Virginia,Bristol City,51520,4423,2683,1740,3419,16,3403,1004,*,*,4149,2409,1740,3465,1776,1689,1002,151,56,2256
9/1/2016,VA,Virginia,Brunswick,51025,3910,3234,676,3162,26,3136,748,27,721,3672,2996,676,2850,2233,617,1119,109,45,1577
9/1/2016,VA,Virginia,Buchanan,51027,7319,4521,2798,4500,17,4483,2819,11,2808,7031,4233,2798,5800,3814,1986,1637,413,116,3634
9/1/2016,VA,Virginia,Buckingham,51029,3397,2809,588,2732,18,2714,665,15,650,3169,2581,588,2394,2008,386,723,147,47,1477
9/1/2016,VA,Virginia,Buena Vista City,51530,1440,1172,268,1158,*,*,282,*,*,1346,1078,268,1040,818,222,319,62,20,639
9/1/2016,VA,Virginia,Campbell,51031,12317,10348,1969,10074,77,9997,2243,64,2179,11565,9596,1969,9249,7441,1808,2107,364,171,6607
9/1/2016,VA,Virginia,Caroline,51033,5505,4573,932,4574,26,4548,931,39,892,4981,4049,932,3375,2521,854,799,232,55,2289
9/1/2016,VA,Virginia,Carroll,51035,7871,6782,1089,6290,21,6269,1581,18,1563,7457,6368,1089,5733,4843,890,1631,278,103,3721
9/1/2016,VA,Virginia,Charles City,51036,1812,1409,403,1536,17,1519,276,12,264,1666,1263,403,1253,906,347,264,78,19,892
9/1/2016,VA,Virginia,Charlotte,51037,3295,2801,494,2665,15,2650,630,16,614,3123,2630,493,2441,2003,438,801,123,51,1466
9/1/2016,VA,Virginia,Charlottesville City,51540,6024,5274,750,4908,25,4883,1116,48,1068,5416,4666,750,4284,3571,713,1233,152,53,2846
9/1/2016,VA,Virginia,Chesapeake City,51550,35101,28537,6564,29890,231,29659,5211,236,4975,31786,25222,6564,19235,13098,6137,4096,841,246,14052
9/1/2016,VA,Virginia,Chesterfield,51041,54933,42625,12308,47501,156,47345,7432,249,7183,49597,37291,12306,37387,26069,11318,5244,989,290,30864
9/1/2016,VA,Virginia,Clarke,51043,3048,2734,314,2796,14,2782,252,*,*,2764,2450,314,1836,1573,263,261,73,34,1468
9/1/2016,VA,Virginia,Colonial Heights City,51570,4112,3535,577,3531,12,3519,581,13,568,3796,3219,577,2395,1859,536,468,103,24,1800
9/1/2016,VA,Virginia,Covington City,51580,1643,1418,225,1271,*,*,372,*,*,1536,1311,225,1202,989,213,362,55,19,766
9/1/2016,VA,Virginia,Craig,51045,1278,1012,266,990,*,*,288,*,*,1180,914,266,916,660,256,203,39,11,663
9/1/2016,VA,Virginia,Culpeper,51047,8702,7627,1075,7484,43,7441,1218,37,1181,7896,6821,1075,5389,4426,963,1127,256,64,3942
9/1/2016,VA,Virginia,Cumberland,51049,2202,1717,485,1810,*,*,392,*,*,2037,1552,485,1580,1137,443,432,84,25,1039
9/1/2016,VA,Virginia,Danville City,51590,11079,8832,2247,8646,76,8570,2433,118,2315,10508,8261,2247,8674,7309,1365,3231,429,160,4854
9/1/2016,VA,Virginia,Dickenson,51051,4679,2992,1687,2859,*,*,1820,14,1806,4469,2782,1687,3634,2114,1520,1105,210,82,2237
9/1/2016,VA,Virginia,Dinwiddie,51053,5619,4478,1141,4495,33,4462,1124,34,1090,5171,4030,1141,3773,2680,1093,904,178,55,2636
9/1/2016,VA,Virginia,Emporia City,51595,1143,868,275,869,13,856,274,14,260,1071,796,275,872,645,227,423,*,*,372
9/1/2016,VA,Virginia,Essex,51057,2770,2299,471,2351,18,2333,419,11,408,2588,2117,471,1910,1559,351,426,88,23,1373
9/1/2016,VA,Virginia,Fairfax,51059,140650,122334,18316,132462,491,131971,8188,420,7768,113928,95642,18286,64344,47339,17005,13065,2618,473,48188
9/1/2016,VA,Virginia,Fairfax City,51600,3659,3138,521,3386,14,3372,273,*,*,3069,2548,521,1828,1346,482,380,57,11,1380
9/1/2016,VA,Virginia,Falls Church City,51610,1794,1554,240,1708,*,*,86,*,*,1410,1170,240,834,614,220,131,*,*,682
9/1/2016,VA,Virginia,Fauquier,51061,11641,10487,1154,10532,46,10486,1109,43,1066,10312,9159,1153,6443,5432,1011,927,196,60,5260
9/1/2016,VA,Virginia,Floyd,51063,3879,3141,738,3330,*,*,549,*,*,3616,2878,738,2790,2107,683,547,98,47,2098
9/1/2016,VA,Virginia,Fluvanna,51065,5490,4749,741,4909,20,4889,581,22,559,5035,4294,741,3621,2965,656,487,127,24,2983
9/1/2016,VA,Virginia,Franklin,51067,14047,10414,3633,11602,46,11556,2445,29,2416,13212,9579,3633,10601,7159,3442,1999,464,158,7980
9/1/2016,VA,Virginia,Franklin City,51620,1894,1592,302,1477,18,1459,417,18,399,1777,1475,302,1443,1164,279,546,64,15,818
9/1/2016,VA,Virginia,Frederick,51069,15039,13306,1733,13291,46,13245,1748,48,1700,13721,11988,1733,9324,7842,1482,1434,338,142,7410
9/1/2016,VA,Virginia,Fredericksburg City,51630,3832,3379,453,3138,18,3120,694,26,668,3455,3002,453,2343,1913,430,777,89,36,1441
9/1/2016,VA,Virginia,Galax City,51640,1934,1798,136,1481,*,*,453,*,*,1833,1697,136,1444,1330,114,679,60,32,673
9/1/2016,VA,Virginia,Giles,51071,4497,3435,1062,3529,19,3510,968,16,952,4243,3182,1061,3397,2693,704,799,128,34,2436
9/1/2016,VA,Virginia,Gloucester,51073,7946,6683,1263,6764,34,6730,1182,21,1161,7367,6104,1263,4638,3491,1147,944,176,47,3471
9/1/2016,VA,Virginia,Goochland,51075,5290,4292,998,4801,19,4782,489,19,470,4789,3791,998,3844,2994,850,419,97,32,3296
9/1/2016,VA,Virginia,Grayson,51077,4565,3976,589,3702,*,*,863,*,*,4364,3775,589,3236,2748,488,1000,172,87,1977
9/1/2016,VA,Virginia,Greene,51079,3528,3061,467,3077,*,*,451,*,*,3230,2763,467,2323,1894,429,447,84,24,1768
9/1/2016,VA,Virginia,Greensville,51081,2432,1833,599,1926,21,1905,506,18,488,2273,1674,599,1846,1335,511,572,128,27,1119
9/1/2016,VA,Virginia,Halifax,51083,9453,8197,1256,7634,58,7576,1819,67,1752,8943,7687,1256,7127,6008,1119,2173,454,140,4360
9/1/2016,VA,Virginia,Hampton City,51650,24012,18540,5472,19643,194,19449,4369,203,4166,21961,16489,5472,13082,7818,5264,3570,785,177,8550
9/1/2016,VA,Virginia,Hanover,51085,19442,15308,4134,17510,77,17433,1932,52,1880,17716,13582,4134,13874,10286,3588,1398,349,99,12028
9/1/2016,VA,Virginia,Harrisonburg City,51660,5121,4551,570,4293,14,4279,828,24,804,4658,4088,570,3630,3213,417,946,129,36,2519
9/1/2016,VA,Virginia,Henrico,51087,52741,40356,12385,45747,310,45437,6994,287,6707,47810,35425,12385,37637,26584,11053,6055,1335,402,29845
9/1/2016,VA,Virginia,Henry,51089,14906,10805,4101,11752,65,11687,3154,58,3096,14214,10113,4101,11956,8664,3292,3020,697,253,7986
9/1/2016,VA,Virginia,Highland,51091,729,670,59,670,*,*,59,*,*,684,625,59,497,440,57,61,*,*,412
9/1/2016,VA,Virginia,Hopewell City,51670,4400,3543,857,3378,30,3348,1022,37,985,4119,3262,857,2768,1930,838,938,157,40,1633
9/1/2016,VA,Virginia,Isle of Wight,51093,7630,6005,1625,6653,48,6605,977,29,948,7090,5465,1625,4975,3450,1525,901,189,75,3810
9/1/2016,VA,Virginia,James City,51095,19038,16800,2238,17867,58,17809,1171,47,1124,17614,15379,2235,11046,9165,1881,861,193,49,9943
9/1/2016,VA,Virginia,King and Queen,51097,1690,1413,277,1411,*,*,279,*,*,1582,1305,277,1170,921,249,270,72,15,813
9/1/2016,VA,Virginia,King George,51099,3643,3278,365,3111,13,3098,532,23,509,3165,2800,365,1593,1254,339,455,79,15,1044
9/1/2016,VA,Virginia,King William,51101,3133,2698,435,2670,22,2648,463,24,439,2896,2461,435,2279,1886,393,376,104,21,1778
9/1/2016,VA,Virginia,Lancaster,51103,4227,3700,527,3889,14,3875,338,11,327,4032,3505,527,2848,2484,364,487,93,25,2243
9/1/2016,VA,Virginia,Lee,51105,6306,4028,2278,4246,16,4230,2060,11,2049,6005,3728,2277,4844,2690,2154,1929,245,73,2597
9/1/2016,VA,Virginia,Lexington City,51678,1599,1446,153,1463,15,1448,136,*,*,1491,1338,153,1122,995,127,210,*,*,874
9/1/2016,VA,Virginia,Loudoun,51107,33046,28279,4767,30720,108,30612,2326,110,2216,27484,22727,4757,17688,13339,4349,2856,611,136,14085
9/1/2016,VA,Virginia,Louisa,51109,7430,6217,1213,6209,36,6173,1221,33,1188,6841,5628,1213,5007,3882,1125,1068,243,71,3625
9/1/2016,VA,Virginia,Lunenburg,51111,2968,2579,389,2408,16,2392,560,22,538,2747,2358,389,2036,1676,360,694,121,44,1177
9/1/2016,VA,Virginia,Lynchburg City,51680,14610,12433,2177,11595,86,11509,3015,103,2912,13600,11423,2177,10953,8974,1979,3307,428,147,7071
9/1/2016,VA,Virginia,Madison,51113,2868,2490,378,2524,*,*,344,*,*,2679,2301,378,1928,1589,339,384,89,27,1428
9/1/2016,VA,Virginia,Manassas City,51683,4240,3547,693,3690,33,3657,550,39,511,3579,2886,693,2444,1789,655,528,90,34,1792
9/1/2016,VA,Virginia,Manassas Park City,51685,1184,976,208,1014,11,1003,170,15,155,999,792,207,695,504,191,185,56,13,441
9/1/2016,VA,Virginia,Martinsville City,51690,3935,3064,871,2935,26,2909,1000,41,959,3718,2847,871,3178,2446,732,1289,165,58,1666
9/1/2016,VA,Virginia,Mathews,51115,2780,2391,389,2544,*,*,236,*,*,2636,2247,389,1783,1453,330,258,39,19,1467
9/1/2016,VA,Virginia,Mecklenburg,51117,8955,7501,1454,7354,52,7302,1601,52,1549,8472,7018,1454,6578,5401,1177,1908,372,112,4186
9/1/2016,VA,Virginia,Middlesex,51119,3492,2992,500,3103,22,3081,389,*,*,3287,2787,500,2470,2103,367,441,85,31,1913
9/1/2016,VA,Virginia,Montgomery,51121,13210,10955,2255,10871,42,10829,2339,37,2302,11975,9720,2255,9564,7425,2139,1839,313,110,7302
9/1/2016,VA,Virginia,Nelson,51125,4340,3777,563,3808,16,3792,532,11,521,3996,3433,563,2894,2379,515,584,96,44,2170
9/1/2016,VA,Virginia,New Kent,51127,4035,3386,649,3577,15,3562,458,*,*,3680,3031,649,2526,2001,525,286,74,15,2151
9/1/2016,VA,Virginia,Newport News City,51700,26772,20284,6488,21835,168,21667,4937,247,4690,24517,18031,6486,15725,9464,6261,4604,801,229,10091
9/1/2016,VA,Virginia,Norfolk City,51710,31514,23892,7622,24913,259,24654,6601,345,6256,28433,20811,7622,18669,11308,7361,6918,1292,282,10177
9/1/2016,VA,Virginia,Northampton,51131,3493,2933,560,2964,25,2939,529,24,505,3275,2715,560,2594,2084,510,919,93,33,1549
9/1/2016,VA,Virginia,Northumberland,51133,4544,3969,575,4202,15,4187,342,*,*,4243,3668,575,2760,2395,365,408,90,35,2227
9/1/2016,VA,Virginia,Norton City,51720,1176,858,318,780,*,*,396,*,*,1095,777,318,871,573,298,355,45,19,452
9/1/2016,VA,Virginia,Nottoway,51135,3648,3001,647,2946,31,2915,702,16,686,3399,2752,647,2631,2200,431,942,129,40,1520
9/1/2016,VA,Virginia,Orange,51137,8351,7387,964,7337,41,7296,1014,37,977,7686,6722,964,4919,4201,718,946,211,69,3693
9/1/2016,VA,Virginia,Page,51139,5977,5260,717,4843,19,4824,1134,16,1118,5608,4891,717,4084,3461,623,1133,212,89,2650
9/1/2016,VA,Virginia,Patrick,51141,5077,3838,1239,4163,*,*,914,12,902,4833,3595,1238,3896,2829,1067,1007,201,82,2606
9/1/2016,VA,Virginia,Petersburg City,51730,7101,5395,1706,5228,99,5129,1873,82,1791,6504,4798,1706,4626,2963,1663,1996,341,67,2222
9/1/2016,VA,Virginia,Pittsylvania,51143,15738,12334,3404,12794,99,12695,2944,77,2867,14894,11490,3404,12147,9664,2483,3093,559,211,8284
9/1/2016,VA,Virginia,Poquoson City,51735,2454,2176,278,2282,*,*,172,*,*,2260,1982,278,1099,844,255,92,27,13,967
9/1/2016,VA,Virginia,Portsmouth City,51740,17648,13253,4395,13594,171,13423,4054,207,3847,15810,11417,4393,10280,6044,4236,3834,667,147,5632
9/1/2016,VA,Virginia,Powhatan,51145,5558,4480,1078,4931,17,4914,627,14,613,5101,4023,1078,3955,2991,964,391,112,29,3423
9/1/2016,VA,Virginia,Prince Edward,51147,4569,3777,792,3644,25,3619,925,33,892,4240,3448,792,3237,2629,608,1073,171,46,1947
9/1/2016,VA,Virginia,Prince George,51149,5592,4893,699,4714,26,4688,878,23,855,5161,4462,699,3052,2407,645,582,112,23,2335
9/1/2016,VA,Virginia,Prince William,51153,43916,36554,7362,38909,236,38673,5007,287,4720,37583,30226,7357,21345,14450,6895,4970,950,214,15211
9/1/2016,VA,Virginia,Pulaski,51155,8932,7305,1627,7018,28,6990,1914,26,1888,8354,6727,1627,6366,4830,1536,1658,322,116,4270
9/1/2016,VA,Virginia,Radford City,51750,2009,1643,366,1612,*,*,397,*,*,1844,1478,366,1520,1169,351,339,40,21,1120
9/1/2016,VA,Virginia,Rappahannock,51157,1976,1815,161,1820,*,*,156,*,*,1790,1630,160,1188,1054,134,163,35,11,979
9/1/2016,VA,Virginia,Richmond,51159,1909,1551,358,1649,15,1634,260,15,245,1785,1427,358,1308,1059,249,305,88,21,894
9/1/2016,VA,Virginia,Richmond City,51760,32475,22530,9945,25288,271,25017,7187,348,6839,29229,19284,9945,24006,14418,9588,8546,1359,312,13789
9/1/2016,VA,Virginia,Roanoke,51161,22579,18173,4406,19929,86,19843,2650,52,2598,20935,16530,4405,16392,12368,4024,1962,420,153,13857
9/1/2016,VA,Virginia,Roanoke City,51770,19988,14542,5446,14852,134,14718,5136,141,4995,18342,12898,5444,14644,9430,5214,4770,847,209,8818
9/1/2016,VA,Virginia,Rockbridge,51163,5739,4865,874,4830,18,4812,909,*,*,5359,4485,874,3977,3257,720,845,171,60,2901
9/1/2016,VA,Virginia,Rockingham,51165,16529,14111,2418,14426,40,14386,2103,43,2060,15288,12870,2418,11664,9934,1730,1766,502,165,9231
9/1/2016,VA,Virginia,Russell,51167,7674,5203,2471,5136,12,5124,2538,*,*,7352,4881,2471,6219,4158,2061,1675,309,128,4107
9/1/2016,VA,Virginia,Salem City,51775,5898,4839,1059,4943,30,4913,955,20,935,5431,4372,1059,4228,3250,978,830,147,39,3212
9/1/2016,VA,Virginia,Scott,51169,6531,3363,3168,4837,*,*,1694,13,1681,6273,3105,3168,5397,2279,3118,1539,245,123,3490
9/1/2016,VA,Virginia,Shenandoah,51171,10095,8939,1156,8839,22,8817,1256,25,1231,9486,8330,1156,6588,5617,971,1289,236,101,4962
9/1/2016,VA,Virginia,Smyth,51173,8753,6816,1937,6447,18,6429,2306,23,2283,8244,6307,1937,6643,4905,1738,2178,399,143,3923
9/1/2016,VA,Virginia,Southampton,51175,4015,3388,627,3320,28,3292,695,25,670,3751,3124,627,2898,2345,553,754,132,35,1977
9/1/2016,VA,Virginia,Spotsylvania,51177,19236,16931,2305,16602,104,16498,2634,90,2544,17146,14842,2304,10265,8271,1994,1923,480,141,7721
9/1/2016,VA,Virginia,Stafford,51179,15622,14199,1423,13693,79,13614,1929,85,1844,13728,12305,1423,6893,5648,1245,1304,346,77,5166
9/1/2016,VA,Virginia,Staunton City,51790,5897,5060,837,4807,20,4787,1090,25,1065,5544,4707,837,4282,3556,726,1059,149,61,3013
9/1/2016,VA,Virginia,Suffolk City,51800,14978,12016,2962,12125,83,12042,2853,96,2757,13731,10769,2962,9405,6664,2741,2651,440,108,6206
9/1/2016,VA,Virginia,Surry,51181,1519,1173,346,1270,11,1259,249,12,237,1399,1053,346,1015,692,323,206,76,13,720
9/1/2016,VA,Virginia,Sussex,51183,2312,1800,512,1876,28,1848,436,*,*,2152,1640,512,1656,1174,482,490,137,17,1012
9/1/2016,VA,Virginia,Tazewell,51185,11719,8560,3159,8534,30,8504,3185,38,3147,11087,7930,3157,8671,6657,2014,2255,434,181,5801
9/1/2016,VA,Virginia,Unknown,51999,*,*,*,*,*,*,*,*,*,*,*,*,*,*,*,*,*,*,*
9/1/2016,VA,Virginia,Virginia Beach City,51810,66543,55775,10768,58417,316,58101,8126,336,7790,61027,50265,10762,33945,23855,10090,6601,1335,365,25644
9/1/2016,VA,Virginia,Warren,51187,7075,6408,667,6025,23,6002,1050,26,1024,6451,5784,667,4291,3729,562,859,228,76,3128
9/1/2016,VA,Virginia,Washington,51191,14722,10032,4690,11637,46,11591,3085,26,3059,13876,9187,4689,11118,6783,4335,2488,519,170,7941
9/1/2016,VA,Virginia,Waynesboro City,51820,4729,4004,725,3843,17,3826,886,22,864,4433,3708,725,3492,2858,634,873,112,44,2463
9/1/2016,VA,Virginia,Westmoreland,51193,4698,4080,618,4100,23,4077,598,11,587,4314,3696,618,2674,2140,534,735,122,49,1768
9/1/2016,VA,Virginia,Williamsburg City,51830,2506,2136,370,2290,*,*,216,*,*,2296,1927,369,1584,1271,313,213,*,*,1334
9/1/2016,VA,Virginia,Winchester City,51840,5019,4479,540,4251,20,4231,768,18,750,4572,4032,540,3261,2801,460,835,125,49,2252
9/1/2016,VA,Virginia,Wise,51195,10442,6927,3515,6873,17,6856,3569,23,3546,9872,6358,3514,7738,4413,3325,2456,467,160,4655
9/1/2016,VA,Virginia,Wythe,51197,7394,5723,1671,5709,30,5679,1685,20,1665,6992,5321,1671,5389,3917,1472,1478,267,109,3535
9/1/2016,VA,Virginia,York,51199,11029,9712,1317,10098,37,10061,931,28,903,10110,8795,1315,5254,4039,1215,612,165,41,4436
4/1/2017,VA,Virginia,Accomack,51001,8540,7182,1358,7347,50,7297,1193,46,1147,7943,6585,1358,5829,4777,1052,1464,381,91,3893
4/1/2017,VA,Virginia,Albemarle,51003,19567,17366,2201,18007,64,17943,1560,51,1509,17550,15349,2201,13301,11384,1917,1496,306,93,11406
4/1/2017,VA,Virginia,Alexandria City,51510,16990,14528,2462,15597,81,15516,1393,91,1302,13682,11224,2458,8173,5891,2282,2049,313,58,5753
4/1/2017,VA,Virginia,Alleghany,51005,4485,3839,646,3632,22,3610,853,14,839,4246,3600,646,3391,2899,492,772,105,52,2462
4/1/2017,VA,Virginia,Amelia,51007,2981,2291,690,2512,12,2500,469,*,*,2744,2054,690,2153,1532,621,461,81,35,1576
4/1/2017,VA,Virginia,Amherst,51009,7606,6307,1299,6347,50,6297,1259,28,1231,7072,5773,1299,5682,4548,1134,1171,235,71,4205
4/1/2017,VA,Virginia,Appomattox,51011,3753,3140,613,3075,14,3061,678,19,659,3533,2920,613,2845,2308,537,651,97,36,2061
4/1/2017,VA,Virginia,Arlington,51013,23284,20225,3059,21698,97,21601,1586,93,1493,18358,15299,3059,10912,8092,2820,2881,336,103,7592
4/1/2017,VA,Virginia,Augusta,51015,17559,14992,2567,15176,56,15120,2383,42,2341,16522,13955,2567,12587,10526,2061,1756,405,144,10282
4/1/2017,VA,Virginia,Bath,51017,1259,1150,109,1115,*,*,144,*,*,1183,1074,109,920,828,92,168,38,24,690
4/1/2017,VA,Virginia,Bedford,51019,19009,15515,3494,16252,85,16167,2757,52,2705,17668,14176,3492,13696,11147,2549,1928,471,163,11134
4/1/2017,VA,Virginia,Bland,51021,1769,1372,397,1391,*,*,378,*,*,1667,1270,397,1247,1031,216,253,51,18,925
4/1/2017,VA,Virginia,Botetourt,51023,8349,6419,1930,7230,45,7185,1119,17,1102,7718,5788,1930,6059,4383,1676,824,180,53,5002
4/1/2017,VA,Virginia,Bristol City,51520,4501,2685,1816,3485,17,3468,1016,12,1004,4214,2398,1816,3547,1800,1747,1054,149,47,2297
4/1/2017,VA,Virginia,Brunswick,51025,3904,3188,716,3206,26,3180,698,23,675,3657,2941,716,2861,2234,627,1102,102,40,1617
4/1/2017,VA,Virginia,Buchanan,51027,7276,4386,2890,4551,20,4531,2725,15,2710,6977,4087,2890,5812,3741,2071,1603,420,112,3677
4/1/2017,VA,Virginia,Buckingham,51029,3413,2773,640,2780,18,2762,633,17,616,3188,2548,640,2436,2034,402,724,140,47,1525
4/1/2017,VA,Virginia,Buena Vista City,51530,1443,1172,271,1165,*,*,278,*,*,1353,1082,271,1054,832,222,333,54,19,648
4/1/2017,VA,Virginia,Campbell,51031,12384,10308,2076,10251,81,10170,2133,62,2071,11592,9516,2076,9355,7546,1809,2059,375,164,6757
4/1/2017,VA,Virginia,Caroline,51033,5611,4621,990,4687,33,4654,924,39,885,5059,4069,990,3442,2574,868,777,232,57,2376
4/1/2017,VA,Virginia,Carroll,51035,7969,6792,1177,6444,24,6420,1525,13,1512,7516,6339,1177,5830,4898,932,1609,292,109,3820
4/1/2017,VA,Virginia,Charles City,51036,1853,1429,424,1578,19,1559,275,11,264,1698,1274,424,1302,948,354,255,79,17,951
4/1/2017,VA,Virginia,Charlotte,51037,3330,2784,546,2693,14,2679,637,17,620,3146,2600,546,2486,2017,469,784,135,51,1516
4/1/2017,VA,Virginia,Charlottesville City,51540,6065,5284,781,4979,31,4948,1086,49,1037,5422,4642,780,4312,3577,735,1218,158,46,2890
4/1/2017,VA,Virginia,Chesapeake City,51550,35764,28412,7352,30663,279,30384,5101,221,4880,32312,24960,7352,19849,13316,6533,4010,891,244,14704
4/1/2017,VA,Virginia,Chesterfield,51041,56316,42765,13551,49008,191,48817,7308,248,7060,50726,37178,13548,38791,26746,12045,5201,1025,283,32282
4/1/2017,VA,Virginia,Clarke,51043,3121,2767,354,2878,13,2865,243,*,*,2820,2466,354,1898,1625,273,251,72,28,1547
4/1/2017,VA,Virginia,Colonial Heights City,51570,4118,3430,688,3515,*,*,603,16,587,3787,3099,688,2445,1858,587,487,99,23,1836
4/1/2017,VA,Virginia,Covington City,51580,1645,1402,243,1274,13,1261,371,*,*,1535,1292,243,1217,990,227,358,54,20,785
4/1/2017,VA,Virginia,Craig,51045,1305,1025,280,1025,*,*,280,0,280,1201,921,280,942,677,265,197,45,11,689
4/1/2017,VA,Virginia,Culpeper,51047,8874,7550,1324,7667,42,7625,1207,42,1165,8044,6720,1324,5565,4511,1054,1135,249,65,4116
4/1/2017,VA,Virginia,Cumberland,51049,2233,1720,513,1862,*,*,371,*,*,2063,1550,513,1603,1149,454,411,95,33,1064
4/1/2017,VA,Virginia,Danville City,51590,11089,8924,2165,8724,85,8639,2365,118,2247,10455,8290,2165,8695,7268,1427,3205,435,158,4897
4/1/2017,VA,Virginia,Dickenson,51051,4739,2924,1815,2973,*,*,1766,12,1754,4507,2692,1815,3707,2093,1614,1109,207,77,2314
4/1/2017,VA,Virginia,Dinwiddie,51053,5695,4487,1208,4570,37,4533,1125,31,1094,5217,4009,1208,3845,2728,1117,891,186,51,2717
4/1/2017,VA,Virginia,Emporia City,51595,1139,873,266,880,16,864,259,12,247,1061,795,266,868,651,217,408,69,11,380
4/1/2017,VA,Virginia,Essex,51057,2841,2315,526,2415,18,2397,426,14,412,2640,2114,526,1973,1578,395,431,90,20,1432
4/1/2017,VA,Virginia,Fairfax,51059,142406,122329,20077,134361,552,133809,8045,431,7614,114853,94810,20043,66457,48087,18370,13096,2655,494,50212
4/1/2017,VA,Virginia,Fairfax City,51600,3667,3118,549,3393,13,3380,274,*,*,3058,2509,549,1845,1353,492,362,*,*,1414
4/1/2017,VA,Virginia,Falls Church City,51610,1855,1602,253,1766,*,*,89,*,*,1440,1187,253,875,641,234,125,*,*,727
4/1/2017,VA,Virginia,Fauquier,51061,11952,10628,1324,10864,60,10804,1088,39,1049,10595,9271,1324,6681,5608,1073,933,195,58,5495
4/1/2017,VA,Virginia,Floyd,51063,3918,3150,768,3381,15,3366,537,*,*,3648,2880,768,2849,2144,705,542,98,42,2167
4/1/2017,VA,Virginia,Fluvanna,51065,5612,4859,753,5033,21,5012,579,21,558,5125,4372,753,3735,3112,623,507,124,31,3073
4/1/2017,VA,Virginia,Franklin,51067,14181,10362,3819,11825,49,11776,2356,29,2327,13307,9489,3818,10780,7260,3520,1937,473,149,8221
4/1/2017,VA,Virginia,Franklin City,51620,1921,1591,330,1502,23,1479,419,23,396,1800,1470,330,1473,1170,303,562,62,14,835
4/1/2017,VA,Virginia,Frederick,51069,15610,13793,1817,13862,56,13806,1748,52,1696,14230,12414,1816,9728,8324,1404,1437,346,136,7809
4/1/2017,VA,Virginia,Fredericksburg City,51630,3892,3370,522,3189,22,3167,703,31,672,3513,2991,522,2410,1938,472,765,92,36,1517
4/1/2017,VA,Virginia,Galax City,51640,1882,1739,143,1486,*,*,396,*,*,1785,1642,143,1418,1308,110,638,58,32,690
4/1/2017,VA,Virginia,Giles,51071,4548,3460,1088,3601,24,3577,947,18,929,4273,3186,1087,3472,2769,703,789,124,32,2527
4/1/2017,VA,Virginia,Gloucester,51073,8118,6721,1397,6946,38,6908,1172,19,1153,7519,6122,1397,4763,3581,1182,944,178,44,3597
4/1/2017,VA,Virginia,Goochland,51075,5429,4277,1152,4953,22,4931,476,22,454,4910,3758,1152,4005,3079,926,407,103,35,3460
4/1/2017,VA,Virginia,Grayson,51077,4611,3950,661,3778,*,*,833,12,821,4394,3733,661,3293,2745,548,980,178,90,2045
4/1/2017,VA,Virginia,Greene,51079,3556,3091,465,3108,13,3095,448,*,*,3248,2783,465,2335,1935,400,449,84,24,1778
4/1/2017,VA,Virginia,Greensville,51081,2433,1825,608,1944,20,1924,489,16,473,2271,1663,608,1854,1363,491,529,126,26,1173
4/1/2017,VA,Virginia,Halifax,51083,9468,8154,1314,7756,70,7686,1712,56,1656,8942,7628,1314,7182,6040,1142,2116,452,140,4474
4/1/2017,VA,Virginia,Hampton City,51650,24241,18211,6030,19952,201,19751,4289,190,4099,22091,16061,6030,13349,7751,5598,3493,794,171,8891
4/1/2017,VA,Virginia,Hanover,51085,19846,15081,4765,18003,83,17920,1843,47,1796,18060,13296,4764,14411,10553,3858,1341,367,96,12607
4/1/2017,VA,Virginia,Harrisonburg City,51660,5152,4569,583,4364,16,4348,788,22,766,4659,4076,583,3650,3227,423,937,125,34,2554
4/1/2017,VA,Virginia,Henrico,51087,53913,39824,14089,46998,338,46660,6915,290,6625,48719,34632,14087,39075,26987,12088,6017,1405,395,31258
4/1/2017,VA,Virginia,Henry,51089,14976,10778,4198,11906,78,11828,3070,54,3016,14243,10045,4198,12017,8137,3880,2981,708,243,8085
4/1/2017,VA,Virginia,Highland,51091,756,682,74,693,*,*,63,*,*,708,634,74,529,462,67,63,*,*,438
4/1/2017,VA,Virginia,Hopewell City,51670,4468,3542,926,3434,31,3403,1034,30,1004,4146,3220,926,2834,1953,881,956,154,32,1692
4/1/2017,VA,Virginia,Isle of Wight,51093,7817,6115,1702,6848,51,6797,969,33,936,7226,5524,1702,5131,3603,1528,936,197,58,3940
4/1/2017,VA,Virginia,James City,51095,19513,16980,2533,18343,59,18284,1170,55,1115,17994,15464,2530,11422,9468,1954,818,216,55,10333
4/1/2017,VA,Virginia,King and Queen,51097,1699,1395,304,1424,11,1413,275,*,*,1583,1279,304,1166,904,262,266,68,15,817
4/1/2017,VA,Virginia,King George,51099,3685,3291,394,3177,16,3161,508,30,478,3204,2810,394,1628,1289,339,459,84,13,1072
4/1/2017,VA,Virginia,King William,51101,3229,2709,520,2770,26,2744,459,24,435,2971,2451,520,2387,1944,443,376,114,24,1873
4/1/2017,VA,Virginia,Lancaster,51103,4257,3675,582,3910,17,3893,347,14,333,4054,3472,582,2918,2518,400,484,98,18,2318
4/1/2017,VA,Virginia,Lee,51105,6327,3874,2453,4338,19,4319,1989,11,1978,6003,3552,2451,4881,2598,2283,1897,244,75,2665
4/1/2017,VA,Virginia,Lexington City,51678,1607,1447,160,1470,11,1459,137,*,*,1491,1331,160,1139,1010,129,214,*,*,885
4/1/2017,VA,Virginia,Loudoun,51107,34326,28931,5395,31978,143,31835,2348,110,2238,28444,23055,5389,18732,13928,4804,2902,651,155,15024
4/1/2017,VA,Virginia,Louisa,51109,7622,6275,1347,6418,38,6380,1204,34,1170,6973,5626,1347,5120,3934,1186,1020,244,73,3783
4/1/2017,VA,Virginia,Lunenburg,51111,2962,2555,407,2427,15,2412,535,22,513,2737,2330,407,2054,1703,351,705,116,45,1188
4/1/2017,VA,Virginia,Lynchburg City,51680,14464,12168,2296,11808,85,11723,2656,107,2549,13408,11112,2296,10866,8877,1989,2979,437,131,7319
4/1/2017,VA,Virginia,Madison,51113,2908,2482,426,2579,15,2564,329,12,317,2713,2287,426,2002,1648,354,388,91,24,1499
4/1/2017,VA,Virginia,Manassas City,51683,4276,3469,807,3745,33,3712,531,40,491,3616,2809,807,2472,1741,731,512,89,32,1839
4/1/2017,VA,Virginia,Manassas Park City,51685,1225,968,257,1058,13,1045,167,13,154,1033,777,256,715,485,230,181,*,*,479
4/1/2017,VA,Virginia,Martinsville City,51690,3909,2895,1014,2917,29,2888,992,41,951,3691,2677,1014,3155,2186,969,1284,170,64,1637
4/1/2017,VA,Virginia,Mathews,51115,2789,2352,437,2561,11,2550,228,*,*,2635,2198,437,1814,1468,346,254,39,19,1502
4/1/2017,VA,Virginia,Mecklenburg,51117,9011,7128,1883,7452,60,7392,1559,58,1501,8493,6610,1883,6659,5099,1560,1880,380,113,4286
4/1/2017,VA,Virginia,Middlesex,51119,3493,2950,543,3122,20,3102,371,*,*,3287,2744,543,2487,2094,393,437,89,28,1933
4/1/2017,VA,Virginia,Montgomery,51121,13478,11039,2439,11103,43,11060,2375,39,2336,12200,9761,2439,9863,7627,2236,1914,324,119,7506
4/1/2017,VA,Virginia,Nelson,51125,4408,3823,585,3900,18,3882,508,*,*,4046,3461,585,2953,2444,509,585,101,43,2224
4/1/2017,VA,Virginia,New Kent,51127,4186,3424,762,3736,21,3715,450,*,*,3798,3036,762,2651,2070,581,270,81,15,2285
4/1/2017,VA,Virginia,Newport News City,51700,27050,20042,7008,22213,197,22016,4837,243,4594,24727,17721,7006,16073,9505,6568,4558,836,226,10453
4/1/2017,VA,Virginia,Norfolk City,51710,31899,23594,8305,25400,275,25125,6499,335,6164,28741,20437,8304,19279,11417,7862,6994,1353,276,10656
4/1/2017,VA,Virginia,Northampton,51131,3530,2923,607,3008,25,2983,522,26,496,3294,2687,607,2617,2113,504,906,88,30,1593
4/1/2017,VA,Virginia,Northumberland,51133,4564,3929,635,4240,13,4227,324,*,*,4244,3609,635,2807,2429,378,402,90,33,2282
4/1/2017,VA,Virginia,Norton City,51720,1172,803,369,788,*,*,384,*,*,1089,720,369,883,557,326,341,50,19,473
4/1/2017,VA,Virginia,Nottoway,51135,3631,2974,657,2954,29,2925,677,15,662,3375,2718,657,2641,2193,448,914,137,39,1551
4/1/2017,VA,Virginia,Orange,51137,8499,7398,1101,7494,47,7447,1005,37,968,7799,6698,1101,5110,4351,759,940,213,64,3893
4/1/2017,VA,Virginia,Page,51139,6068,5323,745,4953,22,4931,1115,19,1096,5694,4949,745,4153,3528,625,1112,228,82,2731
4/1/2017,VA,Virginia,Patrick,51141,5095,3833,1262,4211,11,4200,884,11,873,4843,3582,1261,3938,2871,1067,995,203,75,2665
4/1/2017,VA,Virginia,Petersburg City,51730,7124,5292,1832,5279,100,5179,1845,88,1757,6481,4649,1832,4682,2921,1761,1984,351,59,2288
4/1/2017,VA,Virginia,Pittsylvania,51143,15871,12348,3523,13014,106,12908,2857,78,2779,14964,11441,3523,12251,9725,2526,3028,565,216,8442
4/1/2017,VA,Virginia,Poquoson City,51735,2481,2181,300,2312,*,*,169,*,*,2287,1987,300,1131,874,257,96,25,14,996
4/1/2017,VA,Virginia,Portsmouth City,51740,17730,13036,4694,13778,183,13595,3952,205,3747,15849,11157,4692,10485,6034,4451,3763,711,139,5872
4/1/2017,VA,Virginia,Powhatan,51145,5622,4437,1185,5024,24,5000,598,13,585,5164,3979,1185,4088,3088,1000,390,111,31,3556
4/1/2017,VA,Virginia,Prince Edward,51147,4584,3749,835,3695,38,3657,889,36,853,4252,3417,835,3278,2652,626,1074,163,47,1994
4/1/2017,VA,Virginia,Prince George,51149,5649,4876,773,4798,30,4768,851,31,820,5223,4450,773,3126,2450,676,533,129,26,2438
4/1/2017,VA,Virginia,Prince William,51153,45121,37032,8089,40133,284,39849,4988,300,4688,38374,30289,8085,22185,14783,7402,4954,979,218,16034
4/1/2017,VA,Virginia,Pulaski,51155,8928,7207,1721,7106,36,7070,1822,30,1792,8325,6604,1721,6373,4805,1568,1604,322,116,4331
4/1/2017,VA,Virginia,Radford City,51750,2020,1633,387,1620,*,*,400,*,*,1856,1469,387,1531,1184,347,339,41,19,1132
4/1/2017,VA,Virginia,Rappahannock,51157,1991,1825,166,1845,*,*,146,*,*,1792,1627,165,1183,1056,127,152,*,*,987
4/1/2017,VA,Virginia,Richmond,51159,1968,1583,385,1711,15,1696,257,13,244,1824,1439,385,1351,1093,258,289,87,20,955
4/1/2017,VA,Virginia,Richmond City,51760,33016,22135,10881,25877,291,25586,7139,340,6799,29659,18778,10881,24831,14536,10295,8627,1422,285,14497
4/1/2017,VA,Virginia,Roanoke,51161,22898,17994,4904,20352,106,20246,2546,55,2491,21194,16291,4903,16821,12538,4283,1932,436,140,14313
4/1/2017,VA,Virginia,Roanoke City,51770,20177,14395,5782,15102,139,14963,5075,148,4927,18424,12643,5781,14869,9463,5406,4697,861,209,9102
4/1/2017,VA,Virginia,Rockbridge,51163,5822,4895,927,4943,25,4918,879,*,*,5406,4479,927,4054,3293,761,811,183,72,2988
4/1/2017,VA,Virginia,Rockingham,51165,16834,14260,2574,14736,47,14689,2098,37,2061,15579,13005,2574,12016,10177,1839,1782,503,146,9585
4/1/2017,VA,Virginia,Russell,51167,7718,5118,2600,5256,19,5237,2462,13,2449,7380,4780,2600,6293,4139,2154,1654,307,127,4205
4/1/2017,VA,Virginia,Salem City,51775,5996,4771,1225,5054,31,5023,942,18,924,5499,4274,1225,4353,3262,1091,831,144,36,3342
4/1/2017,VA,Virginia,Scott,51169,6571,3339,3232,4925,11,4914,1646,13,1633,6298,3067,3231,5450,2282,3168,1499,247,124,3580
4/1/2017,VA,Virginia,Shenandoah,51171,10205,8992,1213,8986,27,8959,1219,26,1193,9542,8329,1213,6681,5722,959,1245,258,100,5078
4/1/2017,VA,Virginia,Smyth,51173,8810,6745,2065,6553,28,6525,2257,24,2233,8293,6228,2065,6732,4899,1833,2153,406,134,4039
4/1/2017,VA,Virginia,Southampton,51175,4016,3352,664,3346,30,3316,670,19,651,3739,3075,664,2931,2359,572,725,127,33,2046
4/1/2017,VA,Virginia,Spotsylvania,51177,19719,17091,2628,17094,111,16983,2625,95,2530,17522,14895,2627,10584,8442,2142,1905,499,133,8047
4/1/2017,VA,Virginia,Stafford,51179,16146,14504,1642,14222,97,14125,1924,84,1840,14133,12491,1642,7144,5779,1365,1305,359,75,5405
4/1/2017,VA,Virginia,Staunton City,51790,5979,5125,854,4946,24,4922,1033,22,1011,5608,4754,854,4368,3665,703,1042,157,64,3105
4/1/2017,VA,Virginia,Suffolk City,51800,15359,12112,3247,12571,102,12469,2788,98,2690,14044,10797,3247,9658,6736,2922,2597,453,103,6505
4/1/2017,VA,Virginia,Surry,51181,1523,1180,343,1286,*,*,237,*,*,1412,1069,343,1024,710,314,206,64,14,740
4/1/2017,VA,Virginia,Sussex,51183,2331,1781,550,1907,30,1877,424,*,*,2169,1619,550,1668,1155,513,473,141,19,1035
4/1/2017,VA,Virginia,Tazewell,51185,11797,8389,3408,8692,36,8656,3105,40,3065,11153,7747,3406,8819,6587,2232,2245,449,183,5942
4/1/2017,VA,Virginia,Unknown,51999,*,*,*,*,*,*,*,*,*,*,*,*,*,*,*,*,*,*,*
4/1/2017,VA,Virginia,Virginia Beach City,51810,67911,55943,11968,59829,365,59464,8082,338,7744,62135,50174,11961,35124,24359,10765,6553,1418,356,26797
4/1/2017,VA,Virginia,Warren,51187,7259,6517,742,6214,31,6183,1045,29,1016,6606,5864,742,4460,3866,594,874,236,74,3276
4/1/2017,VA,Virginia,Washington,51191,14762,9889,4873,11809,48,11761,2953,30,2923,13876,9004,4872,11232,6746,4486,2432,522,164,8114
4/1/2017,VA,Virginia,Waynesboro City,51820,4681,3964,717,3821,15,3806,860,25,835,4362,3645,717,3452,2837,615,862,115,37,2438
4/1/2017,VA,Virginia,Westmoreland,51193,4779,4095,684,4190,26,4164,589,11,578,4371,3687,684,2759,2197,562,718,135,50,1856
4/1/2017,VA,Virginia,Williamsburg City,51830,2522,2123,399,2307,*,*,215,*,*,2318,1920,398,1623,1295,328,230,*,*,1355
4/1/2017,VA,Virginia,Winchester City,51840,5042,4491,551,4286,22,4264,756,18,738,4560,4009,551,3293,2859,434,828,133,52,2280
4/1/2017,VA,Virginia,Wise,51195,10497,6702,3795,7042,23,7019,3455,22,3433,9889,6094,3795,7801,4343,3458,2399,475,165,4762
4/1/2017,VA,Virginia,Wythe,51197,7465,5683,1782,5816,34,5782,1649,20,1629,7037,5255,1782,5488,3939,1549,1487,268,101,3632
4/1/2017,VA,Virginia,York,51199,11287,9760,1527,10353,37,10316,934,29,905,10329,8802,1527,5475,4190,1285,646,161,42,4626
8/1/2017,VA,Virginia,Accomack,51001,8626,7276,1350,7412,48,7364,1214,47,1167,8034,6684,1350,5879,4834,1045,1504,378,92,3905
8/1/2017,VA,Virginia,Albemarle,51003,19801,17633,2168,18223,57,18166,1578,49,1529,17779,15611,2168,13454,11574,1880,1512,297,99,11546
8/1/2017,VA,Virginia,Alexandria City,51510,17289,14842,2447,15868,79,15789,1421,92,1329,13971,11528,2443,8317,6049,2268,2118,315,58,5826
8/1/2017,VA,Virginia,Alleghany,51005,4478,3849,629,3615,19,3596,863,14,849,4246,3617,629,3392,2914,478,792,102,48,2450
8/1/2017,VA,Virginia,Amelia,51007,3008,2313,695,2528,11,2517,480,*,*,2779,2084,695,2166,1541,625,464,84,34,1584
8/1/2017,VA,Virginia,Amherst,51009,7670,6380,1290,6386,49,6337,1284,29,1255,7123,5833,1290,5738,4612,1126,1229,226,74,4209
8/1/2017,VA,Virginia,Appomattox,51011,3769,3163,606,3082,14,3068,687,19,668,3547,2941,606,2853,2322,531,667,103,35,2048
8/1/2017,VA,Virginia,Arlington,51013,23587,20512,3075,21970,88,21882,1617,95,1522,18653,15578,3075,11066,8230,2836,2924,342,107,7693
8/1/2017,VA,Virginia,Augusta,51015,17750,15231,2519,15320,51,15269,2430,43,2387,16700,14181,2519,12693,10674,2019,1801,410,142,10340
8/1/2017,VA,Virginia,Bath,51017,1263,1158,105,1115,*,*,148,*,*,1187,1082,105,917,827,90,166,37,25,689
8/1/2017,VA,Virginia,Bedford,51019,19174,15728,3446,16402,82,16320,2772,48,2724,17848,14404,3444,13807,11304,2503,1965,483,162,11197
8/1/2017,VA,Virginia,Bland,51021,1782,1380,402,1397,*,*,385,*,*,1697,1295,402,1253,1031,222,250,50,16,937
8/1/2017,VA,Virginia,Botetourt,51023,8418,6500,1918,7287,42,7245,1131,16,1115,7805,5887,1918,6101,4441,1660,831,179,52,5039
8/1/2017,VA,Virginia,Bristol City,51520,4520,2695,1825,3491,14,3477,1029,11,1018,4245,2420,1825,3565,1809,1756,1069,152,50,2294
8/1/2017,VA,Virginia,Brunswick,51025,3944,3233,711,3233,21,3212,711,23,688,3702,2991,711,2887,2269,618,1120,107,40,1620
8/1/2017,VA,Virginia,Buchanan,51027,7280,4379,2901,4529,18,4511,2751,15,2736,7015,4114,2901,5813,3729,2084,1627,410,114,3662
8/1/2017,VA,Virginia,Buckingham,51029,3440,2796,644,2790,18,2772,650,22,628,3225,2581,644,2465,2056,409,739,146,45,1535
8/1/2017,VA,Virginia,Buena Vista City,51530,1440,1172,268,1159,*,*,281,*,*,1345,1077,268,1052,831,221,331,51,19,651
8/1/2017,VA,Virginia,Campbell,51031,12493,10432,2061,10330,76,10254,2163,62,2101,11707,9646,2061,9415,7621,1794,2099,379,162,6775
8/1/2017,VA,Virginia,Caroline,51033,5669,4688,981,4723,31,4692,946,39,907,5132,4151,981,3477,2617,860,809,231,56,2381
8/1/2017,VA,Virginia,Carroll,51035,8012,6832,1180,6473,24,6449,1539,13,1526,7575,6395,1180,5840,4905,935,1631,282,106,3821
8/1/2017,VA,Virginia,Charles City,51036,1879,1462,417,1597,19,1578,282,11,271,1723,1306,417,1315,967,348,264,77,17,957
8/1/2017,VA,Virginia,Charlotte,51037,3350,2815,535,2704,12,2692,646,19,627,3162,2627,535,2503,2042,461,805,131,52,1515
8/1/2017,VA,Virginia,Charlottesville City,51540,6149,5397,752,5054,30,5024,1095,49,1046,5510,4759,751,4361,3654,707,1242,157,51,2911
8/1/2017,VA,Virginia,Chesapeake City,51550,36249,28911,7338,31053,266,30787,5196,227,4969,32818,25481,7337,20069,13546,6523,4090,905,251,14823
8/1/2017,VA,Virginia,Chesterfield,51041,57083,43478,13605,49643,188,49455,7440,247,7193,51510,37908,13602,39344,27253,12091,5347,1018,277,32702
8/1/2017,VA,Virginia,Clarke,51043,3164,2803,361,2909,11,2898,255,*,*,2865,2504,361,1914,1637,277,256,72,27,1559
8/1/2017,VA,Virginia,Colonial Heights City,51570,4131,3446,685,3518,*,*,613,16,597,3814,3129,685,2454,1869,585,501,95,24,1834
8/1/2017,VA,Virginia,Covington City,51580,1647,1408,239,1269,11,1258,378,*,*,1540,1301,239,1221,1001,220,359,54,20,788
8/1/2017,VA,Virginia,Craig,51045,1309,1031,278,1023,*,*,286,0,286,1208,930,278,947,684,263,201,43,12,691
8/1/2017,VA,Virginia,Culpeper,51047,8983,7668,1315,7755,38,7717,1228,44,1184,8132,6817,1315,5637,4592,1045,1172,236,64,4165
8/1/2017,VA,Virginia,Cumberland,51049,2251,1745,506,1875,*,*,376,*,*,2091,1585,506,1632,1184,448,423,98,33,1078
8/1/2017,VA,Virginia,Danville City,51590,11117,8943,2174,8728,83,8645,2389,117,2272,10471,8297,2174,8699,7266,1433,3230,429,162,4878
8/1/2017,VA,Virginia,Dickenson,51051,4731,2914,1817,2955,*,*,1776,*,*,4524,2707,1817,3699,2085,1614,1120,205,75,2299
8/1/2017,VA,Virginia,Dinwiddie,51053,5732,4547,1185,4596,34,4562,1136,30,1106,5277,4092,1185,3876,2782,1094,908,183,51,2734
8/1/2017,VA,Virginia,Emporia City,51595,1136,877,259,875,16,859,261,11,250,1061,802,259,865,654,211,408,70,12,375
8/1/2017,VA,Virginia,Essex,51057,2865,2339,526,2442,15,2427,423,13,410,2663,2137,526,1980,1586,394,430,84,23,1443
8/1/2017,VA,Virginia,Fairfax,51059,144954,124460,20494,136702,517,136185,8252,437,7815,117238,96779,20459,67682,48887,18795,13443,2679,502,51058
8/1/2017,VA,Virginia,Fairfax City,51600,3701,3143,558,3424,12,3412,277,11,266,3096,2539,557,1880,1378,502,369,58,11,1442
8/1/2017,VA,Virginia,Falls Church City,51610,1890,1627,263,1802,*,*,88,*,*,1474,1211,263,898,654,244,126,*,*,749
8/1/2017,VA,Virginia,Fauquier,51061,12138,10838,1300,11031,57,10974,1107,40,1067,10792,9492,1300,6804,5756,1048,965,193,55,5591
8/1/2017,VA,Virginia,Floyd,51063,3954,3198,756,3413,15,3398,541,*,*,3690,2934,756,2861,2168,693,560,93,41,2167
8/1/2017,VA,Virginia,Fluvanna,51065,5672,4923,749,5078,20,5058,594,23,571,5194,4445,749,3786,3165,621,525,122,29,3110
8/1/2017,VA,Virginia,Franklin,51067,14299,10500,3799,11912,43,11869,2387,29,2358,13437,9639,3798,10847,7350,3497,1976,469,150,8252
8/1/2017,VA,Virginia,Franklin City,51620,1922,1598,324,1502,22,1480,420,22,398,1807,1483,324,1472,1175,297,562,60,14,836
8/1/2017,VA,Virginia,Frederick,51069,15776,13969,1807,13982,50,13932,1794,56,1738,14388,12583,1805,9816,8419,1397,1497,347,137,7835
8/1/2017,VA,Virginia,Fredericksburg City,51630,3932,3426,506,3209,22,3187,723,31,692,3538,3032,506,2434,1977,457,791,86,38,1519
8/1/2017,VA,Virginia,Galax City,51640,1883,1741,142,1481,*,*,402,11,391,1781,1639,142,1407,1299,108,640,57,29,681
8/1/2017,VA,Virginia,Giles,51071,4586,3522,1064,3622,22,3600,964,17,947,4312,3249,1063,3490,2802,688,804,125,35,2526
8/1/2017,VA,Virginia,Gloucester,51073,8195,6805,1390,7013,38,6975,1182,22,1160,7579,6189,1390,4811,3633,1178,972,170,43,3626
8/1/2017,VA,Virginia,Goochland,51075,5508,4363,1145,5024,20,5004,484,22,462,4974,3829,1145,4052,3134,918,401,103,32,3516
8/1/2017,VA,Virginia,Grayson,51077,4626,3955,671,3783,*,*,843,12,831,4413,3742,671,3307,2747,560,992,179,86,2050
8/1/2017,VA,Virginia,Greene,51079,3592,3138,454,3140,12,3128,452,*,*,3272,2818,454,2346,1956,390,449,82,25,1790
8/1/2017,VA,Virginia,Greensville,51081,2434,1836,598,1942,19,1923,492,14,478,2279,1681,598,1847,1363,484,533,127,27,1160
8/1/2017,VA,Virginia,Halifax,51083,9527,8222,1305,7792,66,7726,1735,55,1680,8990,7685,1305,7216,6083,1133,2150,440,142,4484
8/1/2017,VA,Virginia,Hampton City,51650,24425,18369,6056,20040,194,19846,4385,195,4190,22317,16262,6055,13441,7816,5625,3600,785,174,8882
8/1/2017,VA,Virginia,Hanover,51085,20053,15315,4738,18187,80,18107,1866,48,1818,18250,13513,4737,14543,10704,3839,1369,353,96,12725
8/1/2017,VA,Virginia,Harrisonburg City,51660,5213,4647,566,4413,15,4398,800,21,779,4710,4144,566,3700,3291,409,954,123,33,2590
8/1/2017,VA,Virginia,Henrico,51087,54366,40264,14102,47344,313,47031,7022,290,6732,49192,35092,14100,39402,27275,12127,6206,1385,401,31410
8/1/2017,VA,Virginia,Henry,51089,15005,10865,4140,11898,71,11827,3107,53,3054,14286,10146,4140,12034,8209,3825,3056,706,249,8023
8/1/2017,VA,Virginia,Highland,51091,763,689,74,698,*,*,65,*,*,714,640,74,531,464,67,60,*,*,443
8/1/2017,VA,Virginia,Hopewell City,51670,4486,3571,915,3435,30,3405,1051,29,1022,4178,3263,915,2854,1982,872,982,165,32,1675
8/1/2017,VA,Virginia,Isle of Wight,51093,7900,6219,1681,6907,47,6860,993,35,958,7342,5661,1681,5188,3676,1512,945,195,61,3987
8/1/2017,VA,Virginia,James City,51095,19683,17161,2522,18484,56,18428,1199,57,1142,18192,15673,2519,11517,9578,1939,827,223,58,10409
8/1/2017,VA,Virginia,King and Queen,51097,1715,1425,290,1443,11,1432,272,*,*,1604,1314,290,1169,921,248,269,66,15,819
8/1/2017,VA,Virginia,King George,51099,3721,3330,391,3201,14,3187,520,29,491,3245,2854,391,1635,1298,337,467,84,13,1071
8/1/2017,VA,Virginia,King William,51101,3257,2740,517,2789,24,2765,468,23,445,3004,2487,517,2409,1970,439,381,115,23,1890
8/1/2017,VA,Virginia,Lancaster,51103,4265,3702,563,3909,18,3891,356,15,341,4057,3494,563,2924,2540,384,500,95,17,2312
8/1/2017,VA,Virginia,Lee,51105,6353,3875,2478,4343,16,4327,2010,*,*,6044,3568,2476,4896,2587,2309,1926,247,75,2648
8/1/2017,VA,Virginia,Lexington City,51678,1617,1462,155,1480,11,1469,137,*,*,1499,1344,155,1141,1017,124,217,*,*,883
8/1/2017,VA,Virginia,Loudoun,51107,34862,29477,5385,32474,134,32340,2388,113,2275,28954,23576,5378,18922,14115,4807,2992,634,153,15143
8/1/2017,VA,Virginia,Louisa,51109,7711,6368,1343,6478,34,6444,1233,34,1199,7058,5715,1343,5179,3997,1182,1047,246,70,3816
8/1/2017,VA,Virginia,Lunenburg,51111,2994,2599,395,2451,14,2437,543,22,521,2769,2374,395,2083,1741,342,709,112,46,1216
8/1/2017,VA,Virginia,Lynchburg City,51680,14543,12265,2278,11839,80,11759,2704,109,2595,13495,11217,2278,10901,8926,1975,3041,436,131,7293
8/1/2017,VA,Virginia,Madison,51113,2939,2522,417,2604,14,2590,335,13,322,2739,2322,417,2015,1671,344,394,91,23,1507
8/1/2017,VA,Virginia,Manassas City,51683,4355,3550,805,3812,29,3783,543,44,499,3684,2879,805,2502,1771,731,516,89,34,1863
8/1/2017,VA,Virginia,Manassas Park City,51685,1224,964,260,1057,11,1046,167,13,154,1046,787,259,716,483,233,182,*,*,481
8/1/2017,VA,Virginia,Martinsville City,51690,3923,2922,1001,2916,29,2887,1007,40,967,3711,2710,1001,3180,2221,959,1299,166,64,1651
8/1/2017,VA,Virginia,Mathews,51115,2810,2372,438,2580,*,*,230,*,*,2665,2227,438,1830,1480,350,263,41,19,1507
8/1/2017,VA,Virginia,Mecklenburg,51117,9061,7210,1851,7476,56,7420,1585,58,1527,8532,6681,1851,6673,5145,1528,1892,381,115,4285
8/1/2017,VA,Virginia,Middlesex,51119,3514,2984,530,3143,18,3125,371,*,*,3321,2791,530,2504,2119,385,451,85,25,1943
8/1/2017,VA,Virginia,Montgomery,51121,13585,11160,2425,11193,39,11154,2392,36,2356,12282,9857,2425,9917,7694,2223,1940,321,121,7535
8/1/2017,VA,Virginia,Nelson,51125,4482,3907,575,3969,17,3952,513,*,*,4119,3544,575,2994,2494,500,592,100,40,2262
8/1/2017,VA,Virginia,New Kent,51127,4252,3479,773,3794,19,3775,458,*,*,3869,3096,773,2699,2107,592,272,81,17,2329
8/1/2017,VA,Virginia,Newport News City,51700,27283,20311,6972,22366,191,22175,4917,245,4672,25004,18034,6970,16166,9631,6535,4663,841,228,10434
8/1/2017,VA,Virginia,Norfolk City,51710,32232,23937,8295,25603,256,25347,6629,338,6291,29100,20805,8295,19444,11586,7858,7189,1336,281,10638
8/1/2017,VA,Virginia,Northampton,51131,3573,2982,591,3037,24,3013,536,27,509,3350,2759,591,2649,2159,490,914,93,31,1611
8/1/2017,VA,Virginia,Northumberland,51133,4580,3959,621,4249,13,4236,331,*,*,4273,3652,621,2821,2454,367,413,90,34,2284
8/1/2017,VA,Virginia,Norton City,51720,1183,812,371,787,*,*,396,*,*,1102,731,371,882,554,328,348,49,17,468
8/1/2017,VA,Virginia,Nottoway,51135,3643,2996,647,2956,28,2928,687,16,671,3396,2749,647,2641,2202,439,918,134,41,1548
8/1/2017,VA,Virginia,Orange,51137,8583,7495,1088,7567,46,7521,1016,37,979,7879,6791,1088,5181,4433,748,974,216,66,3925
8/1/2017,VA,Virginia,Page,51139,6119,5385,734,4989,21,4968,1130,19,1111,5751,5017,734,4190,3572,618,1124,231,85,2750
8/1/2017,VA,Virginia,Patrick,51141,5097,3851,1246,4204,*,*,893,*,*,4852,3607,1245,3951,2895,1056,1021,195,71,2664
8/1/2017,VA,Virginia,Petersburg City,51730,7154,5343,1811,5297,96,5201,1857,86,1771,6525,4715,1810,4702,2960,1742,2026,342,61,2273
8/1/2017,VA,Virginia,Pittsylvania,51143,15972,12426,3546,13076,98,12978,2896,78,2818,15073,11527,3546,12305,9777,2528,3080,552,219,8454
8/1/2017,VA,Virginia,Poquoson City,51735,2501,2200,301,2328,*,*,173,*,*,2308,2007,301,1131,871,260,100,22,14,995
8/1/2017,VA,Virginia,Portsmouth City,51740,17881,13221,4660,13848,176,13672,4033,210,3823,16014,11356,4658,10561,6141,4420,3860,712,139,5850
8/1/2017,VA,Virginia,Powhatan,51145,5698,4528,1170,5080,18,5062,618,14,604,5223,4053,1170,4126,3140,986,397,109,33,3587
8/1/2017,VA,Virginia,Prince Edward,51147,4580,3760,820,3683,36,3647,897,37,860,4255,3435,820,3274,2659,615,1081,167,49,1977
8/1/2017,VA,Virginia,Prince George,51149,5699,4936,763,4831,25,4806,868,31,837,5288,4525,763,3167,2500,667,552,129,27,2459
8/1/2017,VA,Virginia,Prince William,51153,45896,37763,8133,40816,262,40554,5080,298,4782,39138,31008,8130,22489,15046,7443,5083,991,216,16199
8/1/2017,VA,Virginia,Pulaski,51155,8980,7266,1714,7142,32,7110,1838,30,1808,8378,6664,1714,6388,4825,1563,1624,316,118,4330
8/1/2017,VA,Virginia,Radford City,51750,2031,1645,386,1627,*,*,404,*,*,1872,1486,386,1534,1186,348,345,42,22,1125
8/1/2017,VA,Virginia,Rappahannock,51157,2009,1845,164,1861,*,*,148,*,*,1815,1652,163,1195,1071,124,153,*,*,997
8/1/2017,VA,Virginia,Richmond,51159,1969,1585,384,1708,14,1694,261,13,248,1832,1448,384,1341,1087,254,293,84,20,944
8/1/2017,VA,Virginia,Richmond City,51760,33211,22373,10838,26007,263,25744,7204,347,6857,29925,19087,10838,25008,14750,10258,8812,1410,291,14495
8/1/2017,VA,Virginia,Roanoke,51161,23067,18183,4884,20480,95,20385,2587,56,2531,21362,16479,4883,16954,12682,4272,1981,429,139,14405
8/1/2017,VA,Virginia,Roanoke City,51770,20337,14586,5751,15197,129,15068,5140,149,4991,18579,12829,5750,14949,9570,5379,4831,838,204,9076
8/1/2017,VA,Virginia,Rockbridge,51163,5873,4975,898,4975,21,4954,898,*,*,5446,4548,898,4052,3314,738,821,178,68,2985
8/1/2017,VA,Virginia,Rockingham,51165,16965,14412,2553,14827,43,14784,2138,37,2101,15681,13128,2553,12085,10262,1823,1808,505,146,9626
8/1/2017,VA,Virginia,Russell,51167,7773,5144,2629,5274,17,5257,2499,15,2484,7456,4827,2629,6345,4170,2175,1699,302,131,4213
8/1/2017,VA,Virginia,Salem City,51775,6015,4816,1199,5068,30,5038,947,16,931,5520,4321,1199,4363,3295,1068,852,141,37,3333
8/1/2017,VA,Virginia,Scott,51169,6580,3340,3240,4901,*,*,1679,14,1665,6311,3071,3240,5452,2275,3177,1509,242,121,3580
8/1/2017,VA,Virginia,Shenandoah,51171,10321,9123,1198,9075,27,9048,1246,26,1220,9654,8456,1198,6737,5796,941,1282,259,99,5097
8/1/2017,VA,Virginia,Smyth,51173,8818,6776,2042,6543,24,6519,2275,24,2251,8305,6263,2042,6724,4906,1818,2173,400,131,4020
8/1/2017,VA,Virginia,Southampton,51175,4054,3397,657,3372,24,3348,682,17,665,3789,3132,657,2952,2386,566,737,129,35,2051
8/1/2017,VA,Virginia,Spotsylvania,51177,19986,17408,2578,17298,102,17196,2688,99,2589,17786,15209,2577,10672,8574,2098,1956,488,133,8095
8/1/2017,VA,Virginia,Stafford,51179,16404,14808,1596,14435,90,14345,1969,82,1887,14378,12782,1596,7187,5872,1315,1336,362,77,5412
8/1/2017,VA,Virginia,Staunton City,51790,6006,5172,834,4962,23,4939,1044,20,1024,5640,4806,834,4395,3708,687,1054,156,60,3125
8/1/2017,VA,Virginia,Suffolk City,51800,15486,12257,3229,12643,96,12547,2843,103,2740,14187,10958,3229,9698,6793,2905,2657,456,110,6475
8/1/2017,VA,Virginia,Surry,51181,1539,1196,343,1295,*,*,244,*,*,1433,1090,343,1031,717,314,204,61,14,752
8/1/2017,VA,Virginia,Sussex,51183,2356,1801,555,1926,28,1898,430,*,*,2196,1641,555,1682,1162,520,479,140,19,1044
8/1/2017,VA,Virginia,Tazewell,51185,11882,8451,3431,8710,34,8676,3172,40,3132,11260,7831,3429,8865,6618,2247,2278,443,186,5958
8/1/2017,VA,Virginia,Unknown,51999,*,*,*,*,*,*,*,*,*,*,*,*,*,*,*,*,*,*,*
8/1/2017,VA,Virginia,Virginia Beach City,51810,68805,56805,12000,60570,345,60225,8235,334,7901,63034,51041,11993,35549,24754,10795,6709,1419,357,27064
8/1/2017,VA,Virginia,Warren,51187,7321,6589,732,6252,28,6224,1069,30,1039,6679,5947,732,4487,3907,580,883,237,73,3294
8/1/2017,VA,Virginia,Washington,51191,14759,9907,4852,11791,41,11750,2968,31,2937,13933,9082,4851,11282,6813,4469,2469,525,166,8122
8/1/2017,VA,Virginia,Waynesboro City,51820,4728,4032,696,3853,14,3839,875,26,849,4407,3711,696,3471,2873,598,879,116,34,2442
8/1/2017,VA,Virginia,Westmoreland,51193,4847,4170,677,4246,25,4221,601,11,590,4426,3749,677,2784,2231,553,735,134,48,1867
8/1/2017,VA,Virginia,Williamsburg City,51830,2535,2137,398,2316,*,*,219,*,*,2338,1941,397,1636,1309,327,233,*,*,1366
8/1/2017,VA,Virginia,Winchester City,51840,5093,4540,553,4324,23,4301,769,16,753,4622,4069,553,3325,2889,436,854,129,52,2290
8/1/2017,VA,Virginia,Wise,51195,10542,6725,3817,7034,24,7010,3508,24,3484,9953,6136,3817,7822,4352,3470,2430,469,167,4756
8/1/2017,VA,Virginia,Wythe,51197,7513,5722,1791,5834,31,5803,1679,21,1658,7106,5315,1791,5529,3970,1559,1507,275,100,3647
8/1/2017,VA,Virginia,York,51199,11428,9895,1533,10471,32,10439,957,28,929,10473,8940,1533,5526,4236,1290,661,165,42,4658
12/1/2017,VA,Virginia,Accomack,51001,8675,7340,1335,7447,46,7401,1228,45,1183,8080,6745,1335,5893,4862,1031,1512,374,92,3915
12/1/2017,VA,Virginia,Albemarle,51003,19986,17868,2118,18398,53,18345,1588,47,1541,17920,15802,2118,13540,11708,1832,1532,294,97,11617
12/1/2017,VA,Virginia,Alexandria City,51510,17515,15068,2447,16060,75,15985,1455,94,1361,14076,11633,2443,8366,6093,2273,2136,314,63,5853
12/1/2017,VA,Virginia,Alleghany,51005,4486,3876,610,3614,19,3595,872,14,858,4254,3644,610,3381,2921,460,793,98,54,2436
12/1/2017,VA,Virginia,Amelia,51007,3025,2346,679,2542,*,*,483,*,*,2791,2112,679,2179,1567,612,470,90,38,1581
12/1/2017,VA,Virginia,Amherst,51009,7676,6397,1279,6384,47,6337,1292,29,1263,7118,5839,1279,5729,4610,1119,1235,225,76,4193
12/1/2017,VA,Virginia,Appomattox,51011,3780,3178,602,3086,13,3073,694,19,675,3555,2953,602,2850,2322,528,678,100,37,2035
12/1/2017,VA,Virginia,Arlington,51013,23879,20822,3057,22228,87,22141,1651,96,1555,18797,15740,3057,11153,8331,2822,2955,353,103,7742
12/1/2017,VA,Virginia,Augusta,51015,17843,15347,2496,15376,50,15326,2467,43,2424,16753,14257,2496,12719,10722,1997,1819,405,144,10351
12/1/2017,VA,Virginia,Bath,51017,1276,1178,98,1125,*,*,151,*,*,1204,1106,98,925,842,83,169,36,26,694
12/1/2017,VA,Virginia,Bedford,51019,19250,15860,3390,16447,77,16370,2803,52,2751,17909,14521,3388,13836,11375,2461,1976,477,161,11222
12/1/2017,VA,Virginia,Bland,51021,1780,1381,399,1394,*,*,386,*,*,1695,1296,399,1256,1033,223,250,51,16,939
12/1/2017,VA,Virginia,Botetourt,51023,8485,6587,1898,7337,37,7300,1148,17,1131,7869,5971,1898,6141,4500,1641,819,181,53,5088
12/1/2017,VA,Virginia,Bristol City,51520,4495,2689,1806,3457,14,3443,1038,*,*,4221,2415,1806,3548,1817,1731,1066,153,51,2278
12/1/2017,VA,Virginia,Brunswick,51025,3939,3246,693,3220,21,3199,719,24,695,3685,2992,693,2866,2266,600,1103,107,39,1617
12/1/2017,VA,Virginia,Buchanan,51027,7292,4387,2905,4520,17,4503,2772,12,2760,7023,4118,2905,5805,3712,2093,1649,399,114,3643
12/1/2017,VA,Virginia,Buckingham,51029,3469,2836,633,2809,17,2792,660,22,638,3238,2605,633,2464,2068,396,730,155,48,1531
12/1/2017,VA,Virginia,Buena Vista City,51530,1444,1182,262,1165,*,*,279,*,*,1349,1087,262,1048,833,215,327,52,19,650
12/1/2017,VA,Virginia,Campbell,51031,12538,10490,2048,10345,70,10275,2193,60,2133,11722,9674,2048,9411,7624,1787,2103,369,169,6770
12/1/2017,VA,Virginia,Caroline,51033,5713,4747,966,4755,32,4723,958,40,918,5152,4186,966,3471,2629,842,822,227,54,2368
12/1/2017,VA,Virginia,Carroll,51035,8022,6861,1161,6473,21,6452,1549,11,1538,7572,6411,1161,5833,4918,915,1631,277,103,3822
12/1/2017,VA,Virginia,Charles City,51036,1899,1486,413,1614,18,1596,285,11,274,1742,1329,413,1329,983,346,270,80,18,961
12/1/2017,VA,Virginia,Charlotte,51037,3340,2822,518,2691,12,2679,649,20,629,3152,2634,518,2486,2041,445,806,123,52,1505
12/1/2017,VA,Virginia,Charlottesville City,51540,6204,5482,722,5105,27,5078,1099,46,1053,5542,4821,721,4368,3692,676,1248,156,52,2912
12/1/2017,VA,Virginia,Chesapeake City,51550,36569,29262,7307,31284,250,31034,5285,223,5062,33089,25783,7306,20184,13680,6504,4185,901,253,14845
12/1/2017,VA,Virginia,Chesterfield,51041,57617,44029,13588,50086,177,49909,7531,245,7286,51915,38331,13584,39640,27550,12090,5427,1015,281,32917
12/1/2017,VA,Virginia,Clarke,51043,3180,2814,366,2919,11,2908,261,*,*,2872,2506,366,1919,1638,281,255,73,29,1562
12/1/2017,VA,Virginia,Colonial Heights City,51570,4143,3468,675,3523,*,*,620,15,605,3811,3136,675,2460,1883,577,502,98,25,1835
12/1/2017,VA,Virginia,Covington City,51580,1641,1407,234,1257,*,*,384,*,*,1532,1298,234,1217,1002,215,356,55,19,787
12/1/2017,VA,Virginia,Craig,51045,1323,1048,275,1031,*,*,292,0,292,1222,947,275,958,696,262,213,43,15,687
12/1/2017,VA,Virginia,Culpeper,51047,9037,7740,1297,7793,35,7758,1244,42,1202,8190,6894,1296,5655,4623,1032,1201,230,65,4159
12/1/2017,VA,Virginia,Cumberland,51049,2247,1749,498,1869,*,*,378,*,*,2078,1580,498,1615,1175,440,431,89,36,1059
12/1/2017,VA,Virginia,Danville City,51590,11110,8958,2152,8707,81,8626,2403,117,2286,10442,8290,2152,8672,7264,1408,3255,403,157,4857
12/1/2017,VA,Virginia,Dickenson,51051,4728,2901,1827,2934,*,*,1794,*,*,4528,2701,1827,3699,2071,1628,1134,205,72,2288
12/1/2017,VA,Virginia,Dinwiddie,51053,5751,4567,1184,4602,30,4572,1149,28,1121,5281,4097,1184,3870,2777,1093,908,184,51,2727
12/1/2017,VA,Virginia,Emporia City,51595,1134,879,255,872,15,857,262,*,*,1055,800,255,860,658,202,407,68,12,373
12/1/2017,VA,Virginia,Essex,51057,2874,2364,510,2448,14,2434,426,14,412,2669,2159,510,1981,1604,377,436,84,25,1436
12/1/2017,VA,Virginia,Fairfax,51059,147065,126342,20723,138672,480,138192,8393,442,7951,118545,97853,20692,68434,49409,19025,13672,2672,506,51584
12/1/2017,VA,Virginia,Fairfax City,51600,3729,3167,562,3449,*,*,280,12,268,3118,2557,561,1886,1379,507,376,*,*,1444
12/1/2017,VA,Virginia,Falls Church City,51610,1925,1661,264,1837,*,*,88,*,*,1494,1230,264,905,662,243,127,*,*,755
12/1/2017,VA,Virginia,Fauquier,51061,12209,10931,1278,11087,53,11034,1122,39,1083,10832,9554,1278,6851,5828,1023,981,190,57,5623
12/1/2017,VA,Virginia,Floyd,51063,3961,3223,738,3412,14,3398,549,*,*,3698,2960,738,2855,2178,677,566,87,42,2160
12/1/2017,VA,Virginia,Fluvanna,51065,5704,4978,726,5104,19,5085,600,22,578,5228,4502,726,3782,3183,599,531,117,32,3102
12/1/2017,VA,Virginia,Franklin,51067,14391,10610,3781,11978,41,11937,2413,29,2384,13517,9737,3780,10890,7411,3479,2010,469,158,8253
12/1/2017,VA,Virginia,Franklin City,51620,1937,1627,310,1506,21,1485,431,24,407,1812,1502,310,1474,1191,283,570,59,16,829
12/1/2017,VA,Virginia,Frederick,51069,15859,14077,1782,14032,47,13985,1827,53,1774,14433,12653,1780,9853,8473,1380,1517,339,133,7864
12/1/2017,VA,Virginia,Fredericksburg City,51630,3964,3478,486,3227,20,3207,737,30,707,3550,3064,486,2437,1999,438,797,84,37,1519
12/1/2017,VA,Virginia,Galax City,51640,1895,1762,133,1484,*,*,411,11,400,1790,1657,133,1418,1316,102,645,54,28,691
12/1/2017,VA,Virginia,Giles,51071,4586,3550,1036,3610,21,3589,976,16,960,4314,3279,1035,3495,2836,659,811,128,33,2523
12/1/2017,VA,Virginia,Gloucester,51073,8249,6870,1379,7053,33,7020,1196,22,1174,7623,6244,1379,4835,3670,1165,983,166,44,3642
12/1/2017,VA,Virginia,Goochland,51075,5569,4440,1129,5078,18,5060,491,23,468,5025,3896,1129,4078,3173,905,405,99,34,3540
12/1/2017,VA,Virginia,Grayson,51077,4623,3950,673,3771,*,*,852,11,841,4412,3739,673,3298,2737,561,994,176,85,2043
12/1/2017,VA,Virginia,Greene,51079,3628,3175,453,3164,12,3152,464,*,*,3307,2854,453,2362,1973,389,451,81,28,1802
12/1/2017,VA,Virginia,Greensville,51081,2431,1845,586,1934,18,1916,497,15,482,2276,1691,585,1834,1360,474,524,128,28,1154
12/1/2017,VA,Virginia,Halifax,51083,9530,8232,1298,7773,64,7709,1757,58,1699,8975,7677,1298,7190,6064,1126,2156,433,144,4457
12/1/2017,VA,Virginia,Hampton City,51650,24539,18486,6053,20095,188,19907,4444,196,4248,22390,16338,6052,13463,7839,5624,3680,771,174,8838
12/1/2017,VA,Virginia,Hanover,51085,20174,15445,4729,18290,73,18217,1884,48,1836,18387,13659,4728,14659,10831,3828,1400,347,95,12817
12/1/2017,VA,Virginia,Harrisonburg City,51660,5239,4689,550,4430,13,4417,809,23,786,4741,4191,550,3709,3318,391,955,124,35,2595
12/1/2017,VA,Virginia,Henrico,51087,54741,40690,14051,47616,289,47327,7125,290,6835,49480,35431,14049,39601,27503,12098,6325,1366,400,31510
12/1/2017,VA,Virginia,Henry,51089,14970,10897,4073,11835,67,11768,3135,53,3082,14240,10167,4073,11979,8222,3757,3096,698,251,7934
12/1/2017,VA,Virginia,Highland,51091,767,696,71,699,*,*,68,*,*,719,648,71,535,471,64,59,*,*,446
12/1/2017,VA,Virginia,Hopewell City,51670,4482,3568,914,3429,28,3401,1053,29,1024,4175,3261,914,2850,1978,872,992,156,31,1671
12/1/2017,VA,Virginia,Isle of Wight,51093,7972,6303,1669,6963,45,6918,1009,35,974,7402,5733,1669,5206,3703,1503,957,190,62,3997
12/1/2017,VA,Virginia,James City,51095,19752,17261,2491,18535,52,18483,1217,56,1161,18274,15786,2488,11543,9629,1914,844,218,58,10423
12/1/2017,VA,Virginia,King and Queen,51097,1734,1452,282,1459,11,1448,275,*,*,1618,1336,282,1178,938,240,275,67,14,822
12/1/2017,VA,Virginia,King George,51099,3735,3375,360,3209,13,3196,526,27,499,3255,2895,360,1619,1312,307,471,76,14,1058
12/1/2017,VA,Virginia,King William,51101,3292,2785,507,2813,24,2789,479,22,457,3034,2527,507,2429,1999,430,391,116,23,1899
12/1/2017,VA,Virginia,Lancaster,51103,4264,3708,556,3910,15,3895,354,14,340,4049,3493,556,2916,2543,373,499,92,15,2310
12/1/2017,VA,Virginia,Lee,51105,6362,3883,2479,4334,16,4318,2028,12,2016,6046,3569,2477,4897,2584,2313,1947,241,80,2629
12/1/2017,VA,Virginia,Lexington City,51678,1619,1467,152,1483,*,*,136,*,*,1499,1347,152,1132,1012,120,213,*,*,880
12/1/2017,VA,Virginia,Loudoun,51107,35397,30022,5375,32952,124,32828,2445,117,2328,29264,23896,5368,19119,14313,4806,3051,640,156,15272
12/1/2017,VA,Virginia,Louisa,51109,7767,6435,1332,6523,33,6490,1244,34,1210,7101,5769,1332,5202,4032,1170,1056,248,72,3826
12/1/2017,VA,Virginia,Lunenburg,51111,2999,2612,387,2455,12,2443,544,19,525,2777,2390,387,2088,1754,334,707,116,44,1221
12/1/2017,VA,Virginia,Lynchburg City,51680,14581,12330,2251,11838,77,11761,2743,109,2634,13521,11270,2251,10922,8965,1957,3075,431,131,7285
12/1/2017,VA,Virginia,Madison,51113,2970,2559,411,2624,13,2611,346,14,332,2767,2356,411,2027,1692,335,397,88,23,1519
12/1/2017,VA,Virginia,Manassas City,51683,4422,3627,795,3873,26,3847,549,44,505,3714,2920,794,2513,1794,719,521,91,36,1865
12/1/2017,VA,Virginia,Manassas Park City,51685,1244,978,266,1075,11,1064,169,13,156,1057,792,265,724,483,241,187,*,*,486
12/1/2017,VA,Virginia,Martinsville City,51690,3930,2956,974,2908,27,2881,1022,42,980,3716,2742,974,3168,2237,931,1311,167,66,1624
12/1/2017,VA,Virginia,Mathews,51115,2827,2389,438,2591,*,*,236,*,*,2682,2244,438,1849,1499,350,269,41,21,1518
12/1/2017,VA,Virginia,Mecklenburg,51117,9065,7259,1806,7472,54,7418,1593,56,1537,8530,6724,1806,6664,5172,1492,1897,369,110,4288
12/1/2017,VA,Virginia,Middlesex,51119,3521,3000,521,3145,17,3128,376,*,*,3337,2816,521,2510,2133,377,455,80,26,1949
12/1/2017,VA,Virginia,Montgomery,51121,13649,11228,2421,11247,36,11211,2402,34,2368,12324,9903,2421,9953,7732,2221,1944,327,123,7559
12/1/2017,VA,Virginia,Nelson,51125,4520,3962,558,4000,16,3984,520,*,*,4142,3584,558,3007,2523,484,596,99,41,2271
12/1/2017,VA,Virginia,New Kent,51127,4309,3540,769,3842,17,3825,467,*,*,3918,3149,769,2721,2130,591,285,80,14,2342
12/1/2017,VA,Virginia,Newport News City,51700,27500,20543,6957,22502,182,22320,4998,247,4751,25151,18196,6955,16225,9701,6524,4728,824,227,10446
12/1/2017,VA,Virginia,Norfolk City,51710,32445,24173,8272,25741,241,25500,6704,330,6374,29214,20942,8272,19519,11675,7844,7306,1313,293,10607
12/1/2017,VA,Virginia,Northampton,51131,3580,2998,582,3043,21,3022,537,25,512,3348,2766,582,2656,2174,482,925,93,33,1605
12/1/2017,VA,Virginia,Northumberland,51133,4602,3983,619,4266,12,4254,336,*,*,4296,3677,619,2826,2462,364,424,86,37,2279
12/1/2017,VA,Virginia,Norton City,51720,1192,816,376,787,*,*,405,*,*,1106,730,376,890,557,333,356,51,17,466
12/1/2017,VA,Virginia,Nottoway,51135,3658,3031,627,2965,27,2938,693,15,678,3401,2774,627,2648,2227,421,917,131,45,1555
12/1/2017,VA,Virginia,Orange,51137,8591,7534,1057,7551,42,7509,1040,38,1002,7879,6822,1057,5157,4435,722,993,211,69,3884
12/1/2017,VA,Virginia,Page,51139,6142,5417,725,5000,19,4981,1142,22,1120,5767,5042,725,4203,3592,611,1143,238,84,2738
12/1/2017,VA,Virginia,Patrick,51141,5093,3880,1213,4192,*,*,901,11,890,4840,3628,1212,3930,2904,1026,1024,192,69,2645
12/1/2017,VA,Virginia,Petersburg City,51730,7163,5370,1793,5294,92,5202,1869,87,1782,6524,4732,1792,4708,2983,1725,2064,335,66,2243
12/1/2017,VA,Virginia,Pittsylvania,51143,16035,12494,3541,13088,88,13000,2947,80,2867,15105,11564,3541,12327,9806,2521,3116,553,215,8443
12/1/2017,VA,Virginia,Poquoson City,51735,2508,2208,300,2335,*,*,173,*,*,2310,2010,300,1139,880,259,101,21,15,1002
12/1/2017,VA,Virginia,Portsmouth City,51740,17967,13354,4613,13896,163,13733,4071,206,3865,16076,11465,4611,10562,6185,4377,3880,712,141,5829
12/1/2017,VA,Virginia,Powhatan,51145,5761,4600,1161,5133,19,5114,628,16,612,5265,4104,1161,4158,3184,974,405,105,32,3616
12/1/2017,VA,Virginia,Prince Edward,51147,4601,3796,805,3698,35,3663,903,35,868,4270,3465,805,3287,2689,598,1082,166,50,1989
12/1/2017,VA,Virginia,Prince George,51149,5738,4985,753,4860,25,4835,878,30,848,5322,4569,753,3201,2546,655,574,120,27,2480
12/1/2017,VA,Virginia,Prince William,51153,46590,38460,8130,41418,247,41171,5172,303,4869,39710,31585,8125,22695,15246,7449,5162,995,219,16319
12/1/2017,VA,Virginia,Pulaski,51155,8982,7276,1706,7135,32,7103,1847,28,1819,8384,6678,1706,6377,4823,1554,1636,307,121,4313
12/1/2017,VA,Virginia,Radford City,51750,2040,1651,389,1636,*,*,404,*,*,1882,1493,389,1543,1192,351,343,43,23,1134
12/1/2017,VA,Virginia,Rappahannock,51157,2021,1859,162,1871,*,*,150,*,*,1826,1665,161,1209,1088,121,157,*,*,1009
12/1/2017,VA,Virginia,Richmond,51159,1976,1597,379,1711,12,1699,265,12,253,1829,1450,379,1337,1090,247,297,80,20,940
12/1/2017,VA,Virginia,Richmond City,51760,33384,22628,10756,26101,248,25853,7283,343,6940,30028,19272,10756,25041,14859,10182,8876,1381,297,14487
12/1/2017,VA,Virginia,Roanoke,51161,23101,18262,4839,20482,82,20400,2619,56,2563,21383,16545,4838,16947,12705,4242,1988,434,144,14381
12/1/2017,VA,Virginia,Roanoke City,51770,20370,14685,5685,15207,121,15086,5163,139,5024,18582,12898,5684,14945,9626,5319,4864,846,214,9021
12/1/2017,VA,Virginia,Rockbridge,51163,5907,5017,890,4992,20,4972,915,*,*,5473,4583,890,4075,3347,728,835,183,66,2991
12/1/2017,VA,Virginia,Rockingham,51165,17028,14519,2509,14884,41,14843,2144,36,2108,15751,13242,2509,12143,10355,1788,1823,496,147,9677
12/1/2017,VA,Virginia,Russell,51167,7798,5142,2656,5271,15,5256,2527,15,2512,7476,4820,2656,6368,4167,2201,1707,310,135,4216
12/1/2017,VA,Virginia,Salem City,51775,6040,4872,1168,5076,28,5048,964,16,948,5531,4363,1168,4346,3309,1037,828,146,37,3335
12/1/2017,VA,Virginia,Scott,51169,6572,3322,3250,4876,*,*,1696,15,1681,6314,3064,3250,5463,2273,3190,1519,244,119,3581
12/1/2017,VA,Virginia,Shenandoah,51171,10370,9182,1188,9116,25,9091,1254,29,1225,9689,8501,1188,6752,5821,931,1298,253,99,5102
12/1/2017,VA,Virginia,Smyth,51173,8793,6755,2038,6508,22,6486,2285,23,2262,8300,6262,2038,6717,4902,1815,2188,402,127,4000
12/1/2017,VA,Virginia,Southampton,51175,4080,3439,641,3392,24,3368,688,16,672,3805,3164,641,2972,2418,554,751,121,35,2065
12/1/2017,VA,Virginia,Spotsylvania,51177,20123,17605,2518,17379,88,17291,2744,101,2643,17885,15368,2517,10706,8666,2040,2002,484,133,8087
12/1/2017,VA,Virginia,Stafford,51179,16590,15039,1551,14591,85,14506,1999,78,1921,14521,12970,1551,7193,5925,1268,1349,353,80,5411
12/1/2017,VA,Virginia,Staunton City,51790,6003,5202,801,4952,19,4933,1051,18,1033,5622,4821,801,4382,3731,651,1047,146,64,3125
12/1/2017,VA,Virginia,Suffolk City,51800,15564,12370,3194,12681,88,12593,2883,101,2782,14230,11036,3194,9723,6850,2873,2676,455,114,6478
12/1/2017,VA,Virginia,Surry,51181,1550,1214,336,1303,*,*,247,*,*,1441,1105,336,1037,730,307,206,59,13,759
12/1/2017,VA,Virginia,Sussex,51183,2354,1810,544,1920,27,1893,434,*,*,2190,1646,544,1669,1160,509,475,135,20,1039
12/1/2017,VA,Virginia,Tazewell,51185,11903,8434,3469,8683,30,8653,3220,39,3181,11299,7831,3468,8873,6586,2287,2304,440,191,5938
12/1/2017,VA,Virginia,Unknown,51999,*,*,*,*,*,*,*,*,*,*,*,*,*,*,*,*,*,*,*
12/1/2017,VA,Virginia,Virginia Beach City,51810,69382,57382,12000,61041,320,60721,8341,324,8017,63488,51497,11991,35743,24939,10804,6755,1422,364,27202
12/1/2017,VA,Virginia,Warren,51187,7350,6626,724,6265,26,6239,1085,31,1054,6699,5975,724,4516,3944,572,917,233,74,3292
12/1/2017,VA,Virginia,Washington,51191,14803,9932,4871,11804,38,11766,2999,28,2971,13962,9092,4870,11314,6829,4485,2491,537,168,8118
12/1/2017,VA,Virginia,Waynesboro City,51820,4742,4060,682,3857,13,3844,885,27,858,4412,3730,682,3469,2882,587,898,114,34,2423
12/1/2017,VA,Virginia,Westmoreland,51193,4880,4223,657,4262,24,4238,618,12,606,4452,3795,657,2790,2255,535,742,127,47,1874
12/1/2017,VA,Virginia,Williamsburg City,51830,2551,2165,386,2332,*,*,219,*,*,2355,1969,386,1645,1328,317,231,*,*,1377
12/1/2017,VA,Virginia,Winchester City,51840,5108,4569,539,4332,20,4312,776,15,761,4623,4084,539,3310,2885,425,852,127,53,2278
12/1/2017,VA,Virginia,Wise,51195,10565,6718,3847,7016,22,6994,3549,24,3525,9987,6141,3846,7862,4360,3502,2461,458,172,4771
12/1/2017,VA,Virginia,Wythe,51197,7515,5740,1775,5821,27,5794,1694,20,1674,7106,5331,1775,5500,3957,1543,1519,269,102,3610
12/1/2017,VA,Virginia,York,51199,11541,10027,1514,10560,31,10529,981,33,948,10570,9056,1514,5586,4317,1269,681,164,43,4698
2/1/2017,VA,Virginia,Accomack,51001,8503,7138,1365,7322,50,7272,1181,47,1134,7918,6553,1365,5820,4762,1058,1442,390,104,3884
2/1/2017,VA,Virginia,Albemarle,51003,19483,17267,2216,17929,66,17863,1554,49,1505,17495,15279,2216,13274,11342,1932,1474,307,97,11396
2/1/2017,VA,Virginia,Alexandria City,51510,16892,14442,2450,15513,83,15430,1379,91,1288,13604,11158,2446,8146,5877,2269,2020,327,65,5734
2/1/2017,VA,Virginia,Alleghany,51005,4483,3828,655,3635,22,3613,848,16,832,4253,3598,655,3401,2901,500,770,108,51,2472
2/1/2017,VA,Virginia,Amelia,51007,2975,2283,692,2509,12,2497,466,*,*,2745,2053,692,2153,1533,620,461,82,38,1572
2/1/2017,VA,Virginia,Amherst,51009,7591,6266,1325,6334,51,6283,1257,29,1228,7062,5737,1325,5699,4539,1160,1162,239,76,4222
2/1/2017,VA,Virginia,Appomattox,51011,3736,3117,619,3066,15,3051,670,20,650,3523,2904,619,2847,2305,542,642,97,39,2069
2/1/2017,VA,Virginia,Arlington,51013,23148,20087,3061,21568,100,21468,1580,93,1487,18306,15245,3061,10883,8059,2824,2858,343,113,7569
2/1/2017,VA,Virginia,Augusta,51015,17516,14948,2568,15150,60,15090,2366,43,2323,16480,13912,2568,12562,10503,2059,1747,418,147,10250
2/1/2017,VA,Virginia,Bath,51017,1262,1154,108,1118,*,*,144,*,*,1187,1079,108,925,834,91,169,38,23,695
2/1/2017,VA,Virginia,Bedford,51019,18956,15415,3541,16224,89,16135,2732,50,2682,17637,14098,3539,13702,11113,2589,1931,479,169,11123
2/1/2017,VA,Virginia,Bland,51021,1759,1364,395,1387,*,*,372,*,*,1659,1264,395,1245,1030,215,249,52,18,926
2/1/2017,VA,Virginia,Botetourt,51023,8332,6406,1926,7221,47,7174,1111,17,1094,7713,5787,1926,6045,4370,1675,818,186,57,4984
2/1/2017,VA,Virginia,Bristol City,51520,4500,2684,1816,3489,17,3472,1011,11,1000,4217,2401,1816,3545,1798,1747,1034,157,55,2299
2/1/2017,VA,Virginia,Brunswick,51025,3911,3185,726,3206,29,3177,705,27,678,3670,2944,726,2881,2244,637,1107,107,39,1628
2/1/2017,VA,Virginia,Buchanan,51027,7278,4404,2874,4568,22,4546,2710,14,2696,6967,4093,2874,5822,3767,2055,1588,426,113,3695
2/1/2017,VA,Virginia,Buckingham,51029,3399,2760,639,2767,18,2749,632,17,615,3174,2535,639,2434,2032,402,712,143,49,1530
2/1/2017,VA,Virginia,Buena Vista City,51530,1445,1172,273,1168,*,*,277,*,*,1353,1080,273,1055,830,225,327,54,19,655
2/1/2017,VA,Virginia,Campbell,51031,12356,10252,2104,10244,85,10159,2112,62,2050,11581,9477,2104,9364,7527,1837,2045,380,169,6770
2/1/2017,VA,Virginia,Caroline,51033,5601,4601,1000,4685,34,4651,916,38,878,5053,4053,1000,3447,2569,878,775,241,58,2373
2/1/2017,VA,Virginia,Carroll,51035,7960,6776,1184,6442,24,6418,1518,13,1505,7509,6325,1184,5830,4894,936,1596,302,112,3820
2/1/2017,VA,Virginia,Charles City,51036,1850,1416,434,1577,20,1557,273,12,261,1696,1262,434,1303,939,364,255,83,20,945
2/1/2017,VA,Virginia,Charlotte,51037,3336,2782,554,2701,16,2685,635,17,618,3151,2597,554,2500,2023,477,785,139,54,1522
2/1/2017,VA,Virginia,Charlottesville City,51540,6026,5237,789,4952,33,4919,1074,47,1027,5400,4612,788,4320,3577,743,1202,160,51,2907
2/1/2017,VA,Virginia,Chesapeake City,51550,35583,28229,7354,30544,288,30256,5039,220,4819,32200,24846,7354,19838,13311,6527,3976,908,255,14699
2/1/2017,VA,Virginia,Chesterfield,51041,55979,42433,13546,48748,196,48552,7231,243,6988,50495,36952,13543,38663,26626,12037,5134,1054,308,32167
2/1/2017,VA,Virginia,Clarke,51043,3102,2748,354,2860,13,2847,242,*,*,2807,2453,354,1897,1624,273,252,77,30,1538
2/1/2017,VA,Virginia,Colonial Heights City,51570,4115,3428,687,3520,*,*,595,16,579,3787,3100,687,2445,1858,587,487,102,23,1833
2/1/2017,VA,Virginia,Covington City,51580,1641,1397,244,1272,13,1259,369,*,*,1531,1287,244,1217,988,229,357,53,20,787
2/1/2017,VA,Virginia,Craig,51045,1299,1018,281,1023,*,*,276,0,276,1197,916,281,937,670,267,195,45,12,685
2/1/2017,VA,Virginia,Culpeper,51047,8848,7511,1337,7660,44,7616,1188,42,1146,8031,6694,1337,5568,4500,1068,1117,257,66,4128
2/1/2017,VA,Virginia,Cumberland,51049,2227,1705,522,1859,*,*,368,*,*,2055,1533,522,1613,1150,463,407,98,31,1077
2/1/2017,VA,Virginia,Danville City,51590,11094,8942,2152,8734,88,8646,2360,117,2243,10476,8324,2152,8727,7308,1419,3188,445,166,4928
2/1/2017,VA,Virginia,Dickenson,51051,4741,2930,1811,2981,*,*,1760,12,1748,4506,2695,1811,3712,2106,1606,1103,216,82,2311
2/1/2017,VA,Virginia,Dinwiddie,51053,5690,4476,1214,4568,38,4530,1122,32,1090,5219,4005,1214,3845,2724,1121,886,188,53,2718
2/1/2017,VA,Virginia,Emporia City,51595,1147,875,272,888,16,872,259,12,247,1068,796,272,874,652,222,410,70,11,383
2/1/2017,VA,Virginia,Essex,51057,2826,2304,522,2409,21,2388,417,14,403,2629,2107,522,1976,1585,391,428,92,20,1436
2/1/2017,VA,Virginia,Fairfax,51059,141334,121470,19864,133397,572,132825,7937,419,7518,114246,94415,19831,66083,47927,18156,12932,2763,500,49888
2/1/2017,VA,Virginia,Fairfax City,51600,3652,3108,544,3378,13,3365,274,*,*,3050,2506,544,1844,1357,487,364,61,11,1408
2/1/2017,VA,Virginia,Falls Church City,51610,1831,1577,254,1744,*,*,87,*,*,1434,1180,254,874,642,232,125,*,*,725
2/1/2017,VA,Virginia,Fauquier,51061,11891,10559,1332,10816,61,10755,1075,38,1037,10538,9206,1332,6658,5580,1078,923,205,58,5472
2/1/2017,VA,Virginia,Floyd,51063,3898,3136,762,3364,14,3350,534,*,*,3623,2861,762,2839,2140,699,542,97,46,2154
2/1/2017,VA,Virginia,Fluvanna,51065,5593,4833,760,5016,22,4994,577,21,556,5111,4351,760,3727,3100,627,501,130,30,3066
2/1/2017,VA,Virginia,Franklin,51067,14139,10291,3848,11798,53,11745,2341,30,2311,13272,9425,3847,10777,7229,3548,1935,481,154,8207
2/1/2017,VA,Virginia,Franklin City,51620,1921,1589,332,1505,23,1482,416,23,393,1795,1463,332,1472,1168,304,551,66,16,839
2/1/2017,VA,Virginia,Frederick,51069,15549,13734,1815,13818,58,13760,1731,50,1681,14180,12366,1814,9671,8276,1395,1418,368,138,7747
2/1/2017,VA,Virginia,Fredericksburg City,51630,3881,3362,519,3180,22,3158,701,31,670,3503,2984,519,2409,1939,470,760,97,37,1515
2/1/2017,VA,Virginia,Galax City,51640,1884,1744,140,1489,*,*,395,*,*,1784,1644,140,1417,1307,110,639,60,35,683
2/1/2017,VA,Virginia,Giles,51071,4532,3433,1099,3594,24,3570,938,18,920,4262,3164,1098,3468,2757,711,784,129,33,2522
2/1/2017,VA,Virginia,Gloucester,51073,8091,6689,1402,6929,38,6891,1162,19,1143,7501,6099,1402,4779,3591,1188,930,179,43,3627
2/1/2017,VA,Virginia,Goochland,51075,5394,4257,1137,4925,22,4903,469,21,448,4886,3749,1137,3988,3073,915,399,105,34,3450
2/1/2017,VA,Virginia,Grayson,51077,4594,3942,652,3768,*,*,826,11,815,4387,3735,652,3308,2767,541,976,184,88,2060
2/1/2017,VA,Virginia,Greene,51079,3550,3083,467,3105,12,3093,445,*,*,3248,2781,467,2343,1941,402,450,86,26,1781
2/1/2017,VA,Virginia,Greensville,51081,2429,1817,612,1937,20,1917,492,17,475,2267,1655,612,1862,1367,495,523,131,30,1178
2/1/2017,VA,Virginia,Halifax,51083,9437,8112,1325,7731,70,7661,1706,55,1651,8908,7583,1325,7185,6030,1155,2103,462,143,4477
2/1/2017,VA,Virginia,Hampton City,51650,24179,18167,6012,19932,207,19725,4247,192,4055,22048,16036,6012,13368,7784,5584,3445,812,180,8931
2/1/2017,VA,Virginia,Hanover,51085,19784,15013,4771,17955,83,17872,1829,48,1781,18029,13258,4771,14393,10527,3866,1345,369,105,12574
2/1/2017,VA,Virginia,Harrisonburg City,51660,5144,4561,583,4363,16,4347,781,21,760,4655,4072,583,3648,3227,421,921,126,34,2567
2/1/2017,VA,Virginia,Henrico,51087,53762,39711,14051,46887,349,46538,6875,290,6585,48633,34583,14050,39045,27000,12045,5988,1438,405,31214
2/1/2017,VA,Virginia,Henry,51089,14967,10750,4217,11912,83,11829,3055,55,3000,14245,10028,4217,12047,8150,3897,2953,731,255,8108
2/1/2017,VA,Virginia,Highland,51091,753,683,70,690,*,*,63,*,*,705,635,70,519,456,63,62,*,*,429
2/1/2017,VA,Virginia,Hopewell City,51670,4451,3518,933,3422,32,3390,1029,29,1000,4133,3200,933,2832,1945,887,952,155,38,1687
2/1/2017,VA,Virginia,Isle of Wight,51093,7766,6048,1718,6814,51,6763,952,30,922,7199,5481,1718,5124,3582,1542,916,205,66,3937
2/1/2017,VA,Virginia,James City,51095,19423,16868,2555,18269,60,18209,1154,51,1103,17944,15392,2552,11382,9407,1975,819,214,54,10295
2/1/2017,VA,Virginia,King and Queen,51097,1700,1394,306,1426,11,1415,274,*,*,1587,1281,306,1175,913,262,264,71,16,824
2/1/2017,VA,Virginia,King George,51099,3669,3267,402,3160,16,3144,509,30,479,3182,2780,402,1629,1281,348,451,87,15,1076
2/1/2017,VA,Virginia,King William,51101,3212,2681,531,2761,28,2733,451,24,427,2959,2428,531,2384,1930,454,376,111,24,1873
2/1/2017,VA,Virginia,Lancaster,51103,4252,3664,588,3906,16,3890,346,14,332,4046,3458,588,2923,2520,403,483,99,20,2321
2/1/2017,VA,Virginia,Lee,51105,6308,3878,2430,4341,20,4321,1967,12,1955,5981,3552,2429,4868,2612,2256,1884,244,79,2661
2/1/2017,VA,Virginia,Lexington City,51678,1612,1450,162,1477,13,1464,135,*,*,1496,1334,162,1140,1009,131,211,*,*,890
2/1/2017,VA,Virginia,Loudoun,51107,34055,28652,5403,31736,149,31587,2319,111,2208,28284,22888,5396,18640,13826,4814,2862,672,158,14948
2/1/2017,VA,Virginia,Louisa,51109,7592,6240,1352,6396,41,6355,1196,31,1165,6959,5607,1352,5134,3944,1190,1018,249,73,3794
2/1/2017,VA,Virginia,Lunenburg,51111,2956,2544,412,2422,15,2407,534,22,512,2730,2318,412,2056,1702,354,697,121,45,1193
2/1/2017,VA,Virginia,Lynchburg City,51680,14447,12090,2357,11794,87,11707,2653,107,2546,13403,11046,2357,10907,8854,2053,2970,443,139,7355
2/1/2017,VA,Virginia,Madison,51113,2901,2472,429,2566,16,2550,335,12,323,2709,2280,429,1987,1631,356,387,93,24,1483
2/1/2017,VA,Virginia,Manassas City,51683,4256,3452,804,3731,35,3696,525,40,485,3586,2782,804,2464,1737,727,499,93,35,1837
2/1/2017,VA,Virginia,Manassas Park City,51685,1225,966,259,1059,13,1046,166,12,154,1036,778,258,718,487,231,182,51,11,474
2/1/2017,VA,Virginia,Martinsville City,51690,3923,2874,1049,2939,29,2910,984,42,942,3707,2658,1049,3182,2177,1005,1288,175,66,1653
2/1/2017,VA,Virginia,Mathews,51115,2782,2348,434,2557,13,2544,225,*,*,2630,2196,434,1814,1472,342,253,37,18,1506
2/1/2017,VA,Virginia,Mecklenburg,51117,9016,7101,1915,7470,62,7408,1546,55,1491,8503,6588,1915,6700,5110,1590,1878,392,114,4316
2/1/2017,VA,Virginia,Middlesex,51119,3498,2950,548,3124,21,3103,374,*,*,3295,2747,548,2510,2113,397,441,94,31,1944
2/1/2017,VA,Virginia,Montgomery,51121,13425,10998,2427,11075,47,11028,2350,38,2312,12159,9732,2427,9832,7609,2223,1884,336,118,7494
2/1/2017,VA,Virginia,Nelson,51125,4385,3795,590,3880,19,3861,505,11,494,4028,3438,590,2944,2430,514,578,102,47,2217
2/1/2017,VA,Virginia,New Kent,51127,4152,3405,747,3707,22,3685,445,*,*,3771,3024,747,2640,2069,571,266,84,15,2275
2/1/2017,VA,Virginia,Newport News City,51700,26941,19926,7015,22155,207,21948,4786,239,4547,24674,17661,7013,16065,9491,6574,4468,861,235,10501
2/1/2017,VA,Virginia,Norfolk City,51710,31787,23491,8296,25336,281,25055,6451,338,6113,28663,20367,8296,19275,11423,7852,6916,1379,290,10690
2/1/2017,VA,Virginia,Northampton,51131,3514,2910,604,3000,27,2973,514,26,488,3287,2683,604,2613,2112,501,893,92,32,1596
2/1/2017,VA,Virginia,Northumberland,51133,4551,3913,638,4231,14,4217,320,*,*,4233,3595,638,2818,2437,381,399,92,34,2293
2/1/2017,VA,Virginia,Norton City,51720,1172,806,366,791,*,*,381,*,*,1089,723,366,884,563,321,341,51,19,473
2/1/2017,VA,Virginia,Nottoway,51135,3628,2966,662,2962,30,2932,666,15,651,3376,2714,662,2645,2195,450,915,143,41,1546
2/1/2017,VA,Virginia,Orange,51137,8480,7376,1104,7482,47,7435,998,38,960,7780,6676,1104,5100,4335,765,934,223,65,3878
2/1/2017,VA,Virginia,Page,51139,6064,5313,751,4955,22,4933,1109,17,1092,5690,4939,751,4163,3532,631,1105,231,88,2739
2/1/2017,VA,Virginia,Patrick,51141,5100,3826,1274,4218,11,4207,882,12,870,4853,3580,1273,3946,2869,1077,988,209,80,2669
2/1/2017,VA,Virginia,Petersburg City,51730,7120,5308,1812,5288,104,5184,1832,87,1745,6486,4674,1812,4711,2970,1741,1972,364,64,2311
2/1/2017,VA,Virginia,Pittsylvania,51143,15823,12287,3536,12991,106,12885,2832,78,2754,14938,11402,3536,12262,9707,2555,3007,585,224,8446
2/1/2017,VA,Virginia,Poquoson City,51735,2476,2174,302,2310,*,*,166,*,*,2279,1977,302,1131,873,258,92,28,14,997
2/1/2017,VA,Virginia,Portsmouth City,51740,17705,13013,4692,13776,187,13589,3929,206,3723,15839,11149,4690,10496,6048,4448,3728,726,146,5896
2/1/2017,VA,Virginia,Powhatan,51145,5603,4411,1192,5008,24,4984,595,14,581,5152,3960,1192,4081,3075,1006,386,114,32,3549
2/1/2017,VA,Virginia,Prince Edward,51147,4587,3752,835,3698,38,3660,889,38,851,4252,3417,835,3287,2666,621,1065,174,50,1998
2/1/2017,VA,Virginia,Prince George,51149,5629,4850,779,4784,30,4754,845,30,815,5198,4419,779,3124,2444,680,532,129,27,2436
2/1/2017,VA,Virginia,Prince William,51153,44796,36749,8047,39879,289,39590,4917,290,4627,38195,30151,8044,22158,14801,7357,4902,1010,232,16014
2/1/2017,VA,Virginia,Pulaski,51155,8917,7186,1731,7098,37,7061,1819,29,1790,8319,6588,1731,6388,4809,1579,1593,325,119,4351
2/1/2017,VA,Virginia,Radford City,51750,2021,1625,396,1622,*,*,399,*,*,1855,1459,396,1536,1180,356,336,45,22,1133
2/1/2017,VA,Virginia,Rappahannock,51157,1982,1817,165,1837,*,*,145,*,*,1785,1621,164,1184,1059,125,149,*,*,988
2/1/2017,VA,Virginia,Richmond,51159,1961,1575,386,1708,15,1693,253,14,239,1819,1433,386,1350,1088,262,287,89,21,953
2/1/2017,VA,Virginia,Richmond City,51760,32920,22103,10817,25811,299,25512,7109,340,6769,29587,18770,10817,24790,14558,10232,8518,1455,313,14504
2/1/2017,VA,Virginia,Roanoke,51161,22855,17936,4919,20325,109,20216,2530,54,2476,21178,16260,4918,16803,12506,4297,1948,452,151,14252
2/1/2017,VA,Virginia,Roanoke City,51770,20166,14374,5792,15124,144,14980,5042,149,4893,18429,12638,5791,14932,9518,5414,4677,880,215,9160
2/1/2017,VA,Virginia,Rockbridge,51163,5786,4850,936,4919,25,4894,867,*,*,5379,4443,936,4046,3279,767,802,192,72,2980
2/1/2017,VA,Virginia,Rockingham,51165,16767,14189,2578,14687,49,14638,2080,41,2039,15533,12955,2578,11975,10136,1839,1758,512,158,9547
2/1/2017,VA,Virginia,Russell,51167,7715,5115,2600,5260,19,5241,2455,13,2442,7370,4770,2600,6304,4148,2156,1654,311,130,4209
2/1/2017,VA,Virginia,Salem City,51775,5967,4753,1214,5035,31,5004,932,17,915,5483,4269,1214,4318,3240,1078,819,147,39,3313
2/1/2017,VA,Virginia,Scott,51169,6570,3344,3226,4930,11,4919,1640,13,1627,6297,3072,3225,5449,2287,3162,1498,257,123,3571
2/1/2017,VA,Virginia,Shenandoah,51171,10166,8941,1225,8954,28,8926,1212,27,1185,9511,8286,1225,6663,5693,970,1232,263,110,5058
2/1/2017,VA,Virginia,Smyth,51173,8820,6751,2069,6579,29,6550,2241,23,2218,8311,6242,2069,6771,4933,1838,2155,415,138,4063
2/1/2017,VA,Virginia,Southampton,51175,4004,3339,665,3338,31,3307,666,22,644,3737,3072,665,2939,2366,573,717,133,36,2053
2/1/2017,VA,Virginia,Spotsylvania,51177,19632,16991,2641,17021,116,16905,2611,94,2517,17469,14829,2640,10590,8429,2161,1893,510,132,8055
2/1/2017,VA,Virginia,Stafford,51179,16040,14391,1649,14138,99,14039,1902,82,1820,14054,12405,1649,7148,5778,1370,1282,362,80,5424
2/1/2017,VA,Virginia,Staunton City,51790,5978,5106,872,4940,27,4913,1038,23,1015,5615,4743,872,4379,3661,718,1034,165,71,3109
2/1/2017,VA,Virginia,Suffolk City,51800,15290,12046,3244,12533,106,12427,2757,98,2659,14004,10760,3244,9680,6758,2922,2594,459,112,6515
2/1/2017,VA,Virginia,Surry,51181,1518,1167,351,1282,11,1271,236,*,*,1401,1050,351,1024,703,321,201,67,13,743
2/1/2017,VA,Virginia,Sussex,51183,2327,1771,556,1905,31,1874,422,*,*,2166,1610,556,1678,1161,517,470,143,20,1045
2/1/2017,VA,Virginia,Tazewell,51185,11758,8354,3404,8686,37,8649,3072,39,3033,11117,7715,3402,8797,6578,2219,2211,457,189,5940
2/1/2017,VA,Virginia,Unknown,51999,*,*,*,*,*,*,*,*,*,*,*,*,*,*,*,*,*,*,*
2/1/2017,VA,Virginia,Virginia Beach City,51810,67587,55638,11949,59583,383,59200,8004,338,7666,61898,49955,11943,35078,24340,10738,6473,1448,374,26783
2/1/2017,VA,Virginia,Warren,51187,7209,6461,748,6178,32,6146,1031,29,1002,6566,5818,748,4450,3849,601,851,247,76,3276
2/1/2017,VA,Virginia,Washington,51191,14747,9862,4885,11805,49,11756,2942,31,2911,13867,8983,4884,11253,6763,4490,2423,531,166,8133
2/1/2017,VA,Virginia,Waynesboro City,51820,4687,3955,732,3829,16,3813,858,24,834,4379,3647,732,3470,2842,628,867,114,40,2449
2/1/2017,VA,Virginia,Westmoreland,51193,4763,4074,689,4183,28,4155,580,11,569,4362,3673,689,2759,2192,567,712,137,50,1860
2/1/2017,VA,Virginia,Williamsburg City,51830,2520,2119,401,2308,*,*,212,*,*,2313,1913,400,1617,1289,328,225,*,*,1356
2/1/2017,VA,Virginia,Winchester City,51840,5027,4480,547,4279,23,4256,748,19,729,4552,4005,547,3298,2869,429,820,134,51,2293
2/1/2017,VA,Virginia,Wise,51195,10474,6682,3792,7043,23,7020,3431,24,3407,9869,6077,3792,7799,4351,3448,2377,485,165,4772
2/1/2017,VA,Virginia,Wythe,51197,7452,5675,1777,5817,34,5783,1635,20,1615,7030,5253,1777,5484,3941,1543,1460,278,108,3638
2/1/2017,VA,Virginia,York,51199,11228,9695,1533,10301,37,10264,927,29,898,10294,8761,1533,5469,4182,1287,639,171,42,4617
1/1/2017,VA,Virginia,Accomack,51001,8497,7126,1371,7327,51,7276,1170,47,1123,7906,6535,1371,5817,4755,1062,1441,389,104,3883
1/1/2017,VA,Virginia,Albemarle,51003,19468,17256,2212,17917,66,17851,1551,48,1503,17482,15270,2212,13241,11315,1926,1465,306,98,11372
1/1/2017,VA,Virginia,Alexandria City,51510,16846,14432,2414,15474,83,15391,1372,91,1281,13572,11161,2411,8119,5887,2232,2013,328,64,5714
1/1/2017,VA,Virginia,Alleghany,51005,4481,3829,652,3635,22,3613,846,17,829,4255,3603,652,3409,2911,498,770,107,53,2479
1/1/2017,VA,Virginia,Amelia,51007,2973,2280,693,2506,13,2493,467,*,*,2745,2052,693,2145,1524,621,460,83,37,1565
1/1/2017,VA,Virginia,Amherst,51009,7596,6254,1342,6339,51,6288,1257,29,1228,7058,5716,1342,5700,4528,1172,1156,238,77,4229
1/1/2017,VA,Virginia,Appomattox,51011,3738,3118,620,3072,16,3056,666,20,646,3528,2908,620,2841,2298,543,637,96,38,2070
1/1/2017,VA,Virginia,Arlington,51013,23076,20032,3044,21507,99,21408,1569,91,1478,18261,15217,3044,10826,8019,2807,2842,336,117,7531
1/1/2017,VA,Virginia,Augusta,51015,17495,14945,2550,15134,61,15073,2361,43,2318,16454,13904,2550,12514,10478,2036,1755,415,151,10193
1/1/2017,VA,Virginia,Bath,51017,1263,1152,111,1121,*,*,142,*,*,1188,1077,111,928,834,94,169,38,23,698
1/1/2017,VA,Virginia,Bedford,51019,18928,15376,3552,16212,91,16121,2716,49,2667,17624,14074,3550,13669,11080,2589,1929,478,167,11095
1/1/2017,VA,Virginia,Bland,51021,1759,1362,397,1387,12,1375,372,*,*,1658,1261,397,1248,1030,218,248,51,18,931
1/1/2017,VA,Virginia,Botetourt,51023,8325,6399,1926,7214,47,7167,1111,17,1094,7712,5786,1926,6035,4361,1674,823,184,57,4971
1/1/2017,VA,Virginia,Bristol City,51520,4500,2684,1816,3492,17,3475,1008,11,997,4217,2401,1816,3546,1797,1749,1031,157,55,2303
1/1/2017,VA,Virginia,Brunswick,51025,3917,3191,726,3212,30,3182,705,28,677,3680,2954,726,2892,2256,636,1108,108,41,1635
1/1/2017,VA,Virginia,Buchanan,51027,7274,4391,2883,4570,22,4548,2704,14,2690,6960,4077,2883,5810,3745,2065,1583,425,113,3689
1/1/2017,VA,Virginia,Buckingham,51029,3401,2763,638,2769,19,2750,632,17,615,3175,2537,638,2434,2037,397,711,143,50,1530
1/1/2017,VA,Virginia,Buena Vista City,51530,1446,1174,272,1170,*,*,276,*,*,1351,1079,272,1052,827,225,329,56,20,647
1/1/2017,VA,Virginia,Campbell,51031,12351,10222,2129,10238,88,10150,2113,64,2049,11582,9453,2129,9364,7506,1858,2040,376,168,6780
1/1/2017,VA,Virginia,Caroline,51033,5576,4582,994,4668,34,4634,908,38,870,5035,4041,994,3424,2554,870,770,241,58,2355
1/1/2017,VA,Virginia,Carroll,51035,7942,6760,1182,6429,24,6405,1513,13,1500,7494,6312,1182,5819,4882,937,1584,303,113,3819
1/1/2017,VA,Virginia,Charles City,51036,1839,1410,429,1566,20,1546,273,13,260,1687,1258,429,1296,936,360,255,84,20,937
1/1/2017,VA,Virginia,Charlotte,51037,3329,2774,555,2697,16,2681,632,17,615,3147,2592,555,2499,2021,478,785,139,55,1520
1/1/2017,VA,Virginia,Charlottesville City,51540,6026,5244,782,4952,33,4919,1074,47,1027,5400,4618,782,4316,3580,736,1204,161,49,2902
1/1/2017,VA,Virginia,Chesapeake City,51550,35515,28184,7331,30501,291,30210,5014,219,4795,32151,24820,7331,19777,13274,6503,3941,911,252,14673
1/1/2017,VA,Virginia,Chesterfield,51041,55854,42332,13522,48647,197,48450,7207,241,6966,50411,36892,13519,38563,26553,12010,5109,1052,308,32094
1/1/2017,VA,Virginia,Clarke,51043,3096,2740,356,2853,13,2840,243,*,*,2804,2448,356,1893,1616,277,256,77,30,1530
1/1/2017,VA,Virginia,Colonial Heights City,51570,4127,3429,698,3534,*,*,593,16,577,3804,3106,698,2456,1858,598,490,103,23,1840
1/1/2017,VA,Virginia,Covington City,51580,1640,1399,241,1275,13,1262,365,*,*,1529,1288,241,1215,992,223,354,54,19,788
1/1/2017,VA,Virginia,Craig,51045,1300,1021,279,1026,*,*,274,0,274,1198,919,279,935,669,266,194,43,12,686
1/1/2017,VA,Virginia,Culpeper,51047,8822,7493,1329,7643,44,7599,1179,42,1137,8014,6685,1329,5557,4497,1060,1108,259,65,4125
1/1/2017,VA,Virginia,Cumberland,51049,2228,1708,520,1860,*,*,368,*,*,2055,1535,520,1612,1152,460,405,95,31,1081
1/1/2017,VA,Virginia,Danville City,51590,11117,8987,2130,8762,91,8671,2355,119,2236,10501,8371,2130,8731,7338,1393,3189,449,165,4928
1/1/2017,VA,Virginia,Dickenson,51051,4725,2922,1803,2978,*,*,1747,12,1735,4500,2697,1803,3709,2105,1604,1101,217,81,2310
1/1/2017,VA,Virginia,Dinwiddie,51053,5676,4469,1207,4565,40,4525,1111,32,1079,5213,4006,1207,3837,2722,1115,877,189,52,2719
1/1/2017,VA,Virginia,Emporia City,51595,1147,876,271,887,15,872,260,13,247,1068,797,271,878,657,221,410,*,*,388
1/1/2017,VA,Virginia,Essex,51057,2814,2298,516,2400,23,2377,414,14,400,2621,2105,516,1973,1592,381,425,96,20,1432
1/1/2017,VA,Virginia,Fairfax,51059,140825,121071,19754,132914,580,132334,7911,419,7492,113941,94220,19721,65823,47783,18040,12850,2752,504,49717
1/1/2017,VA,Virginia,Fairfax City,51600,3652,3109,543,3380,13,3367,272,*,*,3048,2505,543,1844,1357,487,364,*,*,1410
1/1/2017,VA,Virginia,Falls Church City,51610,1826,1572,254,1739,*,*,87,*,*,1430,1176,254,873,642,231,125,*,*,724
1/1/2017,VA,Virginia,Fauquier,51061,11874,10522,1352,10808,63,10745,1066,38,1028,10521,9169,1352,6645,5548,1097,913,208,58,5466
1/1/2017,VA,Virginia,Floyd,51063,3896,3127,769,3364,14,3350,532,*,*,3623,2854,769,2832,2126,706,538,97,46,2151
1/1/2017,VA,Virginia,Fluvanna,51065,5592,4841,751,5021,22,4999,571,21,550,5109,4358,751,3715,3096,619,495,130,30,3060
1/1/2017,VA,Virginia,Franklin,51067,14131,10269,3862,11796,56,11740,2335,31,2304,13267,9406,3861,10770,7208,3562,1923,482,157,8208
1/1/2017,VA,Virginia,Franklin City,51620,1917,1589,328,1502,24,1478,415,23,392,1792,1464,328,1469,1169,300,552,66,15,836
1/1/2017,VA,Virginia,Frederick,51069,15526,13711,1815,13807,59,13748,1719,50,1669,14159,12345,1814,9650,8256,1394,1412,371,138,7729
1/1/2017,VA,Virginia,Fredericksburg City,51630,3881,3372,509,3180,23,3157,701,30,671,3505,2996,509,2415,1955,460,761,96,38,1520
1/1/2017,VA,Virginia,Galax City,51640,1897,1755,142,1500,*,*,397,11,386,1796,1654,142,1426,1315,111,641,61,35,689
1/1/2017,VA,Virginia,Giles,51071,4529,3425,1104,3599,24,3575,930,18,912,4262,3159,1103,3465,2752,713,780,132,34,2519
1/1/2017,VA,Virginia,Gloucester,51073,8074,6670,1404,6911,39,6872,1163,20,1143,7485,6081,1404,4774,3586,1188,924,179,43,3628
1/1/2017,VA,Virginia,Goochland,51075,5381,4246,1135,4919,23,4896,462,20,442,4873,3738,1135,3973,3060,913,397,106,35,3435
1/1/2017,VA,Virginia,Grayson,51077,4588,3936,652,3766,*,*,822,11,811,4380,3728,652,3295,2755,540,975,186,87,2047
1/1/2017,VA,Virginia,Greene,51079,3551,3083,468,3109,12,3097,442,*,*,3247,2779,468,2340,1937,403,447,88,26,1779
1/1/2017,VA,Virginia,Greensville,51081,2428,1813,615,1939,21,1918,489,17,472,2270,1655,615,1865,1367,498,525,131,30,1179
1/1/2017,VA,Virginia,Halifax,51083,9440,8102,1338,7732,72,7660,1708,56,1652,8914,7576,1338,7194,6026,1168,2099,465,143,4487
1/1/2017,VA,Virginia,Hampton City,51650,24144,18136,6008,19916,210,19706,4228,190,4038,22026,16018,6008,13347,7769,5578,3431,813,180,8923
1/1/2017,VA,Virginia,Hanover,51085,19751,14973,4778,17932,87,17845,1819,48,1771,18008,13231,4777,14369,10500,3869,1345,371,106,12547
1/1/2017,VA,Virginia,Harrisonburg City,51660,5135,4548,587,4355,17,4338,780,22,758,4655,4068,587,3640,3216,424,918,120,34,2568
1/1/2017,VA,Virginia,Henrico,51087,53679,39673,14006,46810,354,46456,6869,291,6578,48590,34585,14005,38983,26987,11996,5960,1450,409,31164
1/1/2017,VA,Virginia,Henry,51089,14966,10760,4206,11917,85,11832,3049,55,2994,14249,10043,4206,12035,8152,3883,2946,731,253,8105
1/1/2017,VA,Virginia,Highland,51091,749,677,72,686,*,*,63,*,*,702,630,72,520,455,65,61,*,*,431
1/1/2017,VA,Virginia,Hopewell City,51670,4457,3527,930,3431,33,3398,1026,30,996,4137,3207,930,2830,1947,883,947,155,39,1689
1/1/2017,VA,Virginia,Isle of Wight,51093,7764,6040,1724,6811,52,6759,953,31,922,7207,5483,1724,5115,3566,1549,909,209,65,3932
1/1/2017,VA,Virginia,James City,51095,19394,16839,2555,18247,60,18187,1147,50,1097,17913,15361,2552,11374,9396,1978,811,214,53,10296
1/1/2017,VA,Virginia,King and Queen,51097,1697,1395,302,1425,11,1414,272,*,*,1586,1284,302,1174,917,257,257,73,17,827
1/1/2017,VA,Virginia,King George,51099,3666,3263,403,3159,17,3142,507,28,479,3184,2781,403,1627,1281,346,450,89,15,1073
1/1/2017,VA,Virginia,King William,51101,3206,2677,529,2760,28,2732,446,25,421,2953,2424,529,2372,1920,452,372,111,24,1865
1/1/2017,VA,Virginia,Lancaster,51103,4242,3659,583,3901,17,3884,341,14,327,4038,3455,583,2916,2522,394,480,99,21,2316
1/1/2017,VA,Virginia,Lee,51105,6301,3878,2423,4346,21,4325,1955,12,1943,5976,3554,2422,4870,2621,2249,1882,241,79,2668
1/1/2017,VA,Virginia,Lexington City,51678,1613,1453,160,1479,14,1465,134,*,*,1500,1340,160,1140,1010,130,209,*,*,894
1/1/2017,VA,Virginia,Loudoun,51107,33985,28608,5377,31679,149,31530,2306,111,2195,28234,22865,5369,18577,13787,4790,2840,670,155,14912
1/1/2017,VA,Virginia,Louisa,51109,7585,6234,1351,6393,41,6352,1192,32,1160,6954,5603,1351,5138,3946,1192,1015,252,71,3800
1/1/2017,VA,Virginia,Lunenburg,51111,2957,2542,415,2426,15,2411,531,21,510,2736,2321,415,2057,1700,357,689,121,45,1202
1/1/2017,VA,Virginia,Lynchburg City,51680,14456,12069,2387,11807,93,11714,2649,107,2542,13417,11030,2387,10894,8814,2080,2967,439,135,7353
1/1/2017,VA,Virginia,Madison,51113,2897,2466,431,2564,16,2548,333,12,321,2707,2276,431,1987,1629,358,383,95,24,1485
1/1/2017,VA,Virginia,Manassas City,51683,4243,3442,801,3722,35,3687,521,40,481,3577,2776,801,2462,1738,724,499,91,35,1837
1/1/2017,VA,Virginia,Manassas Park City,51685,1222,965,257,1057,13,1044,165,11,154,1034,778,256,718,489,229,185,51,11,471
1/1/2017,VA,Virginia,Martinsville City,51690,3928,2864,1064,2951,29,2922,977,41,936,3715,2651,1064,3181,2162,1019,1283,176,65,1657
1/1/2017,VA,Virginia,Mathews,51115,2780,2345,435,2556,13,2543,224,*,*,2625,2190,435,1808,1465,343,249,38,17,1504
1/1/2017,VA,Virginia,Mecklenburg,51117,9020,7075,1945,7478,63,7415,1542,55,1487,8510,6565,1945,6698,5079,1619,1882,391,114,4311
1/1/2017,VA,Virginia,Middlesex,51119,3496,2950,546,3123,21,3102,373,*,*,3288,2742,546,2505,2111,394,434,95,31,1945
1/1/2017,VA,Virginia,Montgomery,51121,13409,10980,2429,11067,50,11017,2342,39,2303,12150,9721,2429,9814,7589,2225,1869,335,117,7493
1/1/2017,VA,Virginia,Nelson,51125,4366,3781,585,3862,19,3843,504,11,493,4015,3430,585,2929,2422,507,577,102,48,2202
1/1/2017,VA,Virginia,New Kent,51127,4131,3381,750,3687,22,3665,444,*,*,3759,3009,750,2627,2053,574,263,84,15,2265
1/1/2017,VA,Virginia,Newport News City,51700,26916,19931,6985,22148,210,21938,4768,234,4534,24672,17689,6983,16030,9488,6542,4440,864,233,10493
1/1/2017,VA,Virginia,Norfolk City,51710,31756,23518,8238,25326,289,25037,6430,341,6089,28628,20390,8238,19223,11431,7792,6889,1376,293,10665
1/1/2017,VA,Virginia,Northampton,51131,3516,2909,607,3001,28,2973,515,26,489,3294,2687,607,2618,2111,507,899,92,32,1595
1/1/2017,VA,Virginia,Northumberland,51133,4548,3907,641,4227,14,4213,321,*,*,4232,3591,641,2815,2433,382,397,91,34,2293
1/1/2017,VA,Virginia,Norton City,51720,1171,808,363,791,*,*,380,*,*,1087,724,363,882,564,318,341,51,19,471
1/1/2017,VA,Virginia,Nottoway,51135,3633,2972,661,2966,31,2935,667,16,651,3382,2721,661,2641,2195,446,913,141,41,1546
1/1/2017,VA,Virginia,Orange,51137,8457,7352,1105,7461,47,7414,996,38,958,7768,6663,1105,5085,4320,765,921,221,66,3877
1/1/2017,VA,Virginia,Page,51139,6060,5300,760,4952,23,4929,1108,17,1091,5683,4923,760,4158,3522,636,1096,232,89,2741
1/1/2017,VA,Virginia,Patrick,51141,5113,3840,1273,4228,11,4217,885,12,873,4862,3590,1272,3950,2875,1075,993,207,79,2671
1/1/2017,VA,Virginia,Petersburg City,51730,7117,5326,1791,5285,107,5178,1832,89,1743,6490,4699,1791,4696,2976,1720,1953,367,66,2310
1/1/2017,VA,Virginia,Pittsylvania,51143,15807,12267,3540,12990,109,12881,2817,79,2738,14927,11387,3540,12242,9687,2555,2992,585,224,8441
1/1/2017,VA,Virginia,Poquoson City,51735,2473,2169,304,2310,*,*,163,*,*,2279,1975,304,1132,874,258,92,28,14,998
1/1/2017,VA,Virginia,Portsmouth City,51740,17709,13026,4683,13789,194,13595,3920,207,3713,15832,11151,4681,10472,6038,4434,3721,722,145,5884
1/1/2017,VA,Virginia,Powhatan,51145,5603,4412,1191,5010,24,4986,593,14,579,5154,3963,1191,4072,3069,1003,379,113,31,3549
1/1/2017,VA,Virginia,Prince Edward,51147,4581,3756,825,3694,39,3655,887,39,848,4248,3423,825,3284,2672,612,1066,174,50,1994
1/1/2017,VA,Virginia,Prince George,51149,5615,4836,779,4773,33,4740,842,28,814,5186,4407,779,3119,2438,681,533,125,26,2435
1/1/2017,VA,Virginia,Prince William,51153,44650,36659,7991,39758,296,39462,4892,289,4603,38092,30104,7988,22087,14791,7296,4889,1008,231,15959
1/1/2017,VA,Virginia,Pulaski,51155,8913,7175,1738,7100,37,7063,1813,30,1783,8324,6586,1738,6393,4810,1583,1583,329,120,4361
1/1/2017,VA,Virginia,Radford City,51750,2024,1628,396,1623,*,*,401,*,*,1858,1462,396,1535,1179,356,337,43,22,1133
1/1/2017,VA,Virginia,Rappahannock,51157,1984,1816,168,1839,*,*,145,*,*,1791,1624,167,1188,1060,128,152,*,*,989
1/1/2017,VA,Virginia,Richmond,51159,1966,1579,387,1713,16,1697,253,14,239,1826,1439,387,1363,1101,262,291,90,21,961
1/1/2017,VA,Virginia,Richmond City,51760,32881,22131,10750,25795,306,25489,7086,343,6743,29555,18805,10750,24751,14585,10166,8469,1453,316,14513
1/1/2017,VA,Virginia,Roanoke,51161,22817,17900,4917,20298,112,20186,2519,55,2464,21151,16235,4916,16779,12484,4295,1937,455,151,14236
1/1/2017,VA,Virginia,Roanoke City,51770,20141,14367,5774,15128,148,14980,5013,151,4862,18401,12628,5773,14922,9526,5396,4656,876,214,9176
1/1/2017,VA,Virginia,Rockbridge,51163,5769,4835,934,4908,25,4883,861,*,*,5366,4432,934,4037,3272,765,798,188,73,2978
1/1/2017,VA,Virginia,Rockingham,51165,16757,14169,2588,14687,49,14638,2070,41,2029,15513,12925,2588,11961,10117,1844,1745,520,160,9536
1/1/2017,VA,Virginia,Russell,51167,7708,5107,2601,5270,19,5251,2438,13,2425,7360,4759,2601,6303,4141,2162,1652,312,129,4210
1/1/2017,VA,Virginia,Salem City,51775,5982,4760,1222,5056,33,5023,926,17,909,5497,4275,1222,4335,3249,1086,830,146,40,3319
1/1/2017,VA,Virginia,Scott,51169,6570,3339,3231,4935,11,4924,1635,13,1622,6297,3067,3230,5450,2284,3166,1499,257,122,3572
1/1/2017,VA,Virginia,Shenandoah,51171,10157,8928,1229,8946,28,8918,1211,29,1182,9505,8276,1229,6646,5672,974,1226,262,110,5048
1/1/2017,VA,Virginia,Smyth,51173,8823,6752,2071,6587,30,6557,2236,21,2215,8308,6237,2071,6763,4922,1841,2158,413,137,4055
1/1/2017,VA,Virginia,Southampton,51175,3992,3333,659,3328,32,3296,664,24,640,3727,3068,659,2926,2360,566,710,135,36,2045
1/1/2017,VA,Virginia,Spotsylvania,51177,19591,16962,2629,16990,117,16873,2601,94,2507,17443,14815,2628,10564,8415,2149,1879,507,135,8043
1/1/2017,VA,Virginia,Stafford,51179,15985,14351,1634,14102,101,14001,1883,83,1800,14005,12371,1634,7120,5763,1357,1271,364,79,5406
1/1/2017,VA,Virginia,Staunton City,51790,5975,5109,866,4938,29,4909,1037,23,1014,5615,4749,866,4358,3648,710,1033,164,71,3090
1/1/2017,VA,Virginia,Suffolk City,51800,15253,12037,3216,12504,107,12397,2749,99,2650,13975,10759,3216,9640,6747,2893,2580,460,111,6489
1/1/2017,VA,Virginia,Surry,51181,1520,1168,352,1284,12,1272,236,*,*,1404,1052,352,1029,707,322,200,68,13,748
1/1/2017,VA,Virginia,Sussex,51183,2328,1773,555,1909,32,1877,419,*,*,2171,1616,555,1680,1163,517,472,142,19,1047
1/1/2017,VA,Virginia,Tazewell,51185,11770,8376,3394,8704,38,8666,3066,41,3025,11122,7730,3392,8791,6583,2208,2205,455,191,5940
1/1/2017,VA,Virginia,Unknown,51999,*,*,*,*,*,*,*,*,*,*,*,*,*,*,*,*,*,*,*
1/1/2017,VA,Virginia,Virginia Beach City,51810,67450,55519,11931,59488,389,59099,7962,335,7627,61805,49880,11925,34989,24276,10713,6438,1445,372,26734
1/1/2017,VA,Virginia,Warren,51187,7187,6435,752,6157,32,6125,1030,29,1001,6552,5800,752,4441,3836,605,848,245,75,3273
1/1/2017,VA,Virginia,Washington,51191,14765,9863,4902,11831,51,11780,2934,31,2903,13882,8981,4901,11270,6765,4505,2407,538,168,8157
1/1/2017,VA,Virginia,Waynesboro City,51820,4694,3967,727,3839,16,3823,855,26,829,4390,3663,727,3476,2854,622,866,115,39,2456
1/1/2017,VA,Virginia,Westmoreland,51193,4766,4072,694,4190,28,4162,576,12,564,4362,3668,694,2759,2189,570,708,140,50,1861
1/1/2017,VA,Virginia,Williamsburg City,51830,2519,2114,405,2308,*,*,211,*,*,2312,1908,404,1619,1286,333,225,*,*,1357
1/1/2017,VA,Virginia,Winchester City,51840,5027,4487,540,4282,23,4259,745,19,726,4559,4019,540,3289,2866,423,816,135,51,2287
1/1/2017,VA,Virginia,Wise,51195,10462,6681,3781,7042,24,7018,3420,23,3397,9856,6075,3781,7794,4361,3433,2372,490,164,4768
1/1/2017,VA,Virginia,Wythe,51197,7454,5677,1777,5819,35,5784,1635,19,1616,7033,5256,1777,5480,3939,1541,1452,279,109,3640
1/1/2017,VA,Virginia,York,51199,11226,9691,1535,10303,39,10264,923,29,894,10294,8759,1535,5476,4189,1287,640,171,42,4623
7/1/2017,VA,Virginia,Accomack,51001,8606,7254,1352,7394,48,7346,1212,47,1165,8015,6663,1352,5858,4813,1045,1493,376,92,3897
7/1/2017,VA,Virginia,Albemarle,51003,19737,17556,2181,18163,58,18105,1574,49,1525,17734,15553,2181,13421,11525,1896,1514,297,97,11513
7/1/2017,VA,Virginia,Alexandria City,51510,17202,14768,2434,15786,79,15707,1416,91,1325,13907,11477,2430,8260,6003,2257,2090,319,58,5793
7/1/2017,VA,Virginia,Alleghany,51005,4481,3842,639,3618,21,3597,863,14,849,4250,3611,639,3387,2902,485,784,103,49,2451
7/1/2017,VA,Virginia,Amelia,51007,2996,2307,689,2522,12,2510,474,*,*,2768,2079,689,2157,1538,619,463,83,35,1576
7/1/2017,VA,Virginia,Amherst,51009,7659,6365,1294,6380,49,6331,1279,28,1251,7115,5821,1294,5735,4607,1128,1223,228,72,4212
7/1/2017,VA,Virginia,Appomattox,51011,3769,3162,607,3083,14,3069,686,19,667,3548,2941,607,2852,2320,532,661,104,36,2051
7/1/2017,VA,Virginia,Arlington,51013,23517,20451,3066,21906,91,21815,1611,97,1514,18614,15548,3066,11028,8201,2827,2914,340,105,7669
7/1/2017,VA,Virginia,Augusta,51015,17700,15165,2535,15275,52,15223,2425,43,2382,16656,14121,2535,12662,10628,2034,1791,413,145,10313
7/1/2017,VA,Virginia,Bath,51017,1263,1156,107,1116,*,*,147,*,*,1190,1083,107,917,826,91,165,38,25,689
7/1/2017,VA,Virginia,Bedford,51019,19121,15666,3455,16351,83,16268,2770,52,2718,17800,14347,3453,13757,11247,2510,1956,474,164,11163
7/1/2017,VA,Virginia,Bland,51021,1777,1378,399,1392,*,*,385,*,*,1687,1288,399,1251,1032,219,250,51,17,933
7/1/2017,VA,Virginia,Botetourt,51023,8392,6464,1928,7263,42,7221,1129,15,1114,7776,5848,1928,6088,4417,1671,829,179,53,5027
7/1/2017,VA,Virginia,Bristol City,51520,4514,2695,1819,3487,14,3473,1027,11,1016,4241,2422,1819,3559,1809,1750,1064,150,50,2295
7/1/2017,VA,Virginia,Brunswick,51025,3936,3220,716,3229,24,3205,707,23,684,3695,2979,716,2877,2254,623,1118,108,40,1611
7/1/2017,VA,Virginia,Buchanan,51027,7288,4391,2897,4536,19,4517,2752,15,2737,7014,4117,2897,5801,3723,2078,1617,412,110,3662
7/1/2017,VA,Virginia,Buckingham,51029,3434,2791,643,2786,18,2768,648,22,626,3213,2570,643,2452,2045,407,734,145,46,1527
7/1/2017,VA,Virginia,Buena Vista City,51530,1442,1172,270,1161,*,*,281,*,*,1352,1082,270,1055,833,222,330,53,19,653
7/1/2017,VA,Virginia,Campbell,51031,12465,10396,2069,10313,79,10234,2152,62,2090,11680,9611,2069,9399,7597,1802,2084,383,162,6770
7/1/2017,VA,Virginia,Caroline,51033,5659,4674,985,4717,31,4686,942,40,902,5127,4142,985,3462,2601,861,799,230,56,2377
7/1/2017,VA,Virginia,Carroll,51035,8005,6833,1172,6465,24,6441,1540,13,1527,7573,6401,1172,5838,4911,927,1636,282,105,3815
7/1/2017,VA,Virginia,Charles City,51036,1866,1445,421,1585,19,1566,281,11,270,1714,1293,421,1310,959,351,259,79,17,955
7/1/2017,VA,Virginia,Charlotte,51037,3340,2803,537,2696,13,2683,644,18,626,3155,2618,537,2500,2038,462,800,132,51,1517
7/1/2017,VA,Virginia,Charlottesville City,51540,6128,5368,760,5034,30,5004,1094,49,1045,5495,4736,759,4352,3639,713,1234,161,48,2909
7/1/2017,VA,Virginia,Chesapeake City,51550,36102,28756,7346,30928,270,30658,5174,227,4947,32714,25368,7346,20002,13473,6529,4072,898,247,14785
7/1/2017,VA,Virginia,Chesterfield,51041,56876,43289,13587,49454,189,49265,7422,251,7171,51373,37789,13584,39203,27133,12070,5315,1021,278,32589
7/1/2017,VA,Virginia,Clarke,51043,3151,2790,361,2897,11,2886,254,*,*,2854,2493,361,1909,1632,277,254,74,28,1553
7/1/2017,VA,Virginia,Colonial Heights City,51570,4129,3445,684,3516,*,*,613,16,597,3808,3124,684,2450,1866,584,498,96,24,1832
7/1/2017,VA,Virginia,Covington City,51580,1644,1402,242,1270,11,1259,374,*,*,1536,1294,242,1219,995,224,358,51,20,790
7/1/2017,VA,Virginia,Craig,51045,1310,1029,281,1024,*,*,286,0,286,1206,925,281,945,679,266,197,43,11,694
7/1/2017,VA,Virginia,Culpeper,51047,8946,7633,1313,7724,39,7685,1222,43,1179,8104,6791,1313,5589,4544,1045,1167,239,63,4120
7/1/2017,VA,Virginia,Cumberland,51049,2245,1741,504,1870,*,*,375,*,*,2084,1580,504,1627,1181,446,421,98,33,1075
7/1/2017,VA,Virginia,Danville City,51590,11097,8919,2178,8716,84,8632,2381,116,2265,10461,8283,2178,8695,7261,1434,3213,432,162,4888
7/1/2017,VA,Virginia,Dickenson,51051,4730,2915,1815,2957,*,*,1773,11,1762,4516,2701,1815,3695,2086,1609,1114,207,76,2298
7/1/2017,VA,Virginia,Dinwiddie,51053,5716,4526,1190,4586,35,4551,1130,30,1100,5258,4068,1190,3867,2768,1099,903,180,52,2732
7/1/2017,VA,Virginia,Emporia City,51595,1137,875,262,876,16,860,261,11,250,1062,800,262,870,656,214,411,70,12,377
7/1/2017,VA,Virginia,Essex,51057,2859,2333,526,2433,15,2418,426,13,413,2659,2133,526,1979,1585,394,430,86,22,1441
7/1/2017,VA,Virginia,Fairfax,51059,144301,123897,20404,136092,528,135564,8209,438,7771,116853,96484,20369,67339,48632,18707,13351,2675,500,50813
7/1/2017,VA,Virginia,Fairfax City,51600,3695,3142,553,3417,12,3405,278,11,267,3090,2538,552,1872,1376,496,371,*,*,1433
7/1/2017,VA,Virginia,Falls Church City,51610,1885,1626,259,1795,*,*,90,*,*,1468,1209,259,893,654,239,125,*,*,743
7/1/2017,VA,Virginia,Fauquier,51061,12093,10792,1301,10989,59,10930,1104,40,1064,10758,9457,1301,6776,5725,1051,964,192,56,5564
7/1/2017,VA,Virginia,Floyd,51063,3946,3188,758,3407,15,3392,539,*,*,3679,2921,758,2855,2159,696,551,93,40,2171
7/1/2017,VA,Virginia,Fluvanna,51065,5662,4907,755,5072,21,5051,590,23,567,5181,4426,755,3777,3151,626,521,122,29,3105
7/1/2017,VA,Virginia,Franklin,51067,14278,10471,3807,11894,45,11849,2384,30,2354,13411,9605,3806,10833,7330,3503,1964,469,149,8251
7/1/2017,VA,Virginia,Franklin City,51620,1925,1597,328,1505,22,1483,420,22,398,1805,1477,328,1472,1172,300,564,60,14,834
7/1/2017,VA,Virginia,Frederick,51069,15719,13911,1808,13928,50,13878,1791,55,1736,14338,12532,1806,9788,8388,1400,1479,349,136,7824
7/1/2017,VA,Virginia,Fredericksburg City,51630,3928,3418,510,3206,22,3184,722,31,691,3541,3031,510,2425,1965,460,783,88,37,1517
7/1/2017,VA,Virginia,Galax City,51640,1881,1738,143,1480,*,*,401,*,*,1780,1637,143,1408,1299,109,638,57,30,683
7/1/2017,VA,Virginia,Giles,51071,4575,3499,1076,3615,23,3592,960,17,943,4306,3231,1075,3488,2793,695,799,124,33,2532
7/1/2017,VA,Virginia,Gloucester,51073,8168,6772,1396,6990,38,6952,1178,21,1157,7564,6168,1396,4796,3613,1183,960,171,44,3621
7/1/2017,VA,Virginia,Goochland,51075,5477,4328,1149,4995,21,4974,482,22,460,4959,3810,1149,4043,3121,922,403,100,33,3507
7/1/2017,VA,Virginia,Grayson,51077,4625,3956,669,3783,*,*,842,12,830,4412,3743,669,3303,2745,558,987,178,90,2048
7/1/2017,VA,Virginia,Greene,51079,3580,3123,457,3130,13,3117,450,*,*,3264,2807,457,2338,1946,392,446,83,25,1784
7/1/2017,VA,Virginia,Greensville,51081,2432,1830,602,1941,19,1922,491,13,478,2281,1679,602,1848,1361,487,530,128,27,1163
7/1/2017,VA,Virginia,Halifax,51083,9513,8202,1311,7783,68,7715,1730,56,1674,8985,7674,1311,7198,6062,1136,2136,441,141,4480
7/1/2017,VA,Virginia,Hampton City,51650,24371,18320,6051,20002,196,19806,4369,191,4178,22271,16220,6051,13404,7783,5621,3564,789,176,8875
7/1/2017,VA,Virginia,Hanover,51085,19994,15250,4744,18133,81,18052,1861,48,1813,18208,13465,4743,14506,10666,3840,1361,362,94,12689
7/1/2017,VA,Virginia,Harrisonburg City,51660,5195,4624,571,4400,15,4385,795,21,774,4700,4129,571,3685,3272,413,948,125,33,2579
7/1/2017,VA,Virginia,Henrico,51087,54199,40100,14099,47203,320,46883,6996,288,6708,49059,34962,14097,39276,27152,12124,6154,1389,403,31330
7/1/2017,VA,Virginia,Henry,51089,14999,10846,4153,11907,72,11835,3092,52,3040,14288,10135,4153,12026,8189,3837,3031,706,247,8042
7/1/2017,VA,Virginia,Highland,51091,760,685,75,695,*,*,65,*,*,713,638,75,530,462,68,60,*,*,442
7/1/2017,VA,Virginia,Hopewell City,51670,4481,3566,915,3436,30,3406,1045,29,1016,4176,3261,915,2851,1979,872,971,164,32,1684
7/1/2017,VA,Virginia,Isle of Wight,51093,7863,6172,1691,6878,49,6829,985,34,951,7312,5621,1691,5172,3651,1521,939,195,60,3978
7/1/2017,VA,Virginia,James City,51095,19632,17113,2519,18446,56,18390,1186,56,1130,18151,15635,2516,11496,9557,1939,826,223,59,10388
7/1/2017,VA,Virginia,King and Queen,51097,1714,1421,293,1442,11,1431,272,*,*,1604,1311,293,1172,921,251,269,68,15,820
7/1/2017,VA,Virginia,King George,51099,3708,3316,392,3193,14,3179,515,29,486,3237,2845,392,1643,1305,338,468,86,13,1076
7/1/2017,VA,Virginia,King William,51101,3246,2733,513,2784,24,2760,462,23,439,2994,2481,513,2400,1964,436,373,114,24,1889
7/1/2017,VA,Virginia,Lancaster,51103,4266,3694,572,3910,17,3893,356,15,341,4062,3490,572,2926,2537,389,495,97,18,2316
7/1/2017,VA,Virginia,Lee,51105,6345,3870,2475,4340,16,4324,2005,*,*,6030,3557,2473,4889,2584,2305,1922,243,76,2648
7/1/2017,VA,Virginia,Lexington City,51678,1616,1459,157,1480,11,1469,136,*,*,1497,1340,157,1145,1019,126,217,*,*,886
7/1/2017,VA,Virginia,Loudoun,51107,34733,29345,5388,32353,136,32217,2380,113,2267,28866,23485,5381,18858,14057,4801,2972,641,155,15090
7/1/2017,VA,Virginia,Louisa,51109,7687,6347,1340,6456,36,6420,1231,35,1196,7037,5697,1340,5159,3980,1179,1042,245,72,3800
7/1/2017,VA,Virginia,Lunenburg,51111,2990,2592,398,2449,14,2435,541,22,519,2769,2371,398,2081,1737,344,714,111,45,1211
7/1/2017,VA,Virginia,Lynchburg City,51680,14526,12242,2284,11834,81,11753,2692,108,2584,13485,11201,2284,10905,8925,1980,3025,441,131,7308
7/1/2017,VA,Virginia,Madison,51113,2937,2516,421,2602,14,2588,335,13,322,2739,2318,421,2015,1667,348,391,90,24,1510
7/1/2017,VA,Virginia,Manassas City,51683,4342,3540,802,3798,32,3766,544,43,501,3678,2876,802,2494,1766,728,515,89,33,1857
7/1/2017,VA,Virginia,Manassas Park City,51685,1223,966,257,1056,11,1045,167,13,154,1043,787,256,711,481,230,180,*,*,478
7/1/2017,VA,Virginia,Martinsville City,51690,3909,2906,1003,2908,29,2879,1001,40,961,3698,2695,1003,3162,2201,961,1287,170,64,1641
7/1/2017,VA,Virginia,Mathews,51115,2807,2370,437,2576,*,*,231,*,*,2661,2224,437,1827,1479,348,259,41,19,1508
7/1/2017,VA,Virginia,Mecklenburg,51117,9061,7203,1858,7481,57,7424,1580,59,1521,8535,6677,1858,6676,5141,1535,1891,381,115,4289
7/1/2017,VA,Virginia,Middlesex,51119,3508,2973,535,3136,19,3117,372,*,*,3314,2779,535,2501,2111,390,450,84,25,1942
7/1/2017,VA,Virginia,Montgomery,51121,13540,11116,2424,11156,40,11116,2384,36,2348,12248,9824,2424,9887,7664,2223,1922,325,119,7521
7/1/2017,VA,Virginia,Nelson,51125,4460,3879,581,3944,17,3927,516,*,*,4103,3522,581,2987,2480,507,590,100,41,2256
7/1/2017,VA,Virginia,New Kent,51127,4237,3468,769,3781,20,3761,456,*,*,3851,3082,769,2683,2095,588,270,82,17,2314
7/1/2017,VA,Virginia,Newport News City,51700,27224,20244,6980,22316,191,22125,4908,244,4664,24954,17976,6978,16141,9598,6543,4647,831,229,10434
7/1/2017,VA,Virginia,Norfolk City,51710,32203,23891,8312,25589,259,25330,6614,337,6277,29071,20759,8312,19420,11549,7871,7150,1334,285,10651
7/1/2017,VA,Virginia,Northampton,51131,3566,2967,599,3030,24,3006,536,27,509,3341,2742,599,2642,2146,496,912,92,31,1607
7/1/2017,VA,Virginia,Northumberland,51133,4584,3955,629,4254,13,4241,330,*,*,4269,3640,629,2818,2446,372,412,89,33,2284
7/1/2017,VA,Virginia,Norton City,51720,1181,809,372,789,*,*,392,*,*,1098,726,372,887,559,328,347,50,17,473
7/1/2017,VA,Virginia,Nottoway,51135,3645,2992,653,2960,28,2932,685,16,669,3401,2748,653,2646,2200,446,925,131,41,1549
7/1/2017,VA,Virginia,Orange,51137,8567,7474,1093,7551,47,7504,1016,36,980,7872,6779,1093,5154,4401,753,960,218,66,3910
7/1/2017,VA,Virginia,Page,51139,6102,5368,734,4974,21,4953,1128,19,1109,5735,5001,734,4174,3555,619,1123,229,83,2739
7/1/2017,VA,Virginia,Patrick,51141,5092,3839,1253,4202,*,*,890,*,*,4851,3599,1252,3950,2887,1063,1013,199,72,2666
7/1/2017,VA,Virginia,Petersburg City,51730,7148,5334,1814,5291,98,5193,1857,88,1769,6523,4709,1814,4692,2947,1745,2020,346,62,2264
7/1/2017,VA,Virginia,Pittsylvania,51143,15927,12388,3539,13035,99,12936,2892,78,2814,15033,11494,3539,12275,9751,2524,3065,557,218,8435
7/1/2017,VA,Virginia,Poquoson City,51735,2503,2199,304,2330,*,*,173,*,*,2310,2006,304,1137,875,262,102,23,13,999
7/1/2017,VA,Virginia,Portsmouth City,51740,17840,13178,4662,13824,178,13646,4016,207,3809,15986,11326,4660,10532,6111,4421,3833,709,137,5853
7/1/2017,VA,Virginia,Powhatan,51145,5672,4501,1171,5063,18,5045,609,14,595,5214,4043,1171,4119,3134,985,392,110,34,3583
7/1/2017,VA,Virginia,Prince Edward,51147,4579,3752,827,3681,36,3645,898,37,861,4253,3426,827,3273,2654,619,1079,166,49,1979
7/1/2017,VA,Virginia,Prince George,51149,5685,4917,768,4820,25,4795,865,31,834,5279,4511,768,3158,2486,672,544,127,27,2460
7/1/2017,VA,Virginia,Prince William,51153,45695,37588,8107,40639,266,40373,5056,300,4756,38988,30884,8104,22394,14977,7417,5048,993,215,16138
7/1/2017,VA,Virginia,Pulaski,51155,8963,7245,1718,7130,34,7096,1833,30,1803,8360,6642,1718,6370,4803,1567,1614,319,119,4318
7/1/2017,VA,Virginia,Radford City,51750,2026,1643,383,1623,*,*,403,*,*,1863,1480,383,1527,1184,343,343,42,21,1121
7/1/2017,VA,Virginia,Rappahannock,51157,2009,1845,164,1861,*,*,148,*,*,1816,1653,163,1197,1073,124,154,*,*,999
7/1/2017,VA,Virginia,Richmond,51159,1968,1583,385,1709,15,1694,259,13,246,1829,1444,385,1344,1089,255,291,84,20,949
7/1/2017,VA,Virginia,Richmond City,51760,33163,22303,10860,25974,269,25705,7189,347,6842,29885,19025,10860,24948,14677,10271,8745,1412,284,14507
7/1/2017,VA,Virginia,Roanoke,51161,22996,18118,4878,20422,97,20325,2574,56,2518,21306,16429,4877,16891,12623,4268,1963,429,142,14357
7/1/2017,VA,Virginia,Roanoke City,51770,20296,14541,5755,15178,129,15049,5118,148,4970,18533,12779,5754,14916,9533,5383,4793,840,204,9079
7/1/2017,VA,Virginia,Rockbridge,51163,5862,4956,906,4968,22,4946,894,*,*,5440,4534,906,4055,3310,745,819,179,68,2989
7/1/2017,VA,Virginia,Rockingham,51165,16930,14372,2558,14800,43,14757,2130,37,2093,15647,13089,2558,12068,10241,1827,1811,505,148,9604
7/1/2017,VA,Virginia,Russell,51167,7768,5136,2632,5273,18,5255,2495,14,2481,7439,4807,2632,6333,4156,2177,1695,305,129,4204
7/1/2017,VA,Virginia,Salem City,51775,6012,4812,1200,5066,31,5035,946,17,929,5513,4313,1200,4360,3292,1068,844,142,37,3337
7/1/2017,VA,Virginia,Scott,51169,6572,3332,3240,4906,*,*,1666,14,1652,6299,3059,3240,5444,2266,3178,1502,240,122,3580
7/1/2017,VA,Virginia,Shenandoah,51171,10279,9079,1200,9047,27,9020,1232,26,1206,9617,8417,1200,6723,5780,943,1268,262,98,5095
7/1/2017,VA,Virginia,Smyth,51173,8821,6769,2052,6552,26,6526,2269,24,2245,8309,6257,2052,6726,4904,1822,2170,400,133,4023
7/1/2017,VA,Virginia,Southampton,51175,4046,3384,662,3366,24,3342,680,18,662,3778,3116,662,2942,2371,571,728,130,34,2050
7/1/2017,VA,Virginia,Spotsylvania,51177,19917,17311,2606,17242,105,17137,2675,99,2576,17726,15121,2605,10641,8518,2123,1945,493,132,8071
7/1/2017,VA,Virginia,Stafford,51179,16348,14746,1602,14389,93,14296,1959,81,1878,14346,12744,1602,7158,5837,1321,1329,356,78,5395
7/1/2017,VA,Virginia,Staunton City,51790,6004,5168,836,4965,23,4942,1039,20,1019,5641,4805,836,4392,3706,686,1053,156,62,3121
7/1/2017,VA,Virginia,Suffolk City,51800,15450,12217,3233,12624,97,12527,2826,101,2725,14153,10920,3233,9673,6765,2908,2630,459,110,6474
7/1/2017,VA,Virginia,Surry,51181,1538,1196,342,1294,*,*,244,*,*,1435,1093,342,1031,718,313,202,63,14,752
7/1/2017,VA,Virginia,Sussex,51183,2349,1795,554,1919,29,1890,430,*,*,2191,1637,554,1674,1155,519,479,138,19,1038
7/1/2017,VA,Virginia,Tazewell,51185,11864,8440,3424,8705,35,8670,3159,40,3119,11243,7821,3422,8848,6606,2242,2271,443,186,5948
7/1/2017,VA,Virginia,Unknown,51999,*,*,*,*,*,*,*,*,*,*,*,*,*,*,*,*,*,*,*
7/1/2017,VA,Virginia,Virginia Beach City,51810,68585,56593,11992,60378,351,60027,8207,338,7869,62846,50862,11984,35436,24649,10787,6660,1427,360,26989
7/1/2017,VA,Virginia,Warren,51187,7298,6566,732,6237,29,6208,1061,30,1031,6653,5921,732,4476,3892,584,877,239,74,3286
7/1/2017,VA,Virginia,Washington,51191,14763,9906,4857,11794,44,11750,2969,31,2938,13933,9077,4856,11275,6802,4473,2459,526,167,8123
7/1/2017,VA,Virginia,Waynesboro City,51820,4709,4012,697,3836,14,3822,873,26,847,4389,3692,697,3449,2852,597,865,117,36,2431
7/1/2017,VA,Virginia,Westmoreland,51193,4837,4161,676,4238,25,4213,599,11,588,4418,3742,676,2774,2222,552,731,135,48,1860
7/1/2017,VA,Virginia,Williamsburg City,51830,2527,2128,399,2309,*,*,218,*,*,2334,1936,398,1638,1310,328,234,*,*,1366
7/1/2017,VA,Virginia,Winchester City,51840,5074,4523,551,4310,23,4287,764,16,748,4609,4058,551,3312,2878,434,842,128,50,2292
7/1/2017,VA,Virginia,Wise,51195,10536,6711,3825,7037,24,7013,3499,24,3475,9951,6126,3825,7817,4340,3477,2421,467,166,4763
7/1/2017,VA,Virginia,Wythe,51197,7494,5706,1788,5824,31,5793,1670,20,1650,7078,5290,1788,5503,3946,1557,1492,271,101,3639
7/1/2017,VA,Virginia,York,51199,11387,9851,1536,10435,33,10402,952,28,924,10437,8901,1536,5512,4221,1291,658,164,42,4648
6/1/2017,VA,Virginia,Accomack,51001,8585,7229,1356,7384,50,7334,1201,47,1154,7982,6626,1356,5844,4796,1048,1481,380,92,3891
6/1/2017,VA,Virginia,Albemarle,51003,19678,17487,2191,18105,59,18046,1573,51,1522,17633,15442,2191,13372,11464,1908,1511,297,98,11466
6/1/2017,VA,Virginia,Alexandria City,51510,17122,14686,2436,15714,80,15634,1408,90,1318,13742,11310,2432,8222,5965,2257,2074,317,57,5774
6/1/2017,VA,Virginia,Alleghany,51005,4481,3840,641,3620,21,3599,861,14,847,4242,3601,641,3378,2891,487,778,105,50,2445
6/1/2017,VA,Virginia,Amelia,51007,2990,2300,690,2517,12,2505,473,*,*,2749,2059,690,2151,1530,621,463,84,36,1568
6/1/2017,VA,Virginia,Amherst,51009,7640,6348,1292,6371,50,6321,1269,28,1241,7095,5803,1292,5706,4579,1127,1205,235,71,4195
6/1/2017,VA,Virginia,Appomattox,51011,3758,3147,611,3076,14,3062,682,19,663,3533,2922,611,2845,2309,536,658,104,36,2047
6/1/2017,VA,Virginia,Arlington,51013,23434,20375,3059,21829,91,21738,1605,96,1509,18435,15376,3059,10962,8140,2822,2904,333,105,7620
6/1/2017,VA,Virginia,Augusta,51015,17645,15094,2551,15229,53,15176,2416,44,2372,16592,14041,2551,12624,10578,2046,1778,411,145,10290
6/1/2017,VA,Virginia,Bath,51017,1264,1156,108,1117,*,*,147,*,*,1186,1078,108,913,821,92,168,38,24,683
6/1/2017,VA,Virginia,Bedford,51019,19079,15611,3468,16314,84,16230,2765,52,2713,17730,14264,3466,13722,11200,2522,1951,470,163,11138
6/1/2017,VA,Virginia,Bland,51021,1771,1375,396,1389,*,*,382,*,*,1671,1275,396,1248,1030,218,251,51,18,928
6/1/2017,VA,Virginia,Botetourt,51023,8366,6442,1924,7245,44,7201,1121,15,1106,7737,5813,1924,6065,4396,1669,829,179,53,5004
6/1/2017,VA,Virginia,Bristol City,51520,4513,2693,1820,3490,14,3476,1023,11,1012,4233,2413,1820,3557,1805,1752,1067,152,48,2290
6/1/2017,VA,Virginia,Brunswick,51025,3919,3210,709,3218,25,3193,701,23,678,3661,2952,709,2862,2244,618,1111,106,40,1605
6/1/2017,VA,Virginia,Buchanan,51027,7290,4390,2900,4542,19,4523,2748,15,2733,6992,4092,2900,5799,3719,2080,1615,414,110,3660
6/1/2017,VA,Virginia,Buckingham,51029,3428,2785,643,2784,18,2766,644,19,625,3197,2554,643,2441,2035,406,734,143,45,1519
6/1/2017,VA,Virginia,Buena Vista City,51530,1439,1166,273,1158,*,*,281,*,*,1349,1076,273,1054,829,225,332,53,19,650
6/1/2017,VA,Virginia,Campbell,51031,12426,10354,2072,10284,79,10205,2142,61,2081,11627,9555,2072,9368,7563,1805,2077,379,164,6748
6/1/2017,VA,Virginia,Caroline,51033,5647,4661,986,4712,32,4680,935,40,895,5081,4095,986,3437,2575,862,793,229,56,2359
6/1/2017,VA,Virginia,Carroll,51035,7988,6815,1173,6449,24,6425,1539,13,1526,7538,6365,1173,5824,4896,928,1630,284,105,3805
6/1/2017,VA,Virginia,Charles City,51036,1860,1435,425,1583,19,1564,277,11,266,1703,1278,425,1305,950,355,259,78,17,951
6/1/2017,VA,Virginia,Charlotte,51037,3340,2800,540,2698,13,2685,642,17,625,3151,2611,540,2494,2029,465,797,131,52,1514
6/1/2017,VA,Virginia,Charlottesville City,51540,6116,5348,768,5023,30,4993,1093,49,1044,5462,4695,767,4343,3622,721,1228,159,48,2908
6/1/2017,VA,Virginia,Chesapeake City,51550,35975,28634,7341,30821,274,30547,5154,227,4927,32481,25140,7341,19892,13373,6519,4063,886,245,14698
6/1/2017,VA,Virginia,Chesterfield,51041,56668,43113,13555,49288,189,49099,7380,248,7132,51003,37451,13552,38975,26932,12043,5270,1022,279,32404
6/1/2017,VA,Virginia,Clarke,51043,3149,2789,360,2897,11,2886,252,*,*,2838,2478,360,1911,1634,277,253,73,27,1558
6/1/2017,VA,Virginia,Colonial Heights City,51570,4121,3435,686,3512,*,*,609,16,593,3792,3106,686,2441,1856,585,492,97,24,1828
6/1/2017,VA,Virginia,Covington City,51580,1642,1396,246,1269,12,1257,373,*,*,1533,1287,246,1215,987,228,355,53,20,787
6/1/2017,VA,Virginia,Craig,51045,1306,1025,281,1025,*,*,281,0,281,1202,921,281,941,675,266,196,44,11,690
6/1/2017,VA,Virginia,Culpeper,51047,8911,7591,1320,7695,40,7655,1216,43,1173,8065,6745,1320,5568,4516,1052,1152,242,63,4111
6/1/2017,VA,Virginia,Cumberland,51049,2238,1730,508,1866,*,*,372,*,*,2075,1567,508,1620,1171,449,419,98,33,1070
6/1/2017,VA,Virginia,Danville City,51590,11093,8915,2178,8718,83,8635,2375,116,2259,10441,8263,2178,8685,7246,1439,3216,431,159,4879
6/1/2017,VA,Virginia,Dickenson,51051,4734,2920,1814,2960,*,*,1774,11,1763,4502,2688,1814,3694,2085,1609,1113,207,77,2297
6/1/2017,VA,Virginia,Dinwiddie,51053,5713,4514,1199,4586,35,4551,1127,30,1097,5238,4039,1199,3859,2752,1107,901,182,52,2724
6/1/2017,VA,Virginia,Emporia City,51595,1138,875,263,877,16,861,261,11,250,1059,796,263,869,654,215,409,70,11,379
6/1/2017,VA,Virginia,Essex,51057,2846,2317,529,2421,16,2405,425,13,412,2644,2115,529,1969,1572,397,429,86,22,1432
6/1/2017,VA,Virginia,Fairfax,51059,143625,123404,20221,135474,536,134938,8151,435,7716,115593,95406,20187,66980,48461,18519,13266,2663,498,50553
6/1/2017,VA,Virginia,Fairfax City,51600,3688,3137,551,3411,13,3398,277,11,266,3072,2521,551,1864,1369,495,371,*,*,1425
6/1/2017,VA,Virginia,Falls Church City,51610,1879,1626,253,1789,*,*,90,*,*,1454,1201,253,884,650,234,124,*,*,735
6/1/2017,VA,Virginia,Fauquier,51061,12041,10736,1305,10942,59,10883,1099,40,1059,10664,9359,1305,6722,5668,1054,956,193,55,5518
6/1/2017,VA,Virginia,Floyd,51063,3945,3182,763,3405,15,3390,540,*,*,3671,2908,763,2857,2157,700,548,95,41,2173
6/1/2017,VA,Virginia,Fluvanna,51065,5641,4892,749,5053,21,5032,588,23,565,5149,4400,749,3747,3128,619,516,120,30,3081
6/1/2017,VA,Virginia,Franklin,51067,14238,10422,3816,11862,46,11816,2376,29,2347,13359,9544,3815,10814,7301,3513,1960,474,149,8231
6/1/2017,VA,Virginia,Franklin City,51620,1930,1600,330,1510,23,1487,420,22,398,1803,1473,330,1472,1170,302,565,61,14,832
6/1/2017,VA,Virginia,Frederick,51069,15683,13886,1797,13907,52,13855,1776,55,1721,14265,12469,1796,9756,8368,1388,1464,344,135,7813
6/1/2017,VA,Virginia,Fredericksburg City,51630,3912,3397,515,3196,22,3174,716,31,685,3521,3006,515,2418,1953,465,776,90,37,1515
6/1/2017,VA,Virginia,Galax City,51640,1879,1738,141,1480,*,*,399,*,*,1779,1638,141,1406,1298,108,639,57,30,680
6/1/2017,VA,Virginia,Giles,51071,4569,3485,1084,3619,23,3596,950,17,933,4294,3211,1083,3483,2781,702,794,122,33,2534
6/1/2017,VA,Virginia,Gloucester,51073,8140,6734,1406,6963,38,6925,1177,20,1157,7527,6121,1406,4785,3595,1190,957,173,44,3611
6/1/2017,VA,Virginia,Goochland,51075,5456,4305,1151,4975,21,4954,481,22,459,4930,3779,1151,4015,3091,924,404,100,33,3478
6/1/2017,VA,Virginia,Grayson,51077,4621,3959,662,3783,*,*,838,12,826,4405,3743,662,3296,2745,551,986,178,89,2043
6/1/2017,VA,Virginia,Greene,51079,3571,3114,457,3120,13,3107,451,*,*,3249,2792,457,2334,1942,392,448,83,25,1778
6/1/2017,VA,Virginia,Greensville,51081,2428,1822,606,1939,19,1920,489,14,475,2268,1662,606,1844,1353,491,529,128,26,1161
6/1/2017,VA,Virginia,Halifax,51083,9491,8178,1313,7769,70,7699,1722,56,1666,8953,7640,1313,7181,6043,1138,2130,443,139,4469
6/1/2017,VA,Virginia,Hampton City,51650,24325,18283,6042,19975,197,19778,4350,194,4156,22160,16118,6042,13377,7768,5609,3547,793,172,8865
6/1/2017,VA,Virginia,Hanover,51085,19955,15210,4745,18104,81,18023,1851,48,1803,18141,13397,4744,14460,10616,3844,1348,360,95,12657
6/1/2017,VA,Virginia,Harrisonburg City,51660,5173,4597,576,4383,15,4368,790,21,769,4671,4095,576,3658,3241,417,941,124,33,2560
6/1/2017,VA,Virginia,Henrico,51087,54086,39990,14096,47115,325,46790,6971,286,6685,48820,34726,14094,39165,27048,12117,6114,1387,400,31264
6/1/2017,VA,Virginia,Henry,51089,14987,10827,4160,11899,75,11824,3088,54,3034,14243,10083,4160,12011,8169,3842,3011,710,244,8046
6/1/2017,VA,Virginia,Highland,51091,759,683,76,694,*,*,65,*,*,710,634,76,530,461,69,61,*,*,441
6/1/2017,VA,Virginia,Hopewell City,51670,4472,3560,912,3430,30,3400,1042,30,1012,4154,3242,912,2832,1963,869,960,156,31,1685
6/1/2017,VA,Virginia,Isle of Wight,51093,7835,6143,1692,6857,50,6807,978,34,944,7252,5560,1692,5151,3631,1520,937,194,61,3959
6/1/2017,VA,Virginia,James City,51095,19595,17062,2533,18412,58,18354,1183,55,1128,18074,15544,2530,11460,9509,1951,821,219,59,10361
6/1/2017,VA,Virginia,King and Queen,51097,1705,1410,295,1432,11,1421,273,*,*,1590,1295,295,1168,915,253,269,68,15,816
6/1/2017,VA,Virginia,King George,51099,3692,3295,397,3180,14,3166,512,29,483,3209,2812,397,1627,1285,342,458,85,13,1071
6/1/2017,VA,Virginia,King William,51101,3238,2725,513,2777,24,2753,461,23,438,2979,2466,513,2393,1956,437,373,115,25,1880
6/1/2017,VA,Virginia,Lancaster,51103,4259,3683,576,3906,17,3889,353,15,338,4053,3477,576,2922,2527,395,492,97,18,2315
6/1/2017,VA,Virginia,Lee,51105,6344,3867,2477,4343,17,4326,2001,11,1990,6019,3546,2473,4891,2585,2306,1914,242,76,2659
6/1/2017,VA,Virginia,Lexington City,51678,1612,1453,159,1475,11,1464,137,*,*,1493,1334,159,1139,1010,129,218,*,*,880
6/1/2017,VA,Virginia,Loudoun,51107,34580,29186,5394,32215,138,32077,2365,113,2252,28578,23190,5388,18808,14003,4805,2948,652,155,15053
6/1/2017,VA,Virginia,Louisa,51109,7663,6322,1341,6435,37,6398,1228,35,1193,7008,5667,1341,5145,3965,1180,1035,243,71,3796
6/1/2017,VA,Virginia,Lunenburg,51111,2974,2575,399,2434,15,2419,540,22,518,2748,2349,399,2067,1723,344,713,111,44,1199
6/1/2017,VA,Virginia,Lynchburg City,51680,14511,12220,2291,11834,83,11751,2677,109,2568,13433,11142,2291,10869,8884,1985,3009,442,130,7288
6/1/2017,VA,Virginia,Madison,51113,2923,2501,422,2591,14,2577,332,12,320,2720,2298,422,2007,1657,350,390,90,24,1503
6/1/2017,VA,Virginia,Manassas City,51683,4327,3524,803,3784,32,3752,543,42,501,3646,2843,803,2481,1752,729,515,90,32,1844
6/1/2017,VA,Virginia,Manassas Park City,51685,1225,966,259,1058,12,1046,167,13,154,1034,776,258,714,482,232,181,*,*,479
6/1/2017,VA,Virginia,Martinsville City,51690,3902,2899,1003,2904,29,2875,998,41,957,3686,2683,1003,3154,2193,961,1283,169,64,1638
6/1/2017,VA,Virginia,Mathews,51115,2808,2370,438,2578,*,*,230,*,*,2655,2217,438,1823,1475,348,257,42,19,1505
6/1/2017,VA,Virginia,Mecklenburg,51117,9034,7167,1867,7462,58,7404,1572,59,1513,8501,6634,1867,6666,5120,1546,1890,381,115,4280
6/1/2017,VA,Virginia,Middlesex,51119,3500,2959,541,3129,20,3109,371,*,*,3293,2752,541,2492,2099,393,448,87,24,1933
6/1/2017,VA,Virginia,Montgomery,51121,13520,11093,2427,11140,42,11098,2380,37,2343,12211,9784,2427,9862,7635,2227,1919,327,117,7499
6/1/2017,VA,Virginia,Nelson,51125,4444,3863,581,3930,18,3912,514,*,*,4078,3497,581,2973,2466,507,587,102,41,2243
6/1/2017,VA,Virginia,New Kent,51127,4216,3450,766,3763,21,3742,453,*,*,3822,3056,766,2663,2077,586,271,83,17,2292
6/1/2017,VA,Virginia,Newport News City,51700,27148,20172,6976,22263,195,22068,4885,245,4640,24815,17841,6974,16102,9564,6538,4626,834,228,10414
6/1/2017,VA,Virginia,Norfolk City,51710,32073,23769,8304,25492,263,25229,6581,338,6243,28858,20555,8303,19348,11488,7860,7095,1339,279,10635
6/1/2017,VA,Virginia,Northampton,51131,3552,2949,603,3023,24,2999,529,26,503,3315,2712,603,2625,2124,501,911,91,31,1592
6/1/2017,VA,Virginia,Northumberland,51133,4571,3938,633,4244,13,4231,327,*,*,4249,3616,633,2809,2433,376,409,90,33,2277
6/1/2017,VA,Virginia,Norton City,51720,1181,808,373,791,*,*,390,*,*,1098,725,373,890,561,329,346,50,18,476
6/1/2017,VA,Virginia,Nottoway,51135,3641,2987,654,2958,29,2929,683,16,667,3388,2734,654,2642,2194,448,923,130,40,1549
6/1/2017,VA,Virginia,Orange,51137,8542,7452,1090,7527,47,7480,1015,37,978,7831,6741,1090,5135,4385,750,958,218,62,3897
6/1/2017,VA,Virginia,Page,51139,6087,5349,738,4964,22,4942,1123,19,1104,5717,4979,738,4172,3551,621,1121,228,82,2741
6/1/2017,VA,Virginia,Patrick,51141,5094,3841,1253,4203,11,4192,891,*,*,4845,3593,1252,3949,2889,1060,1010,203,74,2662
6/1/2017,VA,Virginia,Petersburg City,51730,7147,5335,1812,5296,100,5196,1851,87,1764,6501,4689,1812,4681,2937,1744,2011,350,59,2261
6/1/2017,VA,Virginia,Pittsylvania,51143,15909,12374,3535,13020,100,12920,2889,77,2812,14993,11458,3535,12263,9736,2527,3057,561,218,8427
6/1/2017,VA,Virginia,Poquoson City,51735,2496,2195,301,2324,*,*,172,*,*,2302,2001,301,1135,876,259,99,25,14,997
6/1/2017,VA,Virginia,Portsmouth City,51740,17795,13126,4669,13802,179,13623,3993,206,3787,15871,11204,4667,10496,6070,4426,3805,713,139,5839
6/1/2017,VA,Virginia,Powhatan,51145,5659,4481,1178,5053,20,5033,606,13,593,5194,4016,1178,4109,3117,992,394,109,32,3574
6/1/2017,VA,Virginia,Prince Edward,51147,4579,3749,830,3684,37,3647,895,37,858,4247,3417,830,3277,2656,621,1078,164,50,1985
6/1/2017,VA,Virginia,Prince George,51149,5665,4898,767,4803,26,4777,862,31,831,5239,4472,767,3126,2453,673,534,130,26,2436
6/1/2017,VA,Virginia,Prince William,51153,45455,37359,8096,40422,267,40155,5033,298,4735,38589,30497,8092,22263,14852,7411,5021,984,215,16043
6/1/2017,VA,Virginia,Pulaski,51155,8964,7248,1716,7133,34,7099,1831,30,1801,8351,6635,1716,6373,4809,1564,1618,322,116,4317
6/1/2017,VA,Virginia,Radford City,51750,2024,1640,384,1621,*,*,403,*,*,1855,1471,384,1527,1183,344,342,42,20,1123
6/1/2017,VA,Virginia,Rappahannock,51157,2001,1835,166,1854,*,*,147,*,*,1803,1638,165,1189,1064,125,153,*,*,992
6/1/2017,VA,Virginia,Richmond,51159,1968,1584,384,1708,15,1693,260,13,247,1821,1437,384,1346,1092,254,295,85,20,946
6/1/2017,VA,Virginia,Richmond City,51760,33109,22239,10870,25941,274,25667,7168,346,6822,29726,18856,10870,24874,14595,10279,8702,1414,286,14472
6/1/2017,VA,Virginia,Roanoke,51161,22945,18052,4893,20382,99,20283,2563,56,2507,21228,16336,4892,16838,12557,4281,1948,429,141,14320
6/1/2017,VA,Virginia,Roanoke City,51770,20254,14488,5766,15150,132,15018,5104,147,4957,18459,12694,5765,14883,9493,5390,4765,854,202,9062
6/1/2017,VA,Virginia,Rockbridge,51163,5837,4920,917,4950,23,4927,887,*,*,5416,4499,917,4051,3297,754,813,182,70,2986
6/1/2017,VA,Virginia,Rockingham,51165,16889,14329,2560,14777,44,14733,2112,37,2075,15586,13026,2560,12014,10187,1827,1799,503,147,9565
6/1/2017,VA,Virginia,Russell,51167,7751,5135,2616,5271,18,5253,2480,13,2467,7412,4796,2616,6318,4150,2168,1687,302,126,4203
6/1/2017,VA,Virginia,Salem City,51775,6009,4805,1204,5060,31,5029,949,18,931,5500,4296,1204,4347,3274,1073,841,145,38,3323
6/1/2017,VA,Virginia,Scott,51169,6584,3344,3240,4925,11,4914,1659,14,1645,6308,3069,3239,5453,2276,3177,1506,243,123,3581
6/1/2017,VA,Virginia,Shenandoah,51171,10255,9051,1204,9026,27,8999,1229,26,1203,9587,8383,1204,6711,5761,950,1260,264,99,5088
6/1/2017,VA,Virginia,Smyth,51173,8805,6752,2053,6546,27,6519,2259,23,2236,8289,6236,2053,6727,4901,1826,2162,405,133,4027
6/1/2017,VA,Virginia,Southampton,51175,4032,3364,668,3357,26,3331,675,19,656,3752,3084,668,2935,2358,577,727,132,34,2042
6/1/2017,VA,Virginia,Spotsylvania,51177,19814,17213,2601,17158,108,17050,2656,96,2560,17577,14977,2600,10598,8479,2119,1940,495,130,8033
6/1/2017,VA,Virginia,Stafford,51179,16277,14659,1618,14325,94,14231,1952,82,1870,14218,12600,1618,7147,5806,1341,1323,355,77,5392
6/1/2017,VA,Virginia,Staunton City,51790,5992,5151,841,4954,24,4930,1038,20,1018,5617,4776,841,4373,3683,690,1052,156,62,3103
6/1/2017,VA,Virginia,Suffolk City,51800,15406,12163,3243,12599,98,12501,2807,101,2706,14068,10825,3243,9661,6741,2920,2618,459,106,6478
6/1/2017,VA,Virginia,Surry,51181,1530,1188,342,1287,*,*,243,*,*,1423,1081,342,1025,712,313,201,63,14,747
6/1/2017,VA,Virginia,Sussex,51183,2338,1784,554,1909,29,1880,429,*,*,2174,1620,554,1669,1150,519,477,140,19,1033
6/1/2017,VA,Virginia,Tazewell,51185,11841,8422,3419,8694,35,8659,3147,41,3106,11195,7778,3417,8832,6593,2239,2261,444,185,5942
6/1/2017,VA,Virginia,Unknown,51999,*,*,*,*,*,*,*,*,*,*,*,*,*,*,*,*,*,*,*
6/1/2017,VA,Virginia,Virginia Beach City,51810,68330,56366,11964,60155,354,59801,8175,338,7837,62453,50496,11957,35282,24523,10759,6642,1426,357,26857
6/1/2017,VA,Virginia,Warren,51187,7282,6545,737,6224,29,6195,1058,30,1028,6622,5885,737,4464,3874,590,874,236,74,3280
6/1/2017,VA,Virginia,Washington,51191,14769,9903,4866,11803,45,11758,2966,30,2936,13894,9029,4865,11245,6768,4477,2457,525,167,8096
6/1/2017,VA,Virginia,Waynesboro City,51820,4702,3994,708,3834,14,3820,868,26,842,4372,3664,708,3443,2836,607,862,119,36,2426
6/1/2017,VA,Virginia,Westmoreland,51193,4815,4142,673,4221,26,4195,594,11,583,4395,3722,673,2769,2218,551,728,136,50,1855
6/1/2017,VA,Virginia,Williamsburg City,51830,2524,2126,398,2308,*,*,216,*,*,2321,1924,397,1626,1300,326,231,*,*,1359
6/1/2017,VA,Virginia,Winchester City,51840,5063,4513,550,4300,22,4278,763,16,747,4577,4027,550,3311,2877,434,841,130,50,2290
6/1/2017,VA,Virginia,Wise,51195,10533,6722,3811,7049,24,7025,3484,23,3461,9925,6114,3811,7817,4344,3473,2428,464,167,4758
6/1/2017,VA,Virginia,Wythe,51197,7487,5705,1782,5825,31,5794,1662,20,1642,7058,5276,1782,5493,3943,1550,1494,272,100,3627
6/1/2017,VA,Virginia,York,51199,11356,9821,1535,10409,33,10376,947,28,919,10393,8858,1535,5500,4211,1289,658,163,41,4638
3/1/2017,VA,Virginia,Accomack,51001,8521,7156,1365,7335,50,7285,1186,46,1140,7924,6559,1365,5831,4772,1059,1456,391,104,3880
3/1/2017,VA,Virginia,Albemarle,51003,19542,17335,2207,17979,65,17914,1563,50,1513,17529,15322,2207,13307,11383,1924,1485,308,98,11416
3/1/2017,VA,Virginia,Alexandria City,51510,16943,14490,2453,15556,83,15473,1387,92,1295,13646,11197,2449,8171,5894,2277,2029,333,65,5744
3/1/2017,VA,Virginia,Alleghany,51005,4490,3835,655,3636,22,3614,854,15,839,4253,3598,655,3404,2904,500,772,110,52,2470
3/1/2017,VA,Virginia,Amelia,51007,2980,2294,686,2513,12,2501,467,*,*,2745,2059,686,2153,1538,615,460,82,39,1572
3/1/2017,VA,Virginia,Amherst,51009,7597,6298,1299,6340,50,6290,1257,29,1228,7062,5763,1299,5695,4560,1135,1165,239,76,4215
3/1/2017,VA,Virginia,Appomattox,51011,3749,3135,614,3075,14,3061,674,19,655,3532,2918,614,2848,2311,537,647,99,39,2063
3/1/2017,VA,Virginia,Arlington,51013,23227,20174,3053,21645,98,21547,1582,92,1490,18330,15277,3053,10906,8090,2816,2871,344,109,7582
3/1/2017,VA,Virginia,Augusta,51015,17544,14980,2564,15169,59,15110,2375,43,2332,16505,13941,2564,12588,10529,2059,1746,419,148,10275
3/1/2017,VA,Virginia,Bath,51017,1260,1150,110,1116,*,*,144,*,*,1186,1076,110,924,831,93,168,39,24,693
3/1/2017,VA,Virginia,Bedford,51019,18994,15496,3498,16246,88,16158,2748,52,2696,17660,14164,3496,13705,11156,2549,1927,473,172,11133
3/1/2017,VA,Virginia,Bland,51021,1767,1370,397,1391,*,*,376,*,*,1665,1268,397,1248,1031,217,250,51,18,929
3/1/2017,VA,Virginia,Botetourt,51023,8348,6414,1934,7232,45,7187,1116,17,1099,7727,5793,1934,6062,4381,1681,821,185,55,5001
3/1/2017,VA,Virginia,Bristol City,51520,4496,2680,1816,3482,17,3465,1014,11,1003,4216,2400,1816,3552,1805,1747,1052,152,52,2296
3/1/2017,VA,Virginia,Brunswick,51025,3907,3182,725,3205,26,3179,702,26,676,3663,2938,725,2874,2240,634,1104,106,39,1625
3/1/2017,VA,Virginia,Buchanan,51027,7285,4395,2890,4567,21,4546,2718,14,2704,6980,4090,2890,5831,3762,2069,1596,427,113,3695
3/1/2017,VA,Virginia,Buckingham,51029,3404,2770,634,2772,18,2754,632,17,615,3176,2542,634,2436,2037,399,715,143,49,1529
3/1/2017,VA,Virginia,Buena Vista City,51530,1444,1173,271,1166,*,*,278,*,*,1353,1082,271,1055,833,222,330,55,19,651
3/1/2017,VA,Virginia,Campbell,51031,12378,10298,2080,10251,82,10169,2127,62,2065,11596,9516,2080,9362,7550,1812,2049,386,168,6759
3/1/2017,VA,Virginia,Caroline,51033,5605,4613,992,4685,33,4652,920,38,882,5053,4061,992,3449,2579,870,775,241,58,2375
3/1/2017,VA,Virginia,Carroll,51035,7965,6782,1183,6441,24,6417,1524,13,1511,7515,6332,1183,5839,4904,935,1603,298,111,3827
3/1/2017,VA,Virginia,Charles City,51036,1857,1426,431,1582,19,1563,275,12,263,1701,1270,431,1309,948,361,260,81,19,949
3/1/2017,VA,Virginia,Charlotte,51037,3332,2786,546,2695,15,2680,637,17,620,3144,2598,546,2486,2017,469,785,138,53,1510
3/1/2017,VA,Virginia,Charlottesville City,51540,6047,5257,790,4966,32,4934,1081,48,1033,5416,4627,789,4335,3591,744,1211,163,49,2912
3/1/2017,VA,Virginia,Chesapeake City,51550,35679,28341,7338,30603,282,30321,5076,221,4855,32255,24917,7338,19878,13363,6515,3996,910,256,14716
3/1/2017,VA,Virginia,Chesterfield,51041,56162,42621,13541,48886,193,48693,7276,245,7031,50621,37083,13538,38776,26746,12030,5179,1052,305,32240
3/1/2017,VA,Virginia,Clarke,51043,3113,2758,355,2870,13,2857,243,*,*,2815,2460,355,1903,1629,274,254,74,31,1544
3/1/2017,VA,Virginia,Colonial Heights City,51570,4119,3431,688,3520,*,*,599,16,583,3788,3100,688,2448,1861,587,486,104,23,1835
3/1/2017,VA,Virginia,Covington City,51580,1645,1403,242,1274,13,1261,371,*,*,1533,1291,242,1221,994,227,360,55,20,786
3/1/2017,VA,Virginia,Craig,51045,1302,1022,280,1025,*,*,277,0,277,1200,920,280,941,675,266,198,45,12,686
3/1/2017,VA,Virginia,Culpeper,51047,8868,7531,1337,7672,43,7629,1196,41,1155,8045,6708,1337,5584,4516,1068,1129,253,67,4135
3/1/2017,VA,Virginia,Cumberland,51049,2231,1708,523,1860,*,*,371,*,*,2059,1536,523,1612,1148,464,409,98,34,1071
3/1/2017,VA,Virginia,Danville City,51590,11093,8939,2154,8731,87,8644,2362,119,2243,10462,8308,2154,8728,7310,1418,3200,444,165,4919
3/1/2017,VA,Virginia,Dickenson,51051,4739,2927,1812,2978,*,*,1761,12,1749,4507,2695,1812,3713,2105,1608,1103,213,82,2315
3/1/2017,VA,Virginia,Dinwiddie,51053,5695,4488,1207,4572,37,4535,1123,31,1092,5221,4014,1207,3853,2739,1114,894,189,52,2718
3/1/2017,VA,Virginia,Emporia City,51595,1143,874,269,883,16,867,260,12,248,1067,798,269,875,656,219,411,70,11,383
3/1/2017,VA,Virginia,Essex,51057,2838,2317,521,2417,20,2397,421,14,407,2640,2119,521,1983,1592,391,433,90,22,1438
3/1/2017,VA,Virginia,Fairfax,51059,141895,121953,19942,133894,565,133329,8001,425,7576,114560,94651,19909,66328,48091,18237,13015,2763,508,50042
3/1/2017,VA,Virginia,Fairfax City,51600,3663,3116,547,3388,13,3375,275,*,*,3055,2508,547,1850,1359,491,366,61,11,1412
3/1/2017,VA,Virginia,Falls Church City,51610,1840,1586,254,1751,*,*,89,*,*,1436,1182,254,872,640,232,124,*,*,724
3/1/2017,VA,Virginia,Fauquier,51061,11930,10604,1326,10846,60,10786,1084,38,1046,10577,9251,1326,6684,5609,1075,932,206,59,5487
3/1/2017,VA,Virginia,Floyd,51063,3923,3154,769,3384,14,3370,539,*,*,3651,2882,769,2854,2148,706,549,98,45,2162
3/1/2017,VA,Virginia,Fluvanna,51065,5606,4846,760,5026,22,5004,580,22,558,5115,4355,760,3733,3104,629,509,128,31,3065
3/1/2017,VA,Virginia,Franklin,51067,14175,10338,3837,11826,51,11775,2349,29,2320,13303,9467,3836,10795,7259,3536,1937,485,154,8219
3/1/2017,VA,Virginia,Franklin City,51620,1920,1592,328,1505,23,1482,415,23,392,1797,1469,328,1480,1179,301,559,65,15,841
3/1/2017,VA,Virginia,Frederick,51069,15575,13760,1815,13837,58,13779,1738,50,1688,14208,12394,1814,9715,8315,1400,1430,366,139,7780
3/1/2017,VA,Virginia,Fredericksburg City,51630,3874,3357,517,3171,22,3149,703,31,672,3497,2980,517,2407,1939,468,759,96,37,1515
3/1/2017,VA,Virginia,Galax City,51640,1887,1744,143,1492,*,*,395,*,*,1788,1645,143,1422,1310,112,641,59,35,687
3/1/2017,VA,Virginia,Giles,51071,4541,3457,1084,3599,24,3575,942,18,924,4266,3183,1083,3474,2777,697,786,128,33,2527
3/1/2017,VA,Virginia,Gloucester,51073,8103,6701,1402,6936,38,6898,1167,19,1148,7508,6106,1402,4790,3602,1188,939,178,44,3629
3/1/2017,VA,Virginia,Goochland,51075,5407,4261,1146,4933,23,4910,474,22,452,4890,3744,1146,3994,3072,922,400,106,36,3452
3/1/2017,VA,Virginia,Grayson,51077,4607,3948,659,3776,*,*,831,12,819,4394,3735,659,3311,2763,548,981,182,89,2059
3/1/2017,VA,Virginia,Greene,51079,3552,3086,466,3105,12,3093,447,*,*,3245,2779,466,2338,1937,401,447,86,26,1779
3/1/2017,VA,Virginia,Greensville,51081,2426,1817,609,1936,20,1916,490,17,473,2263,1654,609,1859,1367,492,524,132,29,1174
3/1/2017,VA,Virginia,Halifax,51083,9452,8135,1317,7744,70,7674,1708,56,1652,8919,7602,1317,7196,6048,1148,2107,463,145,4481
3/1/2017,VA,Virginia,Hampton City,51650,24227,18201,6026,19960,205,19755,4267,192,4075,22080,16054,6026,13388,7795,5593,3477,816,182,8913
3/1/2017,VA,Virginia,Hanover,51085,19822,15059,4763,17984,83,17901,1838,50,1788,18039,13276,4763,14401,10545,3856,1342,369,104,12586
3/1/2017,VA,Virginia,Harrisonburg City,51660,5153,4572,581,4370,16,4354,783,21,762,4657,4076,581,3664,3243,421,933,127,34,2570
3/1/2017,VA,Virginia,Henrico,51087,53870,39802,14068,46973,346,46627,6897,293,6604,48707,34641,14066,39103,27041,12062,6003,1439,406,31255
3/1/2017,VA,Virginia,Henry,51089,14982,10775,4207,11918,80,11838,3064,54,3010,14249,10042,4207,12057,8169,3888,2966,734,254,8103
3/1/2017,VA,Virginia,Highland,51091,753,681,72,690,*,*,63,*,*,704,632,72,521,456,65,61,*,*,431
3/1/2017,VA,Virginia,Hopewell City,51670,4465,3533,932,3434,31,3403,1031,30,1001,4142,3210,932,2843,1957,886,955,156,37,1695
3/1/2017,VA,Virginia,Isle of Wight,51093,7789,6080,1709,6827,52,6775,962,31,931,7208,5499,1709,5135,3598,1537,926,202,65,3942
3/1/2017,VA,Virginia,James City,51095,19476,16923,2553,18316,61,18255,1160,52,1108,17968,15418,2550,11410,9438,1972,823,216,57,10314
3/1/2017,VA,Virginia,King and Queen,51097,1703,1398,305,1429,11,1418,274,*,*,1588,1283,305,1177,915,262,263,69,17,828
3/1/2017,VA,Virginia,King George,51099,3682,3285,397,3170,16,3154,512,30,482,3197,2800,397,1625,1283,342,455,85,13,1072
3/1/2017,VA,Virginia,King William,51101,3226,2704,522,2768,28,2740,458,24,434,2967,2445,522,2387,1941,446,377,114,24,1872
3/1/2017,VA,Virginia,Lancaster,51103,4251,3669,582,3906,16,3890,345,14,331,4049,3467,582,2920,2522,398,482,99,19,2320
3/1/2017,VA,Virginia,Lee,51105,6321,3884,2437,4340,20,4320,1981,12,1969,5994,3558,2436,4869,2605,2264,1893,242,79,2655
3/1/2017,VA,Virginia,Lexington City,51678,1609,1448,161,1474,11,1463,135,*,*,1493,1332,161,1140,1010,130,214,*,*,886
3/1/2017,VA,Virginia,Loudoun,51107,34185,28787,5398,31860,147,31713,2325,112,2213,28356,22964,5392,18704,13894,4810,2894,673,156,14981
3/1/2017,VA,Virginia,Louisa,51109,7603,6254,1349,6400,39,6361,1203,32,1171,6964,5615,1349,5138,3950,1188,1019,249,74,3796
3/1/2017,VA,Virginia,Lunenburg,51111,2957,2546,411,2424,15,2409,533,22,511,2734,2323,411,2058,1704,354,700,119,46,1193
3/1/2017,VA,Virginia,Lynchburg City,51680,14457,12149,2308,11804,86,11718,2653,107,2546,13401,11093,2308,10885,8884,2001,2968,439,139,7339
3/1/2017,VA,Virginia,Madison,51113,2904,2477,427,2570,16,2554,334,12,322,2709,2282,427,1995,1641,354,387,92,24,1492
3/1/2017,VA,Virginia,Manassas City,51683,4267,3463,804,3739,34,3705,528,40,488,3598,2794,804,2473,1744,729,507,92,37,1837
3/1/2017,VA,Virginia,Manassas Park City,51685,1223,961,262,1057,13,1044,166,12,154,1034,773,261,718,484,234,181,50,11,476
3/1/2017,VA,Virginia,Martinsville City,51690,3926,2901,1025,2939,29,2910,987,42,945,3707,2682,1025,3185,2205,980,1293,174,64,1654
3/1/2017,VA,Virginia,Mathews,51115,2786,2351,435,2560,12,2548,226,*,*,2632,2197,435,1819,1476,343,258,38,18,1505
3/1/2017,VA,Virginia,Mecklenburg,51117,9019,7126,1893,7466,61,7405,1553,56,1497,8504,6611,1893,6703,5134,1569,1885,388,118,4312
3/1/2017,VA,Virginia,Middlesex,51119,3495,2946,549,3124,21,3103,371,*,*,3292,2743,549,2506,2109,397,439,91,31,1945
3/1/2017,VA,Virginia,Montgomery,51121,13455,11021,2434,11090,45,11045,2365,38,2327,12181,9747,2434,9843,7613,2230,1901,332,118,7492
3/1/2017,VA,Virginia,Nelson,51125,4392,3804,588,3886,18,3868,506,*,*,4034,3446,588,2950,2439,511,578,104,44,2224
3/1/2017,VA,Virginia,New Kent,51127,4174,3414,760,3725,21,3704,449,*,*,3786,3026,760,2651,2070,581,269,83,15,2284
3/1/2017,VA,Virginia,Newport News City,51700,26992,19969,7023,22181,201,21980,4811,241,4570,24707,17686,7021,16081,9498,6583,4509,852,238,10482
3/1/2017,VA,Virginia,Norfolk City,51710,31870,23570,8300,25381,278,25103,6489,335,6154,28731,20432,8299,19320,11464,7856,6960,1380,292,10688
3/1/2017,VA,Virginia,Northampton,51131,3522,2919,603,3006,26,2980,516,26,490,3289,2686,603,2620,2119,501,899,91,33,1597
3/1/2017,VA,Virginia,Northumberland,51133,4562,3926,636,4238,13,4225,324,*,*,4242,3606,636,2814,2437,377,402,90,35,2287
3/1/2017,VA,Virginia,Norton City,51720,1177,810,367,793,*,*,384,*,*,1090,723,367,886,562,324,342,51,19,474
3/1/2017,VA,Virginia,Nottoway,51135,3631,2969,662,2960,29,2931,671,15,656,3377,2715,662,2642,2191,451,912,139,40,1551
3/1/2017,VA,Virginia,Orange,51137,8491,7381,1110,7491,47,7444,1000,37,963,7794,6684,1110,5121,4354,767,935,220,68,3898
3/1/2017,VA,Virginia,Page,51139,6061,5313,748,4953,22,4931,1108,18,1090,5689,4941,748,4166,3537,629,1107,231,88,2740
3/1/2017,VA,Virginia,Patrick,51141,5099,3829,1270,4216,11,4205,883,12,871,4850,3581,1269,3948,2875,1073,992,207,80,2669
3/1/2017,VA,Virginia,Petersburg City,51730,7125,5303,1822,5289,101,5188,1836,87,1749,6490,4668,1822,4711,2960,1751,1978,365,62,2306
3/1/2017,VA,Virginia,Pittsylvania,51143,15855,12348,3507,13010,106,12904,2845,77,2768,14960,11453,3507,12263,9743,2520,3020,582,227,8434
3/1/2017,VA,Virginia,Poquoson City,51735,2484,2182,302,2318,*,*,166,*,*,2289,1987,302,1137,878,259,93,29,14,1001
3/1/2017,VA,Virginia,Portsmouth City,51740,17724,13022,4702,13778,187,13591,3946,203,3743,15855,11155,4700,10507,6050,4457,3751,727,143,5886
3/1/2017,VA,Virginia,Powhatan,51145,5609,4422,1187,5012,24,4988,597,14,583,5152,3965,1187,4080,3079,1001,389,116,32,3543
3/1/2017,VA,Virginia,Prince Edward,51147,4587,3752,835,3699,38,3661,888,37,851,4251,3416,835,3291,2668,623,1070,170,50,2001
3/1/2017,VA,Virginia,Prince George,51149,5636,4855,781,4785,30,4755,851,31,820,5207,4426,781,3128,2445,683,536,129,26,2437
3/1/2017,VA,Virginia,Prince William,51153,44938,36862,8076,39991,287,39704,4947,296,4651,38270,30197,8073,22200,14812,7388,4935,1006,232,16027
3/1/2017,VA,Virginia,Pulaski,51155,8923,7205,1718,7107,37,7070,1816,29,1787,8325,6607,1718,6383,4818,1565,1600,324,119,4340
3/1/2017,VA,Virginia,Radford City,51750,2026,1633,393,1628,*,*,398,*,*,1861,1468,393,1535,1182,353,339,43,21,1132
3/1/2017,VA,Virginia,Rappahannock,51157,1986,1821,165,1841,*,*,145,*,*,1787,1623,164,1186,1061,125,151,*,*,989
3/1/2017,VA,Virginia,Richmond,51159,1968,1582,386,1714,15,1699,254,13,241,1825,1439,386,1357,1098,259,290,88,21,958
3/1/2017,VA,Virginia,Richmond City,51760,32973,22117,10856,25844,294,25550,7129,341,6788,29628,18772,10856,24849,14581,10268,8583,1466,309,14491
3/1/2017,VA,Virginia,Roanoke,51161,22888,17968,4920,20352,108,20244,2536,55,2481,21196,16277,4919,16828,12531,4297,1941,452,152,14283
3/1/2017,VA,Virginia,Roanoke City,51770,20186,14383,5803,15116,140,14976,5070,149,4921,18450,12648,5802,14936,9510,5426,4687,882,215,9152
3/1/2017,VA,Virginia,Rockbridge,51163,5811,4879,932,4941,25,4916,870,*,*,5394,4462,932,4056,3292,764,807,190,75,2984
3/1/2017,VA,Virginia,Rockingham,51165,16806,14227,2579,14715,48,14667,2091,37,2054,15562,12983,2579,12004,10161,1843,1768,505,158,9573
3/1/2017,VA,Virginia,Russell,51167,7720,5118,2602,5260,19,5241,2460,13,2447,7384,4782,2602,6307,4150,2157,1658,311,131,4207
3/1/2017,VA,Virginia,Salem City,51775,5988,4761,1227,5048,31,5017,940,18,922,5495,4268,1227,4340,3249,1091,823,149,39,3329
3/1/2017,VA,Virginia,Scott,51169,6568,3336,3232,4925,11,4914,1643,13,1630,6294,3063,3231,5450,2283,3167,1497,254,124,3575
3/1/2017,VA,Virginia,Shenandoah,51171,10178,8966,1212,8965,28,8937,1213,27,1186,9517,8305,1212,6673,5716,957,1235,264,103,5071
3/1/2017,VA,Virginia,Smyth,51173,8815,6749,2066,6566,28,6538,2249,24,2225,8300,6234,2066,6757,4921,1836,2152,413,139,4053
3/1/2017,VA,Virginia,Southampton,51175,4009,3346,663,3343,30,3313,666,19,647,3734,3071,663,2936,2365,571,722,131,36,2047
3/1/2017,VA,Virginia,Spotsylvania,51177,19676,17047,2629,17060,113,16947,2616,92,2524,17490,14862,2628,10598,8448,2150,1891,514,135,8058
3/1/2017,VA,Virginia,Stafford,51179,16105,14460,1645,14189,100,14089,1916,84,1832,14104,12459,1645,7152,5786,1366,1297,367,80,5408
3/1/2017,VA,Virginia,Staunton City,51790,5971,5107,864,4936,25,4911,1035,23,1012,5610,4746,864,4378,3667,711,1033,166,70,3109
3/1/2017,VA,Virginia,Suffolk City,51800,15330,12087,3243,12555,103,12452,2775,98,2677,14022,10779,3243,9699,6778,2921,2599,464,109,6527
3/1/2017,VA,Virginia,Surry,51181,1526,1178,348,1290,11,1279,236,*,*,1413,1065,348,1027,709,318,202,67,15,743
3/1/2017,VA,Virginia,Sussex,51183,2329,1774,555,1905,31,1874,424,*,*,2165,1610,555,1678,1161,517,470,145,19,1044
3/1/2017,VA,Virginia,Tazewell,51185,11783,8375,3408,8693,37,8656,3090,39,3051,11135,7729,3406,8816,6589,2227,2229,460,187,5940
3/1/2017,VA,Virginia,Unknown,51999,*,*,*,*,*,*,*,*,*,*,*,*,*,*,*,*,*,*,*
3/1/2017,VA,Virginia,Virginia Beach City,51810,67763,55816,11947,59710,373,59337,8053,339,7714,62031,50090,11941,35150,24409,10741,6509,1444,375,26822
3/1/2017,VA,Virginia,Warren,51187,7235,6489,746,6196,32,6164,1039,29,1010,6587,5841,746,4466,3867,599,869,245,74,3278
3/1/2017,VA,Virginia,Washington,51191,14752,9871,4881,11804,47,11757,2948,30,2918,13864,8984,4880,11260,6771,4489,2430,533,168,8129
3/1/2017,VA,Virginia,Waynesboro City,51820,4684,3953,731,3827,15,3812,857,25,832,4370,3639,731,3472,2845,627,867,116,40,2449
3/1/2017,VA,Virginia,Westmoreland,51193,4776,4091,685,4190,28,4162,586,11,575,4371,3686,685,2765,2202,563,716,139,51,1859
3/1/2017,VA,Virginia,Williamsburg City,51830,2523,2122,401,2310,*,*,213,*,*,2318,1918,400,1624,1295,329,228,*,*,1357
3/1/2017,VA,Virginia,Winchester City,51840,5037,4489,548,4283,22,4261,754,18,736,4555,4007,548,3301,2870,431,823,135,52,2291
3/1/2017,VA,Virginia,Wise,51195,10483,6688,3795,7044,23,7021,3439,23,3416,9876,6081,3795,7806,4350,3456,2390,480,165,4771
3/1/2017,VA,Virginia,Wythe,51197,7467,5694,1773,5823,34,5789,1644,20,1624,7036,5263,1773,5492,3951,1541,1476,275,106,3635
3/1/2017,VA,Virginia,York,51199,11255,9725,1530,10324,36,10288,931,29,902,10312,8782,1530,5477,4191,1286,643,168,43,4623
5/1/2017,VA,Virginia,Accomack,51001,8558,7205,1353,7366,50,7316,1192,47,1145,7951,6598,1353,5829,4783,1046,1473,379,91,3886
5/1/2017,VA,Virginia,Albemarle,51003,19619,17415,2204,18057,62,17995,1562,51,1511,17581,15377,2204,13334,11414,1920,1510,298,96,11430
5/1/2017,VA,Virginia,Alexandria City,51510,17051,14595,2456,15654,81,15573,1397,90,1307,13700,11248,2452,8201,5924,2277,2069,315,58,5759
5/1/2017,VA,Virginia,Alleghany,51005,4478,3835,643,3623,22,3601,855,14,841,4240,3597,643,3381,2892,489,774,106,50,2451
5/1/2017,VA,Virginia,Amelia,51007,2988,2295,693,2517,12,2505,471,*,*,2749,2056,693,2151,1527,624,462,83,35,1571
5/1/2017,VA,Virginia,Amherst,51009,7617,6325,1292,6359,50,6309,1258,28,1230,7070,5778,1292,5690,4562,1128,1191,237,72,4190
5/1/2017,VA,Virginia,Appomattox,51011,3754,3145,609,3074,14,3060,680,19,661,3534,2925,609,2844,2310,534,658,101,35,2050
5/1/2017,VA,Virginia,Arlington,51013,23341,20273,3068,21748,94,21654,1593,95,1498,18383,15315,3068,10916,8087,2829,2893,331,104,7588
5/1/2017,VA,Virginia,Augusta,51015,17592,15028,2564,15201,54,15147,2391,43,2348,16540,13976,2564,12591,10532,2059,1764,411,144,10272
5/1/2017,VA,Virginia,Bath,51017,1261,1151,110,1116,*,*,145,*,*,1182,1072,110,913,820,93,167,38,24,684
5/1/2017,VA,Virginia,Bedford,51019,19042,15550,3492,16281,85,16196,2761,52,2709,17699,14209,3490,13698,11151,2547,1929,476,162,11131
5/1/2017,VA,Virginia,Bland,51021,1770,1372,398,1391,*,*,379,*,*,1669,1271,398,1246,1028,218,251,51,18,926
5/1/2017,VA,Virginia,Botetourt,51023,8344,6418,1926,7229,44,7185,1115,16,1099,7716,5790,1926,6057,4386,1671,825,180,53,4999
5/1/2017,VA,Virginia,Bristol City,51520,4507,2696,1811,3490,15,3475,1017,11,1006,4218,2407,1811,3546,1803,1743,1057,151,47,2291
5/1/2017,VA,Virginia,Brunswick,51025,3916,3200,716,3214,25,3189,702,23,679,3663,2947,716,2864,2237,627,1108,104,41,1611
5/1/2017,VA,Virginia,Buchanan,51027,7282,4391,2891,4549,19,4530,2733,15,2718,6987,4096,2891,5803,3732,2071,1608,415,109,3671
5/1/2017,VA,Virginia,Buckingham,51029,3422,2778,644,2783,18,2765,639,17,622,3192,2548,644,2438,2033,405,732,141,47,1518
5/1/2017,VA,Virginia,Buena Vista City,51530,1442,1169,273,1163,*,*,279,*,*,1352,1079,273,1057,832,225,332,53,19,653
5/1/2017,VA,Virginia,Campbell,51031,12402,10327,2075,10265,80,10185,2137,61,2076,11604,9529,2075,9351,7545,1806,2063,377,164,6747
5/1/2017,VA,Virginia,Caroline,51033,5635,4645,990,4705,33,4672,930,39,891,5073,4083,990,3439,2572,867,790,229,56,2364
5/1/2017,VA,Virginia,Carroll,51035,7974,6800,1174,6442,25,6417,1532,13,1519,7522,6348,1174,5822,4894,928,1623,284,106,3809
5/1/2017,VA,Virginia,Charles City,51036,1855,1429,426,1579,19,1560,276,11,265,1699,1273,426,1301,944,357,259,78,17,947
5/1/2017,VA,Virginia,Charlotte,51037,3334,2791,543,2696,14,2682,638,17,621,3150,2607,543,2487,2020,467,792,133,51,1511
5/1/2017,VA,Virginia,Charlottesville City,51540,6081,5309,772,4991,30,4961,1090,49,1041,5433,4662,771,4315,3590,725,1221,159,47,2888
5/1/2017,VA,Virginia,Chesapeake City,51550,35831,28475,7356,30712,275,30437,5119,225,4894,32364,25008,7356,19855,13317,6538,4038,887,245,14685
5/1/2017,VA,Virginia,Chesterfield,51041,56456,42889,13567,49131,190,48941,7325,248,7077,50837,37273,13564,38858,26804,12054,5228,1022,277,32331
5/1/2017,VA,Virginia,Clarke,51043,3134,2776,358,2886,11,2875,248,*,*,2831,2473,358,1904,1629,275,251,73,27,1553
5/1/2017,VA,Virginia,Colonial Heights City,51570,4123,3432,691,3517,*,*,606,16,590,3792,3101,691,2445,1855,590,490,98,23,1834
5/1/2017,VA,Virginia,Covington City,51580,1642,1395,247,1271,13,1258,371,*,*,1535,1288,247,1216,987,229,355,53,20,788
5/1/2017,VA,Virginia,Craig,51045,1308,1026,282,1027,*,*,281,0,281,1202,920,282,942,675,267,198,45,11,688
5/1/2017,VA,Virginia,Culpeper,51047,8901,7572,1329,7691,41,7650,1210,42,1168,8064,6735,1329,5565,4504,1061,1143,246,64,4112
5/1/2017,VA,Virginia,Cumberland,51049,2236,1721,515,1864,*,*,372,*,*,2071,1556,515,1614,1159,455,415,97,33,1069
5/1/2017,VA,Virginia,Danville City,51590,11076,8897,2179,8709,85,8624,2367,115,2252,10433,8254,2179,8678,7237,1441,3201,433,159,4885
5/1/2017,VA,Virginia,Dickenson,51051,4734,2922,1812,2964,*,*,1770,12,1758,4507,2695,1812,3704,2097,1607,1111,206,77,2310
5/1/2017,VA,Virginia,Dinwiddie,51053,5692,4491,1201,4570,36,4534,1122,30,1092,5221,4020,1201,3846,2736,1110,895,184,52,2715
5/1/2017,VA,Virginia,Emporia City,51595,1138,873,265,877,16,861,261,12,249,1057,792,265,867,650,217,408,69,11,379
5/1/2017,VA,Virginia,Essex,51057,2842,2314,528,2416,17,2399,426,13,413,2639,2111,528,1970,1575,395,431,87,21,1431
5/1/2017,VA,Virginia,Fairfax,51059,143034,122869,20165,134948,542,134406,8086,435,7651,115188,95058,20130,66646,48188,18458,13165,2661,494,50326
5/1/2017,VA,Virginia,Fairfax City,51600,3680,3131,549,3406,13,3393,274,*,*,3063,2514,549,1860,1367,493,367,*,*,1426
5/1/2017,VA,Virginia,Falls Church City,51610,1869,1615,254,1779,*,*,90,*,*,1446,1192,254,880,645,235,125,*,*,731
5/1/2017,VA,Virginia,Fauquier,51061,11991,10674,1317,10899,59,10840,1092,41,1051,10628,9311,1317,6702,5638,1064,942,194,57,5509
5/1/2017,VA,Virginia,Floyd,51063,3927,3158,769,3389,15,3374,538,*,*,3650,2881,769,2846,2140,706,544,95,40,2167
5/1/2017,VA,Virginia,Fluvanna,51065,5624,4870,754,5041,21,5020,583,22,561,5135,4381,754,3743,3120,623,514,121,31,3077
5/1/2017,VA,Virginia,Franklin,51067,14204,10386,3818,11843,48,11795,2361,28,2333,13335,9518,3817,10785,7269,3516,1945,476,147,8217
5/1/2017,VA,Virginia,Franklin City,51620,1922,1590,332,1504,23,1481,418,22,396,1798,1466,332,1470,1166,304,561,62,14,833
5/1/2017,VA,Virginia,Frederick,51069,15646,13837,1809,13886,54,13832,1760,53,1707,14245,12437,1808,9750,8350,1400,1452,344,135,7819
5/1/2017,VA,Virginia,Fredericksburg City,51630,3898,3375,523,3191,22,3169,707,31,676,3514,2991,523,2409,1936,473,769,91,36,1513
5/1/2017,VA,Virginia,Galax City,51640,1882,1740,142,1484,*,*,398,*,*,1783,1641,142,1414,1305,109,642,57,30,685
5/1/2017,VA,Virginia,Giles,51071,4557,3469,1088,3606,24,3582,951,19,932,4277,3190,1087,3472,2767,705,792,124,32,2524
5/1/2017,VA,Virginia,Gloucester,51073,8124,6718,1406,6951,38,6913,1173,20,1153,7519,6113,1406,4776,3583,1193,952,176,42,3606
5/1/2017,VA,Virginia,Goochland,51075,5436,4286,1150,4958,22,4936,478,22,456,4914,3764,1150,4003,3080,923,404,103,34,3462
5/1/2017,VA,Virginia,Grayson,51077,4613,3954,659,3781,*,*,832,12,820,4397,3738,659,3290,2743,547,983,175,89,2043
5/1/2017,VA,Virginia,Greene,51079,3567,3106,461,3115,13,3102,452,*,*,3249,2788,461,2335,1938,397,450,83,24,1778
5/1/2017,VA,Virginia,Greensville,51081,2432,1824,608,1944,20,1924,488,15,473,2272,1664,608,1851,1359,492,532,126,26,1167
5/1/2017,VA,Virginia,Halifax,51083,9480,8167,1313,7763,70,7693,1717,57,1660,8948,7635,1313,7184,6045,1139,2122,445,140,4477
5/1/2017,VA,Virginia,Hampton City,51650,24275,18213,6062,19961,198,19763,4314,192,4122,22116,16054,6062,13357,7727,5630,3517,787,171,8882
5/1/2017,VA,Virginia,Hanover,51085,19895,15128,4767,18054,81,17973,1841,47,1794,18086,13320,4766,14433,10574,3859,1344,366,95,12628
5/1/2017,VA,Virginia,Harrisonburg City,51660,5154,4576,578,4368,15,4353,786,22,764,4650,4072,578,3643,3225,418,938,126,33,2546
5/1/2017,VA,Virginia,Henrico,51087,53966,39855,14111,47037,337,46700,6929,288,6641,48751,34642,14109,39098,26978,12120,6072,1391,397,31238
5/1/2017,VA,Virginia,Henry,51089,14982,10793,4189,11905,76,11829,3077,54,3023,14241,10052,4189,12022,8150,3872,3002,710,245,8065
5/1/2017,VA,Virginia,Highland,51091,758,682,76,694,*,*,64,*,*,710,634,76,532,463,69,63,*,*,441
5/1/2017,VA,Virginia,Hopewell City,51670,4473,3556,917,3434,31,3403,1039,31,1008,4147,3230,917,2825,1953,872,957,154,32,1682
5/1/2017,VA,Virginia,Isle of Wight,51093,7823,6114,1709,6855,51,6804,968,33,935,7243,5534,1709,5155,3621,1534,936,196,58,3965
5/1/2017,VA,Virginia,James City,51095,19557,17017,2540,18380,58,18322,1177,56,1121,18033,15496,2537,11433,9476,1957,822,217,59,10335
5/1/2017,VA,Virginia,King and Queen,51097,1706,1411,295,1432,11,1421,274,*,*,1590,1295,295,1168,915,253,269,69,15,815
5/1/2017,VA,Virginia,King George,51099,3683,3285,398,3175,16,3159,508,29,479,3207,2809,398,1627,1284,343,455,85,12,1075
5/1/2017,VA,Virginia,King William,51101,3238,2718,520,2778,25,2753,460,24,436,2972,2452,520,2389,1945,444,376,115,25,1873
5/1/2017,VA,Virginia,Lancaster,51103,4259,3679,580,3909,17,3892,350,14,336,4054,3474,580,2919,2521,398,488,97,17,2317
5/1/2017,VA,Virginia,Lee,51105,6331,3864,2467,4340,17,4323,1991,*,*,6007,3543,2464,4882,2586,2296,1907,243,77,2655
5/1/2017,VA,Virginia,Lexington City,51678,1612,1449,163,1474,11,1463,138,*,*,1494,1331,163,1143,1010,133,219,*,*,884
5/1/2017,VA,Virginia,Loudoun,51107,34454,29060,5394,32103,139,31964,2351,112,2239,28494,23106,5388,18762,13958,4804,2930,656,152,15024
5/1/2017,VA,Virginia,Louisa,51109,7649,6304,1345,6431,37,6394,1218,35,1183,6986,5641,1345,5135,3952,1183,1031,246,71,3787
5/1/2017,VA,Virginia,Lunenburg,51111,2973,2570,403,2436,15,2421,537,22,515,2748,2345,403,2065,1717,348,709,115,44,1197
5/1/2017,VA,Virginia,Lynchburg City,51680,14468,12181,2287,11804,84,11720,2664,107,2557,13401,11114,2287,10853,8871,1982,2985,444,130,7294
5/1/2017,VA,Virginia,Madison,51113,2913,2489,424,2585,15,2570,328,12,316,2714,2290,424,2002,1650,352,389,90,24,1499
5/1/2017,VA,Virginia,Manassas City,51683,4301,3488,813,3764,33,3731,537,41,496,3625,2812,813,2482,1744,738,517,89,32,1844
5/1/2017,VA,Virginia,Manassas Park City,51685,1225,964,261,1058,12,1046,167,13,154,1032,772,260,717,483,234,183,*,*,480
5/1/2017,VA,Virginia,Martinsville City,51690,3899,2892,1007,2905,29,2876,994,41,953,3681,2674,1007,3150,2187,963,1280,170,65,1635
5/1/2017,VA,Virginia,Mathews,51115,2796,2359,437,2566,*,*,230,*,*,2642,2205,437,1814,1466,348,257,40,19,1498
5/1/2017,VA,Virginia,Mecklenburg,51117,9015,7131,1884,7452,59,7393,1563,58,1505,8487,6603,1884,6643,5082,1561,1879,381,113,4270
5/1/2017,VA,Virginia,Middlesex,51119,3502,2959,543,3131,20,3111,371,*,*,3295,2752,543,2492,2099,393,446,86,27,1933
5/1/2017,VA,Virginia,Montgomery,51121,13480,11045,2435,11106,42,11064,2374,38,2336,12180,9745,2435,9852,7618,2234,1919,327,118,7488
5/1/2017,VA,Virginia,Nelson,51125,4419,3836,583,3911,18,3893,508,*,*,4059,3476,583,2955,2448,507,584,100,43,2228
5/1/2017,VA,Virginia,New Kent,51127,4205,3434,771,3755,21,3734,450,*,*,3815,3044,771,2661,2073,588,273,83,17,2288
5/1/2017,VA,Virginia,Newport News City,51700,27086,20061,7025,22237,197,22040,4849,243,4606,24752,17729,7023,16085,9500,6585,4600,837,227,10421
5/1/2017,VA,Virginia,Norfolk City,51710,31952,23632,8320,25418,268,25150,6534,338,6196,28774,20455,8319,19303,11429,7874,7053,1342,277,10631
5/1/2017,VA,Virginia,Northampton,51131,3544,2939,605,3018,24,2994,526,26,500,3309,2704,605,2625,2122,503,909,90,30,1596
5/1/2017,VA,Virginia,Northumberland,51133,4566,3933,633,4242,13,4229,324,*,*,4246,3613,633,2806,2431,375,408,87,33,2278
5/1/2017,VA,Virginia,Norton City,51720,1178,809,369,789,*,*,389,*,*,1095,726,369,887,560,327,344,50,18,475
5/1/2017,VA,Virginia,Nottoway,51135,3634,2976,658,2955,29,2926,679,15,664,3378,2720,658,2637,2186,451,920,133,39,1545
5/1/2017,VA,Virginia,Orange,51137,8518,7420,1098,7507,47,7460,1011,38,973,7817,6719,1098,5121,4366,755,947,217,64,3893
5/1/2017,VA,Virginia,Page,51139,6078,5337,741,4960,22,4938,1118,19,1099,5706,4965,741,4153,3530,623,1118,226,82,2727
5/1/2017,VA,Virginia,Patrick,51141,5091,3828,1263,4201,11,4190,890,*,*,4840,3578,1262,3940,2871,1069,1001,202,74,2663
5/1/2017,VA,Virginia,Petersburg City,51730,7134,5300,1834,5279,99,5180,1855,89,1766,6493,4659,1834,4687,2924,1763,2004,353,57,2273
5/1/2017,VA,Virginia,Pittsylvania,51143,15879,12350,3529,13012,104,12908,2867,77,2790,14969,11440,3529,12253,9732,2521,3046,559,216,8432
5/1/2017,VA,Virginia,Poquoson City,51735,2485,2184,301,2316,*,*,169,*,*,2288,1987,301,1128,870,258,96,25,15,992
5/1/2017,VA,Virginia,Portsmouth City,51740,17734,13035,4699,13761,179,13582,3973,208,3765,15839,11142,4697,10482,6027,4455,3777,711,138,5856
5/1/2017,VA,Virginia,Powhatan,51145,5649,4468,1181,5047,22,5025,602,13,589,5180,3999,1181,4096,3100,996,391,110,32,3563
5/1/2017,VA,Virginia,Prince Edward,51147,4579,3750,829,3691,38,3653,888,36,852,4247,3418,829,3275,2654,621,1077,163,48,1987
5/1/2017,VA,Virginia,Prince George,51149,5652,4884,768,4798,29,4769,854,32,822,5228,4460,768,3122,2450,672,534,131,26,2431
5/1/2017,VA,Virginia,Prince William,51153,45276,37170,8106,40274,276,39998,5002,298,4704,38463,30361,8102,22204,14787,7417,4983,979,219,16023
5/1/2017,VA,Virginia,Pulaski,51155,8933,7211,1722,7109,35,7074,1824,30,1794,8326,6604,1722,6356,4786,1570,1607,322,117,4310
5/1/2017,VA,Virginia,Radford City,51750,2019,1633,386,1618,*,*,401,*,*,1852,1466,386,1525,1179,346,343,42,20,1120
5/1/2017,VA,Virginia,Rappahannock,51157,1998,1829,169,1852,*,*,146,*,*,1799,1631,168,1188,1060,128,154,*,*,990
5/1/2017,VA,Virginia,Richmond,51159,1967,1580,387,1707,15,1692,260,13,247,1825,1438,387,1351,1094,257,292,86,20,953
5/1/2017,VA,Virginia,Richmond City,51760,33048,22162,10886,25904,284,25620,7144,344,6800,29676,18790,10886,24835,14535,10300,8660,1417,286,14472
5/1/2017,VA,Virginia,Roanoke,51161,22913,18016,4897,20357,104,20253,2556,56,2500,21204,16308,4896,16822,12542,4280,1939,432,142,14309
5/1/2017,VA,Virginia,Roanoke City,51770,20213,14426,5787,15127,135,14992,5086,149,4937,18438,12652,5786,14868,9457,5411,4729,856,204,9079
5/1/2017,VA,Virginia,Rockbridge,51163,5824,4901,923,4940,23,4917,884,*,*,5402,4479,923,4047,3288,759,809,185,71,2982
5/1/2017,VA,Virginia,Rockingham,51165,16866,14297,2569,14761,46,14715,2105,37,2068,15578,13009,2569,12014,10175,1839,1791,498,145,9580
5/1/2017,VA,Virginia,Russell,51167,7728,5126,2602,5260,18,5242,2468,13,2455,7390,4788,2602,6307,4152,2155,1671,301,125,4210
5/1/2017,VA,Virginia,Salem City,51775,6003,4784,1219,5059,31,5028,944,18,926,5498,4279,1219,4345,3257,1088,834,143,38,3330
5/1/2017,VA,Virginia,Scott,51169,6584,3350,3234,4931,11,4920,1653,14,1639,6308,3075,3233,5453,2282,3171,1504,246,124,3579
5/1/2017,VA,Virginia,Shenandoah,51171,10235,9031,1204,9011,27,8984,1224,26,1198,9572,8368,1204,6695,5745,950,1257,260,100,5078
5/1/2017,VA,Virginia,Smyth,51173,8800,6749,2051,6544,28,6516,2256,24,2232,8279,6228,2051,6718,4897,1821,2160,405,134,4019
5/1/2017,VA,Virginia,Southampton,51175,4020,3352,668,3350,29,3321,670,19,651,3744,3076,668,2930,2353,577,724,130,34,2042
5/1/2017,VA,Virginia,Spotsylvania,51177,19770,17150,2620,17130,110,17020,2640,96,2544,17563,14944,2619,10595,8457,2138,1923,497,131,8044
5/1/2017,VA,Virginia,Stafford,51179,16202,14567,1635,14272,97,14175,1930,82,1848,14170,12535,1635,7145,5788,1357,1322,356,76,5391
5/1/2017,VA,Virginia,Staunton City,51790,5983,5139,844,4951,24,4927,1032,20,1012,5607,4763,844,4365,3672,693,1051,156,62,3096
5/1/2017,VA,Virginia,Suffolk City,51800,15377,12119,3258,12579,99,12480,2798,100,2698,14054,10796,3258,9659,6725,2934,2611,456,105,6487
5/1/2017,VA,Virginia,Surry,51181,1526,1182,344,1285,*,*,241,*,*,1418,1074,344,1022,707,315,201,64,14,743
5/1/2017,VA,Virginia,Sussex,51183,2328,1772,556,1903,29,1874,425,*,*,2164,1608,556,1665,1146,519,477,139,19,1030
5/1/2017,VA,Virginia,Tazewell,51185,11816,8405,3411,8699,35,8664,3117,40,3077,11176,7767,3409,8813,6579,2234,2248,445,185,5935
5/1/2017,VA,Virginia,Unknown,51999,*,*,*,*,*,*,*,*,*,*,*,*,*,*,*,*,*,*,*
5/1/2017,VA,Virginia,Virginia Beach City,51810,68112,56145,11967,59993,359,59634,8119,337,7782,62275,50315,11960,35201,24437,10764,6620,1421,355,26805
5/1/2017,VA,Virginia,Warren,51187,7273,6535,738,6219,29,6190,1054,29,1025,6621,5883,738,4465,3874,591,878,235,74,3278
5/1/2017,VA,Virginia,Washington,51191,14754,9887,4867,11802,45,11757,2952,30,2922,13881,9015,4866,11238,6757,4481,2442,523,164,8109
5/1/2017,VA,Virginia,Waynesboro City,51820,4679,3966,713,3817,14,3803,862,26,836,4355,3642,713,3441,2828,613,862,116,36,2427
5/1/2017,VA,Virginia,Westmoreland,51193,4795,4112,683,4204,26,4178,591,11,580,4385,3702,683,2761,2200,561,723,134,49,1855
5/1/2017,VA,Virginia,Williamsburg City,51830,2526,2126,400,2311,*,*,215,*,*,2320,1921,399,1625,1296,329,231,*,*,1356
5/1/2017,VA,Virginia,Winchester City,51840,5054,4505,549,4296,22,4274,758,18,740,4563,4014,549,3292,2860,432,832,132,51,2277
5/1/2017,VA,Virginia,Wise,51195,10508,6701,3807,7040,24,7016,3468,22,3446,9902,6095,3807,7809,4340,3469,2418,462,167,4762
5/1/2017,VA,Virginia,Wythe,51197,7481,5694,1787,5824,33,5791,1657,20,1637,7056,5269,1787,5495,3941,1554,1496,268,102,3629
5/1/2017,VA,Virginia,York,51199,11314,9780,1534,10379,34,10345,935,29,906,10355,8821,1534,5483,4194,1289,649,163,40,4631
11/1/2017,VA,Virginia,Accomack,51001,8665,7320,1345,7439,46,7393,1226,46,1180,8073,6728,1345,5894,4853,1041,1508,379,92,3915
11/1/2017,VA,Virginia,Albemarle,51003,19944,17812,2132,18361,54,18307,1583,49,1534,17880,15748,2132,13548,11702,1846,1533,293,98,11624
11/1/2017,VA,Virginia,Alexandria City,51510,17440,14996,2444,16005,75,15930,1435,95,1340,14029,11589,2440,8364,6095,2269,2131,315,62,5856
11/1/2017,VA,Virginia,Alleghany,51005,4486,3871,615,3616,19,3597,870,14,856,4255,3640,615,3393,2931,462,795,99,53,2446
11/1/2017,VA,Virginia,Amelia,51007,3018,2336,682,2537,*,*,481,*,*,2787,2105,682,2177,1563,614,471,89,38,1579
11/1/2017,VA,Virginia,Amherst,51009,7659,6379,1280,6377,47,6330,1282,29,1253,7103,5823,1280,5726,4608,1118,1236,225,75,4190
11/1/2017,VA,Virginia,Appomattox,51011,3770,3166,604,3079,13,3066,691,19,672,3547,2943,604,2847,2317,530,676,102,37,2032
11/1/2017,VA,Virginia,Arlington,51013,23825,20765,3060,22189,88,22101,1636,97,1539,18764,15704,3060,11143,8320,2823,2944,351,109,7739
11/1/2017,VA,Virginia,Augusta,51015,17824,15320,2504,15368,51,15317,2456,43,2413,16735,14231,2504,12729,10724,2005,1822,406,145,10356
11/1/2017,VA,Virginia,Bath,51017,1270,1171,99,1119,*,*,151,*,*,1197,1098,99,921,837,84,167,36,25,693
11/1/2017,VA,Virginia,Bedford,51019,19225,15821,3404,16438,80,16358,2787,50,2737,17893,14491,3402,13840,11367,2473,1980,481,161,11218
11/1/2017,VA,Virginia,Bland,51021,1779,1379,400,1394,*,*,385,*,*,1694,1294,400,1256,1033,223,252,51,15,938
11/1/2017,VA,Virginia,Botetourt,51023,8458,6556,1902,7320,39,7281,1138,17,1121,7847,5945,1902,6134,4489,1645,824,179,54,5077
11/1/2017,VA,Virginia,Bristol City,51520,4503,2691,1812,3467,14,3453,1036,*,*,4231,2419,1812,3554,1817,1737,1070,150,51,2283
11/1/2017,VA,Virginia,Brunswick,51025,3936,3237,699,3221,21,3200,715,24,691,3685,2986,699,2871,2265,606,1099,109,42,1621
11/1/2017,VA,Virginia,Buchanan,51027,7289,4388,2901,4519,17,4502,2770,12,2758,7019,4118,2901,5810,3721,2089,1644,404,114,3648
11/1/2017,VA,Virginia,Buckingham,51029,3457,2819,638,2803,17,2786,654,22,632,3230,2592,638,2460,2058,402,728,152,47,1533
11/1/2017,VA,Virginia,Buena Vista City,51530,1446,1179,267,1167,*,*,279,*,*,1351,1084,267,1051,831,220,329,51,19,652
11/1/2017,VA,Virginia,Campbell,51031,12516,10466,2050,10332,71,10261,2184,61,2123,11708,9658,2050,9419,7634,1785,2100,374,166,6779
11/1/2017,VA,Virginia,Caroline,51033,5695,4724,971,4739,31,4708,956,41,915,5144,4173,971,3482,2634,848,825,226,54,2377
11/1/2017,VA,Virginia,Carroll,51035,8008,6846,1162,6465,22,6443,1543,13,1530,7558,6396,1162,5833,4919,914,1627,282,105,3819
11/1/2017,VA,Virginia,Charles City,51036,1893,1479,414,1609,18,1591,284,11,273,1737,1323,414,1327,980,347,270,80,17,960
11/1/2017,VA,Virginia,Charlotte,51037,3344,2821,523,2697,12,2685,647,19,628,3157,2634,523,2493,2043,450,806,125,53,1509
11/1/2017,VA,Virginia,Charlottesville City,51540,6184,5453,731,5087,27,5060,1097,46,1051,5532,4802,730,4376,3691,685,1252,156,53,2915
11/1/2017,VA,Virginia,Chesapeake City,51550,36445,29139,7306,31198,252,30946,5247,226,5021,32978,25672,7306,20174,13673,6501,4177,896,253,14848
11/1/2017,VA,Virginia,Chesterfield,51041,57478,43879,13599,49979,181,49798,7499,246,7253,51807,38212,13595,39597,27499,12098,5430,1020,275,32872
11/1/2017,VA,Virginia,Clarke,51043,3171,2807,364,2915,11,2904,256,*,*,2866,2502,364,1914,1635,279,255,69,27,1563
11/1/2017,VA,Virginia,Colonial Heights City,51570,4142,3465,677,3524,*,*,618,15,603,3810,3133,677,2462,1884,578,507,99,25,1831
11/1/2017,VA,Virginia,Covington City,51580,1642,1409,233,1259,*,*,383,*,*,1536,1303,233,1220,1006,214,357,55,19,789
11/1/2017,VA,Virginia,Craig,51045,1315,1041,274,1028,*,*,287,0,287,1212,938,274,954,693,261,210,42,15,687
11/1/2017,VA,Virginia,Culpeper,51047,9016,7712,1304,7777,35,7742,1239,44,1195,8168,6865,1303,5652,4614,1038,1193,231,66,4162
11/1/2017,VA,Virginia,Cumberland,51049,2242,1743,499,1864,*,*,378,*,*,2076,1577,499,1619,1178,441,427,93,36,1063
11/1/2017,VA,Virginia,Danville City,51590,11128,8967,2161,8725,83,8642,2403,119,2284,10465,8304,2161,8697,7279,1418,3267,411,155,4864
11/1/2017,VA,Virginia,Dickenson,51051,4729,2903,1826,2939,*,*,1790,*,*,4529,2703,1826,3705,2079,1626,1136,207,74,2288
11/1/2017,VA,Virginia,Dinwiddie,51053,5743,4562,1181,4594,30,4564,1149,30,1119,5279,4098,1181,3869,2779,1090,908,185,52,2724
11/1/2017,VA,Virginia,Emporia City,51595,1135,880,255,873,16,857,262,*,*,1057,802,255,866,662,204,411,68,12,375
11/1/2017,VA,Virginia,Essex,51057,2869,2355,514,2444,14,2430,425,14,411,2663,2149,514,1979,1598,381,433,84,25,1437
11/1/2017,VA,Virginia,Fairfax,51059,146514,125844,20670,138221,487,137734,8293,438,7855,118145,97507,20638,68289,49314,18975,13617,2683,509,51480
11/1/2017,VA,Virginia,Fairfax City,51600,3726,3163,563,3447,11,3436,279,12,267,3121,2559,562,1887,1380,507,376,*,*,1444
11/1/2017,VA,Virginia,Falls Church City,51610,1914,1651,263,1826,*,*,88,*,*,1489,1226,263,904,661,243,126,*,*,754
11/1/2017,VA,Virginia,Fauquier,51061,12196,10913,1283,11080,56,11024,1116,41,1075,10828,9545,1283,6844,5813,1031,978,192,57,5617
11/1/2017,VA,Virginia,Floyd,51063,3959,3218,741,3412,14,3398,547,*,*,3700,2959,741,2861,2182,679,567,87,42,2165
11/1/2017,VA,Virginia,Fluvanna,51065,5696,4966,730,5100,20,5080,596,22,574,5220,4490,730,3787,3184,603,525,120,30,3112
11/1/2017,VA,Virginia,Franklin,51067,14364,10571,3793,11957,41,11916,2407,30,2377,13491,9699,3792,10884,7394,3490,2006,472,156,8250
11/1/2017,VA,Virginia,Franklin City,51620,1926,1612,314,1501,21,1480,425,23,402,1804,1490,314,1469,1182,287,564,60,15,830
11/1/2017,VA,Virginia,Frederick,51069,15808,14020,1788,13995,48,13947,1813,54,1759,14393,12607,1786,9829,8447,1382,1505,342,135,7847
11/1/2017,VA,Virginia,Fredericksburg City,51630,3952,3461,491,3221,21,3200,731,30,701,3543,3052,491,2435,1993,442,795,85,37,1518
11/1/2017,VA,Virginia,Galax City,51640,1893,1756,137,1484,*,*,409,11,398,1789,1652,137,1418,1314,104,639,58,28,693
11/1/2017,VA,Virginia,Giles,51071,4588,3547,1041,3615,21,3594,973,17,956,4317,3277,1040,3507,2839,668,813,126,33,2535
11/1/2017,VA,Virginia,Gloucester,51073,8234,6851,1383,7042,34,7008,1192,22,1170,7615,6232,1383,4839,3670,1169,988,166,44,3641
11/1/2017,VA,Virginia,Goochland,51075,5546,4414,1132,5056,19,5037,490,23,467,5004,3872,1132,4075,3168,907,404,99,34,3538
11/1/2017,VA,Virginia,Grayson,51077,4623,3953,670,3773,*,*,850,11,839,4412,3742,670,3299,2740,559,998,175,85,2041
11/1/2017,VA,Virginia,Greene,51079,3623,3166,457,3162,12,3150,461,*,*,3302,2845,457,2367,1974,393,457,80,27,1803
11/1/2017,VA,Virginia,Greensville,51081,2424,1837,587,1933,18,1915,491,15,476,2268,1682,586,1834,1360,474,525,127,28,1154
11/1/2017,VA,Virginia,Halifax,51083,9526,8222,1304,7777,64,7713,1749,58,1691,8967,7663,1304,7186,6054,1132,2141,440,145,4460
11/1/2017,VA,Virginia,Hampton City,51650,24499,18438,6061,20077,188,19889,4422,196,4226,22365,16305,6060,13465,7835,5630,3668,768,176,8853
11/1/2017,VA,Virginia,Hanover,51085,20148,15421,4727,18275,75,18200,1873,47,1826,18359,13633,4726,14657,10831,3826,1405,348,95,12809
11/1/2017,VA,Virginia,Harrisonburg City,51660,5235,4674,561,4428,15,4413,807,24,783,4736,4175,561,3708,3308,400,955,124,35,2594
11/1/2017,VA,Virginia,Henrico,51087,54604,40559,14045,47545,295,47250,7059,288,6771,49341,35298,14043,39542,27459,12083,6269,1368,401,31504
11/1/2017,VA,Virginia,Henry,51089,14977,10883,4094,11852,68,11784,3125,52,3073,14244,10150,4094,12009,8232,3777,3102,698,247,7962
11/1/2017,VA,Virginia,Highland,51091,767,696,71,699,*,*,68,*,*,719,648,71,535,471,64,59,*,*,446
11/1/2017,VA,Virginia,Hopewell City,51670,4486,3576,910,3434,29,3405,1052,29,1023,4179,3269,910,2851,1983,868,988,161,31,1671
11/1/2017,VA,Virginia,Isle of Wight,51093,7936,6265,1671,6940,45,6895,996,35,961,7371,5700,1671,5196,3690,1506,953,190,61,3992
11/1/2017,VA,Virginia,James City,51095,19725,17226,2499,18521,53,18468,1204,57,1147,18247,15751,2496,11549,9627,1922,838,220,58,10433
11/1/2017,VA,Virginia,King and Queen,51097,1727,1442,285,1453,11,1442,274,*,*,1613,1328,285,1174,931,243,273,68,14,819
11/1/2017,VA,Virginia,King George,51099,3735,3369,366,3212,13,3199,523,27,496,3254,2888,366,1621,1308,313,469,77,14,1061
11/1/2017,VA,Virginia,King William,51101,3284,2775,509,2808,24,2784,476,22,454,3025,2516,509,2422,1990,432,388,116,22,1896
11/1/2017,VA,Virginia,Lancaster,51103,4264,3704,560,3909,16,3893,355,14,341,4049,3489,560,2919,2541,378,500,93,16,2310
11/1/2017,VA,Virginia,Lee,51105,6346,3870,2476,4328,16,4312,2018,12,2006,6036,3562,2474,4890,2582,2308,1939,245,79,2627
11/1/2017,VA,Virginia,Lexington City,51678,1616,1464,152,1481,*,*,135,*,*,1494,1342,152,1135,1014,121,214,*,*,881
11/1/2017,VA,Virginia,Loudoun,51107,35291,29908,5383,32861,127,32734,2430,117,2313,29175,23799,5376,19090,14282,4808,3040,636,157,15257
11/1/2017,VA,Virginia,Louisa,51109,7759,6423,1336,6518,33,6485,1241,34,1207,7090,5754,1336,5198,4024,1174,1053,246,73,3826
11/1/2017,VA,Virginia,Lunenburg,51111,2994,2607,387,2452,14,2438,542,19,523,2770,2383,387,2086,1752,334,710,116,44,1216
11/1/2017,VA,Virginia,Lynchburg City,51680,14555,12296,2259,11824,78,11746,2731,108,2623,13495,11236,2259,10919,8954,1965,3077,430,129,7283
11/1/2017,VA,Virginia,Madison,51113,2960,2547,413,2617,14,2603,343,14,329,2760,2347,413,2026,1688,338,397,89,23,1517
11/1/2017,VA,Virginia,Manassas City,51683,4408,3613,795,3860,29,3831,548,44,504,3713,2919,794,2514,1793,721,523,92,36,1863
11/1/2017,VA,Virginia,Manassas Park City,51685,1234,968,266,1066,11,1055,168,13,155,1054,789,265,722,482,240,185,*,*,485
11/1/2017,VA,Virginia,Martinsville City,51690,3923,2943,980,2904,27,2877,1019,42,977,3711,2731,980,3172,2235,937,1311,168,65,1628
11/1/2017,VA,Virginia,Mathews,51115,2826,2389,437,2593,*,*,233,*,*,2679,2242,437,1850,1502,348,271,41,20,1518
11/1/2017,VA,Virginia,Mecklenburg,51117,9055,7241,1814,7465,54,7411,1590,58,1532,8526,6712,1814,6660,5160,1500,1895,369,111,4285
11/1/2017,VA,Virginia,Middlesex,51119,3511,2986,525,3136,17,3119,375,*,*,3327,2802,525,2506,2126,380,450,82,26,1948
11/1/2017,VA,Virginia,Montgomery,51121,13647,11225,2422,11251,38,11213,2396,34,2362,12338,9916,2422,9967,7745,2222,1940,329,125,7573
11/1/2017,VA,Virginia,Nelson,51125,4510,3951,559,3994,16,3978,516,*,*,4138,3579,559,3010,2525,485,594,101,41,2274
11/1/2017,VA,Virginia,New Kent,51127,4285,3514,771,3821,17,3804,464,*,*,3899,3128,771,2716,2125,591,284,80,14,2338
11/1/2017,VA,Virginia,Newport News City,51700,27437,20485,6952,22472,185,22287,4965,248,4717,25103,18153,6950,16221,9700,6521,4711,836,227,10447
11/1/2017,VA,Virginia,Norfolk City,51710,32359,24110,8249,25701,245,25456,6658,332,6326,29161,20912,8249,19498,11678,7820,7270,1327,292,10609
11/1/2017,VA,Virginia,Northampton,51131,3575,2989,586,3041,22,3019,534,25,509,3349,2763,586,2659,2173,486,924,94,30,1611
11/1/2017,VA,Virginia,Northumberland,51133,4603,3983,620,4269,12,4257,334,*,*,4294,3674,620,2840,2475,365,424,89,37,2290
11/1/2017,VA,Virginia,Norton City,51720,1188,816,372,785,*,*,403,*,*,1104,732,372,887,558,329,353,49,17,468
11/1/2017,VA,Virginia,Nottoway,51135,3645,3017,628,2955,27,2928,690,15,675,3388,2760,628,2638,2215,423,912,132,43,1551
11/1/2017,VA,Virginia,Orange,51137,8587,7517,1070,7554,43,7511,1033,38,995,7874,6804,1070,5164,4430,734,984,218,68,3894
11/1/2017,VA,Virginia,Page,51139,6129,5400,729,4990,19,4971,1139,21,1118,5758,5029,729,4204,3589,615,1137,234,86,2747
11/1/2017,VA,Virginia,Patrick,51141,5094,3874,1220,4196,*,*,898,*,*,4846,3627,1219,3938,2906,1032,1022,192,69,2655
11/1/2017,VA,Virginia,Petersburg City,51730,7159,5363,1796,5295,93,5202,1864,86,1778,6526,4731,1795,4717,2989,1728,2060,336,63,2258
11/1/2017,VA,Virginia,Pittsylvania,51143,16013,12469,3544,13081,91,12990,2932,79,2853,15092,11548,3544,12332,9805,2527,3107,554,216,8455
11/1/2017,VA,Virginia,Poquoson City,51735,2505,2205,300,2332,*,*,173,*,*,2309,2009,300,1137,878,259,102,21,15,999
11/1/2017,VA,Virginia,Portsmouth City,51740,17928,13297,4631,13866,165,13701,4062,207,3855,16038,11409,4629,10567,6173,4394,3879,713,142,5833
11/1/2017,VA,Virginia,Powhatan,51145,5741,4576,1165,5118,19,5099,623,15,608,5256,4091,1165,4150,3172,978,401,107,32,3610
11/1/2017,VA,Virginia,Prince Edward,51147,4599,3791,808,3698,36,3662,901,35,866,4270,3462,808,3286,2687,599,1083,164,50,1989
11/1/2017,VA,Virginia,Prince George,51149,5728,4963,765,4851,25,4826,877,31,846,5319,4554,765,3205,2538,667,574,121,26,2484
11/1/2017,VA,Virginia,Prince William,51153,46405,38275,8130,41280,251,41029,5125,302,4823,39532,31407,8125,22666,15222,7444,5150,998,218,16300
11/1/2017,VA,Virginia,Pulaski,51155,8965,7260,1705,7130,32,7098,1835,28,1807,8364,6659,1705,6379,4825,1554,1630,309,121,4319
11/1/2017,VA,Virginia,Radford City,51750,2040,1650,390,1637,*,*,403,*,*,1886,1496,390,1547,1195,352,344,43,23,1137
11/1/2017,VA,Virginia,Rappahannock,51157,2020,1857,163,1870,*,*,150,*,*,1830,1668,162,1210,1088,122,158,*,*,1009
11/1/2017,VA,Virginia,Richmond,51159,1977,1596,381,1712,12,1700,265,12,253,1834,1453,381,1342,1092,250,294,83,20,945
11/1/2017,VA,Virginia,Richmond City,51760,33281,22517,10764,26047,252,25795,7234,346,6888,29962,19198,10764,25012,14825,10187,8865,1384,296,14467
11/1/2017,VA,Virginia,Roanoke,51161,23091,18234,4857,20488,86,20402,2603,55,2548,21366,16510,4856,16979,12724,4255,1988,433,143,14415
11/1/2017,VA,Virginia,Roanoke City,51770,20358,14659,5699,15206,123,15083,5152,141,5011,18558,12860,5698,14948,9618,5330,4864,843,211,9030
11/1/2017,VA,Virginia,Rockbridge,51163,5899,5007,892,4990,20,4970,909,*,*,5465,4573,892,4076,3346,730,832,182,67,2995
11/1/2017,VA,Virginia,Rockingham,51165,17023,14505,2518,14878,41,14837,2145,35,2110,15742,13224,2518,12157,10362,1795,1830,498,147,9682
11/1/2017,VA,Virginia,Russell,51167,7793,5142,2651,5276,16,5260,2517,16,2501,7475,4824,2651,6368,4172,2196,1711,305,133,4219
11/1/2017,VA,Virginia,Salem City,51775,6028,4854,1174,5071,29,5042,957,16,941,5527,4353,1174,4350,3309,1041,836,145,38,3331
11/1/2017,VA,Virginia,Scott,51169,6582,3326,3256,4888,*,*,1694,15,1679,6329,3073,3256,5474,2279,3195,1524,245,120,3585
11/1/2017,VA,Virginia,Shenandoah,51171,10361,9172,1189,9112,25,9087,1249,27,1222,9678,8489,1189,6755,5822,933,1297,256,99,5103
11/1/2017,VA,Virginia,Smyth,51173,8794,6761,2033,6513,22,6491,2281,23,2258,8297,6264,2033,6717,4907,1810,2182,399,127,4009
11/1/2017,VA,Virginia,Southampton,51175,4064,3421,643,3378,24,3354,686,16,670,3793,3150,643,2960,2406,554,744,124,35,2057
11/1/2017,VA,Virginia,Spotsylvania,51177,20085,17542,2543,17369,92,17277,2716,101,2615,17864,15322,2542,10713,8649,2064,2000,486,133,8094
11/1/2017,VA,Virginia,Stafford,51179,16551,14995,1556,14567,86,14481,1984,79,1905,14484,12928,1556,7199,5928,1271,1341,354,77,5427
11/1/2017,VA,Virginia,Staunton City,51790,6000,5195,805,4950,21,4929,1050,19,1031,5633,4828,805,4386,3729,657,1050,148,64,3124
11/1/2017,VA,Virginia,Suffolk City,51800,15539,12336,3203,12670,90,12580,2869,100,2769,14218,11015,3203,9722,6840,2882,2682,454,113,6473
11/1/2017,VA,Virginia,Surry,51181,1550,1211,339,1304,*,*,246,*,*,1440,1101,339,1038,728,310,205,60,13,760
11/1/2017,VA,Virginia,Sussex,51183,2355,1808,547,1921,27,1894,434,*,*,2190,1643,547,1676,1164,512,478,136,21,1041
11/1/2017,VA,Virginia,Tazewell,51185,11897,8433,3464,8695,31,8664,3202,40,3162,11289,7826,3463,8881,6598,2283,2298,443,187,5953
11/1/2017,VA,Virginia,Unknown,51999,*,*,*,*,*,*,*,*,*,*,*,*,*,*,*,*,*,*,*
11/1/2017,VA,Virginia,Virginia Beach City,51810,69188,57208,11980,60914,324,60590,8274,325,7949,63315,51344,11971,35720,24936,10784,6743,1421,366,27190
11/1/2017,VA,Virginia,Warren,51187,7351,6624,727,6263,27,6236,1088,31,1057,6702,5975,727,4522,3947,575,911,233,74,3304
11/1/2017,VA,Virginia,Washington,51191,14805,9942,4863,11816,38,11778,2989,29,2960,13971,9109,4862,11331,6857,4474,2493,538,165,8135
11/1/2017,VA,Virginia,Waynesboro City,51820,4735,4052,683,3857,13,3844,878,27,851,4403,3720,683,3475,2887,588,896,114,34,2431
11/1/2017,VA,Virginia,Westmoreland,51193,4876,4213,663,4264,25,4239,612,12,600,4449,3786,663,2787,2247,540,739,130,47,1871
11/1/2017,VA,Virginia,Williamsburg City,51830,2547,2159,388,2328,*,*,219,*,*,2355,1967,388,1650,1332,318,233,*,*,1378
11/1/2017,VA,Virginia,Winchester City,51840,5089,4551,538,4319,20,4299,770,15,755,4610,4072,538,3309,2886,423,850,126,52,2281
11/1/2017,VA,Virginia,Wise,51195,10545,6715,3830,7019,22,6997,3526,24,3502,9971,6142,3829,7845,4362,3483,2459,461,169,4756
11/1/2017,VA,Virginia,Wythe,51197,7520,5744,1776,5826,28,5798,1694,20,1674,7114,5338,1776,5509,3965,1544,1519,273,103,3614
11/1/2017,VA,Virginia,York,51199,11512,10001,1511,10538,31,10507,974,31,943,10549,9038,1511,5582,4315,1267,682,165,43,4692
10/1/2017,VA,Virginia,Accomack,51001,8644,7296,1348,7423,48,7375,1221,47,1174,8049,6701,1348,5888,4844,1044,1502,39,27,4320
10/1/2017,VA,Virginia,Albemarle,51003,19882,17737,2145,18301,55,18246,1581,48,1533,17847,15702,2145,13542,11683,1859,1536,27,23,11956
10/1/2017,VA,Virginia,Alexandria City,51510,17388,14943,2445,15960,76,15884,1428,94,1334,14011,11570,2441,8363,6093,2270,2130,55,14,6164
10/1/2017,VA,Virginia,Alleghany,51005,4480,3864,616,3614,19,3595,866,14,852,4251,3635,616,3390,2927,463,797,*,*,2573
10/1/2017,VA,Virginia,Amelia,51007,3014,2326,688,2533,11,2522,481,*,*,2783,2095,688,2176,1557,619,468,*,*,1694
10/1/2017,VA,Virginia,Amherst,51009,7645,6361,1284,6361,47,6314,1284,29,1255,7100,5816,1284,5724,4603,1121,1234,15,12,4463
10/1/2017,VA,Virginia,Appomattox,51011,3765,3163,602,3078,13,3065,687,18,669,3541,2939,602,2847,2319,528,672,*,*,2153
10/1/2017,VA,Virginia,Arlington,51013,23720,20659,3061,22091,88,22003,1629,95,1534,18715,15654,3061,11125,8300,2825,2936,53,28,8108
10/1/2017,VA,Virginia,Augusta,51015,17790,15275,2515,15347,51,15296,2443,43,2400,16710,14195,2515,12714,10700,2014,1810,49,24,10831
10/1/2017,VA,Virginia,Bath,51017,1265,1164,101,1117,*,*,148,*,*,1191,1090,101,920,834,86,166,*,*,743
10/1/2017,VA,Virginia,Bedford,51019,19204,15788,3416,16430,80,16350,2774,50,2724,17876,14462,3414,13843,11358,2485,1984,64,17,11778
10/1/2017,VA,Virginia,Bland,51021,1774,1375,399,1391,*,*,383,*,*,1689,1290,399,1255,1033,222,253,*,*,992
10/1/2017,VA,Virginia,Botetourt,51023,8445,6539,1906,7308,40,7268,1137,18,1119,7829,5923,1906,6128,4480,1648,829,*,*,5274
10/1/2017,VA,Virginia,Bristol City,51520,4510,2701,1809,3480,14,3466,1030,*,*,4235,2426,1809,3554,1816,1738,1069,22,12,2451
10/1/2017,VA,Virginia,Brunswick,51025,3940,3236,704,3224,22,3202,716,24,692,3692,2988,704,2881,2270,611,1113,*,*,1747
10/1/2017,VA,Virginia,Buchanan,51027,7281,4378,2903,4521,17,4504,2760,14,2746,7010,4107,2903,5806,3717,2089,1632,35,14,4125
10/1/2017,VA,Virginia,Buckingham,51029,3452,2815,637,2800,17,2783,652,22,630,3231,2594,637,2468,2065,403,734,14,14,1706
10/1/2017,VA,Virginia,Buena Vista City,51530,1446,1179,267,1165,*,*,281,*,*,1352,1085,267,1053,833,220,332,*,*,714
10/1/2017,VA,Virginia,Campbell,51031,12502,10453,2049,10329,73,10256,2173,61,2112,11697,9648,2049,9414,7630,1784,2102,52,33,7227
10/1/2017,VA,Virginia,Caroline,51033,5696,4721,975,4742,31,4711,954,41,913,5142,4167,975,3485,2634,851,823,*,*,2631
10/1/2017,VA,Virginia,Carroll,51035,8014,6852,1162,6473,22,6451,1541,13,1528,7565,6403,1162,5830,4914,916,1628,32,11,4159
10/1/2017,VA,Virginia,Charles City,51036,1887,1471,416,1604,19,1585,283,11,272,1729,1313,416,1323,974,349,268,*,*,1045
10/1/2017,VA,Virginia,Charlotte,51037,3339,2816,523,2693,12,2681,646,19,627,3153,2630,523,2489,2039,450,803,*,*,1664
10/1/2017,VA,Virginia,Charlottesville City,51540,6173,5440,733,5075,27,5048,1098,47,1051,5530,4798,732,4378,3691,687,1248,*,*,3098
10/1/2017,VA,Virginia,Chesapeake City,51550,36353,29056,7297,31126,256,30870,5227,226,5001,32905,25608,7297,20116,13627,6489,4139,109,63,15805
10/1/2017,VA,Virginia,Chesterfield,51041,57307,43735,13572,49834,183,49651,7473,246,7227,51669,38100,13569,39506,27438,12068,5404,132,57,33913
10/1/2017,VA,Virginia,Clarke,51043,3171,2808,363,2916,11,2905,255,*,*,2866,2503,363,1917,1639,278,259,*,*,1650
10/1/2017,VA,Virginia,Colonial Heights City,51570,4138,3459,679,3522,*,*,616,15,601,3809,3130,679,2457,1878,579,507,*,*,1936
10/1/2017,VA,Virginia,Covington City,51580,1643,1411,232,1263,11,1252,380,*,*,1536,1304,232,1219,1006,213,358,*,*,848
10/1/2017,VA,Virginia,Craig,51045,1314,1039,275,1028,*,*,286,0,286,1209,934,275,950,689,261,207,*,*,736
10/1/2017,VA,Virginia,Culpeper,51047,8984,7679,1305,7753,36,7717,1231,43,1188,8135,6831,1304,5636,4598,1038,1186,30,17,4403
10/1/2017,VA,Virginia,Cumberland,51049,2243,1745,498,1868,*,*,375,*,*,2082,1584,498,1620,1180,440,425,*,*,1174
10/1/2017,VA,Virginia,Danville City,51590,11118,8957,2161,8720,83,8637,2398,117,2281,10465,8304,2161,8693,7273,1420,3263,48,32,5350
10/1/2017,VA,Virginia,Dickenson,51051,4727,2907,1820,2946,*,*,1781,*,*,4525,2705,1820,3702,2086,1616,1135,22,11,2534
10/1/2017,VA,Virginia,Dinwiddie,51053,5735,4552,1183,4591,31,4560,1144,30,1114,5267,4084,1183,3878,2786,1092,909,*,*,2941
10/1/2017,VA,Virginia,Emporia City,51595,1136,878,258,874,16,858,262,11,251,1057,799,258,865,657,208,412,*,*,445
10/1/2017,VA,Virginia,Essex,51057,2866,2347,519,2442,14,2428,424,14,410,2664,2145,519,1981,1594,387,432,*,*,1528
10/1/2017,VA,Virginia,Fairfax,51059,146006,125412,20594,137742,499,137243,8264,439,7825,117806,97245,20561,68151,49255,18896,13580,430,121,54020
10/1/2017,VA,Virginia,Fairfax City,51600,3716,3159,557,3439,12,3427,277,12,265,3117,2561,556,1883,1381,502,369,*,*,1500
10/1/2017,VA,Virginia,Falls Church City,51610,1908,1648,260,1821,*,*,87,*,*,1485,1225,260,901,660,241,125,*,*,772
10/1/2017,VA,Virginia,Fauquier,51061,12163,10875,1288,11053,57,10996,1110,41,1069,10807,9519,1288,6822,5787,1035,973,*,*,5819
10/1/2017,VA,Virginia,Floyd,51063,3953,3207,746,3410,15,3395,543,*,*,3692,2946,746,2865,2180,685,567,*,*,2279
10/1/2017,VA,Virginia,Fluvanna,51065,5680,4945,735,5085,20,5065,595,23,572,5205,4470,735,3783,3175,608,527,*,*,3230
10/1/2017,VA,Virginia,Franklin,51067,14343,10544,3799,11948,41,11907,2395,30,2365,13477,9679,3798,10880,7386,3494,1999,47,19,8815
10/1/2017,VA,Virginia,Franklin City,51620,1924,1609,315,1501,21,1480,423,23,400,1805,1490,315,1472,1184,288,564,*,*,899
10/1/2017,VA,Virginia,Frederick,51069,15789,13993,1796,13984,49,13935,1805,55,1750,14381,12587,1794,9841,8452,1389,1503,30,27,8281
10/1/2017,VA,Virginia,Fredericksburg City,51630,3952,3454,498,3223,22,3201,729,30,699,3546,3048,498,2442,1993,449,799,*,*,1630
10/1/2017,VA,Virginia,Galax City,51640,1889,1750,139,1481,*,*,408,11,397,1785,1646,139,1415,1309,106,642,*,*,751
10/1/2017,VA,Virginia,Giles,51071,4589,3541,1048,3620,21,3599,969,17,952,4319,3272,1047,3509,2834,675,809,*,*,2677
10/1/2017,VA,Virginia,Gloucester,51073,8209,6823,1386,7018,36,6982,1191,22,1169,7594,6208,1386,4823,3650,1173,977,*,*,3818
10/1/2017,VA,Virginia,Goochland,51075,5534,4399,1135,5045,19,5026,489,22,467,4988,3853,1135,4065,3156,909,406,*,*,3641
10/1/2017,VA,Virginia,Grayson,51077,4623,3953,670,3777,*,*,846,11,835,4413,3743,670,3306,2747,559,997,13,15,2281
10/1/2017,VA,Virginia,Greene,51079,3602,3145,457,3150,12,3138,452,*,*,3288,2831,457,2366,1973,393,453,*,*,1901
10/1/2017,VA,Virginia,Greensville,51081,2426,1839,587,1936,18,1918,490,15,475,2271,1685,586,1836,1360,476,525,*,*,1288
10/1/2017,VA,Virginia,Halifax,51083,9531,8227,1304,7786,65,7721,1745,58,1687,8972,7668,1304,7199,6066,1133,2149,51,23,4976
10/1/2017,VA,Virginia,Hampton City,51650,24456,18398,6058,20055,189,19866,4401,196,4205,22320,16263,6057,13448,7818,5630,3644,100,40,9664
10/1/2017,VA,Virginia,Hanover,51085,20095,15365,4730,18224,76,18148,1871,48,1823,18322,13593,4729,14629,10799,3830,1390,43,19,13177
10/1/2017,VA,Virginia,Harrisonburg City,51660,5226,4661,565,4423,15,4408,803,22,781,4735,4170,565,3709,3306,403,948,*,*,2738
10/1/2017,VA,Virginia,Henrico,51087,54506,40452,14054,47473,299,47174,7033,289,6744,49269,35217,14052,39523,27438,12085,6252,168,86,33017
10/1/2017,VA,Virginia,Henry,51089,14979,10884,4095,11862,71,11791,3117,52,3065,14252,10157,4095,12012,8233,3779,3079,82,34,8817
10/1/2017,VA,Virginia,Highland,51091,763,690,73,698,*,*,65,*,*,716,643,73,533,467,66,60,*,*,471
10/1/2017,VA,Virginia,Hopewell City,51670,4476,3569,907,3426,30,3396,1050,29,1021,4165,3258,907,2846,1981,865,987,*,*,1829
10/1/2017,VA,Virginia,Isle of Wight,51093,7917,6237,1680,6924,45,6879,993,35,958,7359,5679,1680,5193,3680,1513,950,25,14,4204
10/1/2017,VA,Virginia,James City,51095,19713,17208,2505,18510,53,18457,1203,58,1145,18230,15728,2502,11532,9604,1928,836,31,17,10648
10/1/2017,VA,Virginia,King and Queen,51097,1726,1442,284,1449,11,1438,277,*,*,1613,1329,284,1172,930,242,274,*,*,880
10/1/2017,VA,Virginia,King George,51099,3721,3351,370,3202,13,3189,519,26,493,3241,2871,370,1619,1302,317,469,*,*,1134
10/1/2017,VA,Virginia,King William,51101,3264,2753,511,2794,24,2770,470,22,448,3008,2497,511,2408,1975,433,382,*,*,2005
10/1/2017,VA,Virginia,Lancaster,51103,4268,3707,561,3913,17,3896,355,15,340,4053,3492,561,2915,2532,383,498,*,*,2404
10/1/2017,VA,Virginia,Lee,51105,6340,3863,2477,4332,16,4316,2008,*,*,6032,3557,2475,4898,2587,2311,1936,31,17,2914
10/1/2017,VA,Virginia,Lexington City,51678,1615,1461,154,1479,*,*,136,*,*,1494,1340,154,1137,1014,123,215,*,*,916
10/1/2017,VA,Virginia,Loudoun,51107,35149,29774,5375,32738,129,32609,2411,116,2295,29079,23711,5368,19063,14266,4797,3023,104,44,15892
10/1/2017,VA,Virginia,Louisa,51109,7738,6406,1332,6502,34,6468,1236,34,1202,7073,5741,1332,5191,4021,1170,1050,24,20,4097
10/1/2017,VA,Virginia,Lunenburg,51111,2997,2609,388,2456,14,2442,541,20,521,2775,2387,388,2087,1750,337,708,*,*,1360
10/1/2017,VA,Virginia,Lynchburg City,51680,14547,12284,2263,11829,79,11750,2718,110,2608,13493,11230,2263,10912,8946,1966,3070,60,19,7763
10/1/2017,VA,Virginia,Madison,51113,2949,2535,414,2610,14,2596,339,14,325,2745,2331,414,2015,1675,340,392,*,*,1608
10/1/2017,VA,Virginia,Manassas City,51683,4387,3586,801,3843,29,3814,544,44,500,3704,2904,800,2511,1783,728,523,*,*,1968
10/1/2017,VA,Virginia,Manassas Park City,51685,1234,968,266,1066,11,1055,168,13,155,1057,792,265,723,484,239,184,*,*,528
10/1/2017,VA,Virginia,Martinsville City,51690,3917,2936,981,2906,27,2879,1011,42,969,3706,2725,981,3173,2235,938,1309,17,15,1832
10/1/2017,VA,Virginia,Mathews,51115,2815,2379,436,2582,*,*,233,*,*,2671,2235,436,1843,1496,347,267,*,*,1563
10/1/2017,VA,Virginia,Mecklenburg,51117,9053,7221,1832,7467,54,7413,1586,57,1529,8527,6695,1832,6675,5163,1512,1901,46,33,4695
10/1/2017,VA,Virginia,Middlesex,51119,3508,2981,527,3134,18,3116,374,*,*,3323,2796,527,2505,2122,383,449,*,*,2039
10/1/2017,VA,Virginia,Montgomery,51121,13625,11208,2417,11235,38,11197,2390,34,2356,12327,9910,2417,9957,7740,2217,1939,35,20,7963
10/1/2017,VA,Virginia,Nelson,51125,4502,3943,559,3985,16,3969,517,*,*,4136,3577,559,3010,2525,485,593,*,*,2399
10/1/2017,VA,Virginia,New Kent,51127,4280,3510,770,3818,19,3799,462,*,*,3899,3129,770,2719,2128,591,281,*,*,2427
10/1/2017,VA,Virginia,Newport News City,51700,27379,20444,6935,22434,188,22246,4945,246,4699,25057,18124,6933,16188,9682,6506,4703,85,45,11355
10/1/2017,VA,Virginia,Norfolk City,51710,32307,24057,8250,25673,246,25427,6634,336,6298,29121,20871,8250,19478,11657,7821,7229,167,63,12019
10/1/2017,VA,Virginia,Northampton,51131,3573,2987,586,3040,23,3017,533,26,507,3344,2758,586,2658,2173,485,922,*,*,1711
10/1/2017,VA,Virginia,Northumberland,51133,4592,3972,620,4260,13,4247,332,*,*,4285,3665,620,2829,2464,365,419,*,*,2385
10/1/2017,VA,Virginia,Norton City,51720,1188,814,374,789,*,*,399,*,*,1101,727,374,886,555,331,354,*,*,522
10/1/2017,VA,Virginia,Nottoway,51135,3642,3009,633,2953,28,2925,689,15,674,3389,2756,633,2643,2217,426,918,*,*,1701
10/1/2017,VA,Virginia,Orange,51137,8581,7510,1071,7559,44,7515,1022,37,985,7868,6797,1071,5161,4426,735,974,27,15,4145
10/1/2017,VA,Virginia,Page,51139,6114,5385,729,4981,19,4962,1133,20,1113,5745,5016,729,4195,3581,614,1134,23,17,3021
10/1/2017,VA,Virginia,Patrick,51141,5100,3870,1230,4204,*,*,896,*,*,4851,3622,1229,3948,2906,1042,1021,*,*,2895
10/1/2017,VA,Virginia,Petersburg City,51730,7158,5361,1797,5305,94,5211,1853,87,1766,6523,4727,1796,4718,2990,1728,2056,36,12,2614
10/1/2017,VA,Virginia,Pittsylvania,51143,15982,12435,3547,13069,94,12975,2913,79,2834,15070,11523,3547,12324,9791,2533,3093,69,41,9121
10/1/2017,VA,Virginia,Poquoson City,51735,2508,2208,300,2335,*,*,173,*,*,2311,2011,300,1138,879,259,103,*,*,1029
10/1/2017,VA,Virginia,Portsmouth City,51740,17901,13267,4634,13858,169,13689,4043,205,3838,16013,11381,4632,10562,6166,4396,3864,98,23,6577
10/1/2017,VA,Virginia,Powhatan,51145,5719,4550,1169,5098,19,5079,621,15,606,5235,4066,1169,4135,3153,982,402,*,*,3721
10/1/2017,VA,Virginia,Prince Edward,51147,4586,3775,811,3691,36,3655,895,34,861,4256,3445,811,3281,2676,605,1082,*,*,2172
10/1/2017,VA,Virginia,Prince George,51149,5714,4949,765,4841,25,4816,873,30,843,5297,4532,765,3194,2527,667,572,*,*,2605
10/1/2017,VA,Virginia,Prince William,51153,46254,38116,8138,41155,255,40900,5099,302,4797,39412,31278,8134,22640,15189,7451,5147,135,65,17293
10/1/2017,VA,Virginia,Pulaski,51155,8967,7263,1704,7131,32,7099,1836,28,1808,8370,6666,1704,6391,4838,1553,1632,31,26,4702
10/1/2017,VA,Virginia,Radford City,51750,2031,1645,386,1629,*,*,402,*,*,1880,1494,386,1542,1194,348,344,*,*,1191
10/1/2017,VA,Virginia,Rappahannock,51157,2019,1854,165,1870,*,*,149,*,*,1827,1663,164,1210,1086,124,158,*,*,1050
10/1/2017,VA,Virginia,Richmond,51159,1973,1590,383,1709,13,1696,264,12,252,1834,1451,383,1343,1091,252,297,*,*,1030
10/1/2017,VA,Virginia,Richmond City,51760,33246,22442,10804,26029,258,25771,7217,347,6870,29942,19138,10804,25059,14834,10225,8874,177,62,15946
10/1/2017,VA,Virginia,Roanoke,51161,23079,18215,4864,20483,89,20394,2596,55,2541,21366,16503,4863,16976,12715,4261,1988,37,34,14917
10/1/2017,VA,Virginia,Roanoke City,51770,20322,14605,5717,15176,126,15050,5146,143,5003,18560,12844,5716,14965,9618,5347,4871,108,38,9948
10/1/2017,VA,Virginia,Rockbridge,51163,5880,4986,894,4973,20,4953,907,*,*,5448,4554,894,4061,3329,732,826,34,15,3186
10/1/2017,VA,Virginia,Rockingham,51165,16998,14475,2523,14864,42,14822,2134,36,2098,15715,13192,2523,12136,10333,1803,1818,54,25,10239
10/1/2017,VA,Virginia,Russell,51167,7779,5145,2634,5275,17,5258,2504,16,2488,7460,4826,2634,6352,4174,2178,1698,30,19,4605
10/1/2017,VA,Virginia,Salem City,51775,6013,4832,1181,5063,29,5034,950,16,934,5517,4336,1181,4356,3308,1048,845,*,*,3479
10/1/2017,VA,Virginia,Scott,51169,6573,3331,3242,4888,*,*,1685,15,1670,6318,3076,3242,5462,2282,3180,1518,37,34,3873
10/1/2017,VA,Virginia,Shenandoah,51171,10343,9148,1195,9095,26,9069,1248,27,1221,9665,8470,1195,6750,5814,936,1285,33,20,5412
10/1/2017,VA,Virginia,Smyth,51173,8800,6772,2028,6521,22,6499,2279,23,2256,8295,6267,2028,6716,4910,1806,2189,36,18,4473
10/1/2017,VA,Virginia,Southampton,51175,4058,3414,644,3377,24,3353,681,16,665,3789,3145,644,2955,2400,555,743,*,*,2185
10/1/2017,VA,Virginia,Spotsylvania,51177,20042,17490,2552,17336,92,17244,2706,100,2606,17833,15282,2551,10698,8623,2075,1988,45,29,8636
10/1/2017,VA,Virginia,Stafford,51179,16497,14926,1571,14522,90,14432,1975,80,1895,14451,12880,1571,7207,5919,1288,1343,44,18,5802
10/1/2017,VA,Virginia,Staunton City,51790,5990,5173,817,4947,21,4926,1043,19,1024,5625,4808,817,4381,3711,670,1047,20,12,3302
10/1/2017,VA,Virginia,Suffolk City,51800,15513,12304,3209,12658,93,12565,2855,102,2753,14202,10993,3209,9721,6834,2887,2681,59,22,6959
10/1/2017,VA,Virginia,Surry,51181,1545,1205,340,1301,*,*,244,*,*,1437,1097,340,1034,723,311,206,*,*,818
10/1/2017,VA,Virginia,Sussex,51183,2357,1808,549,1924,27,1897,433,*,*,2192,1643,549,1679,1164,515,482,*,*,1178
10/1/2017,VA,Virginia,Tazewell,51185,11892,8441,3451,8701,32,8669,3191,40,3151,11279,7830,3449,8865,6595,2270,2297,32,38,6498
10/1/2017,VA,Virginia,Unknown,51999,*,*,*,*,*,*,*,*,*,*,*,*,*,*,*,*,*,*,*
10/1/2017,VA,Virginia,Virginia Beach City,51810,69048,57085,11963,60799,329,60470,8249,324,7925,63212,51257,11955,35690,24925,10765,6756,158,92,28684
10/1/2017,VA,Virginia,Warren,51187,7340,6618,722,6263,27,6236,1077,31,1046,6693,5971,722,4509,3939,570,901,36,14,3558
10/1/2017,VA,Virginia,Washington,51191,14789,9941,4848,11812,38,11774,2977,29,2948,13965,9118,4847,11322,6858,4464,2482,68,24,8748
10/1/2017,VA,Virginia,Waynesboro City,51820,4723,4035,688,3846,13,3833,877,26,851,4397,3709,688,3472,2879,593,887,*,*,2564
10/1/2017,VA,Virginia,Westmoreland,51193,4856,4187,669,4252,25,4227,604,11,593,4430,3761,669,2786,2239,547,738,24,20,2004
10/1/2017,VA,Virginia,Williamsburg City,51830,2543,2152,391,2325,*,*,218,*,*,2349,1958,391,1643,1322,321,233,*,*,1405
10/1/2017,VA,Virginia,Winchester City,51840,5099,4555,544,4331,21,4310,768,15,753,4618,4074,544,3320,2892,428,856,15,14,2435
10/1/2017,VA,Virginia,Wise,51195,10527,6708,3819,7010,22,6988,3517,24,3493,9952,6133,3819,7833,4360,3473,2448,67,25,5293
10/1/2017,VA,Virginia,Wythe,51197,7513,5734,1779,5826,31,5795,1687,20,1667,7103,5324,1779,5512,3965,1547,1515,55,14,3928
10/1/2017,VA,Virginia,York,51199,11477,9967,1510,10515,32,10483,962,30,932,10516,9006,1510,5561,4293,1268,674,*,*,4862
9/1/2017,VA,Virginia,Accomack,51001,8652,7305,1347,7428,48,7380,1224,47,1177,8060,6713,1347,5897,4854,1043,1508,379,91,3919
9/1/2017,VA,Virginia,Albemarle,51003,19865,17712,2153,18282,56,18226,1583,48,1535,17821,15668,2153,13497,11633,1864,1528,295,97,11577
9/1/2017,VA,Virginia,Alexandria City,51510,17349,14891,2458,15919,77,15842,1430,95,1335,14006,11552,2454,8347,6068,2279,2126,313,58,5850
9/1/2017,VA,Virginia,Alleghany,51005,4493,3868,625,3627,19,3608,866,14,852,4259,3634,625,3402,2929,473,800,99,50,2453
9/1/2017,VA,Virginia,Amelia,51007,3015,2322,693,2533,11,2522,482,*,*,2786,2093,693,2175,1553,622,466,85,36,1588
9/1/2017,VA,Virginia,Amherst,51009,7667,6380,1287,6381,47,6334,1286,29,1257,7114,5827,1287,5735,4612,1123,1236,223,75,4201
9/1/2017,VA,Virginia,Appomattox,51011,3773,3172,601,3084,14,3070,689,19,670,3548,2947,601,2852,2325,527,669,104,34,2045
9/1/2017,VA,Virginia,Arlington,51013,23648,20574,3074,22020,88,21932,1628,95,1533,18689,15615,3074,11090,8254,2836,2926,345,111,7708
9/1/2017,VA,Virginia,Augusta,51015,17801,15278,2523,15356,51,15305,2445,43,2402,16732,14209,2523,12728,10707,2021,1812,413,142,10361
9/1/2017,VA,Virginia,Bath,51017,1268,1164,104,1119,*,*,149,*,*,1194,1090,104,922,833,89,165,37,25,695
9/1/2017,VA,Virginia,Bedford,51019,19206,15769,3437,16423,82,16341,2783,51,2732,17878,14443,3435,13835,11334,2501,1975,481,161,11218
9/1/2017,VA,Virginia,Bland,51021,1779,1377,402,1395,*,*,384,*,*,1695,1293,402,1256,1034,222,252,51,16,937
9/1/2017,VA,Virginia,Botetourt,51023,8440,6527,1913,7304,41,7263,1136,18,1118,7830,5917,1913,6123,4468,1655,828,181,54,5060
9/1/2017,VA,Virginia,Bristol City,51520,4522,2705,1817,3490,14,3476,1032,*,*,4250,2433,1817,3568,1817,1751,1070,150,51,2297
9/1/2017,VA,Virginia,Brunswick,51025,3949,3238,711,3229,21,3208,720,24,696,3704,2993,711,2886,2269,617,1116,108,41,1621
9/1/2017,VA,Virginia,Buchanan,51027,7295,4386,2909,4535,18,4517,2760,15,2745,7024,4115,2909,5812,3720,2092,1634,406,113,3659
9/1/2017,VA,Virginia,Buckingham,51029,3449,2810,639,2797,17,2780,652,22,630,3232,2593,639,2470,2065,405,730,149,47,1544
9/1/2017,VA,Virginia,Buena Vista City,51530,1446,1179,267,1164,*,*,282,*,*,1351,1084,267,1053,833,220,331,51,19,652
9/1/2017,VA,Virginia,Campbell,51031,12522,10465,2057,10346,75,10271,2176,61,2115,11725,9668,2057,9423,7634,1789,2103,377,166,6777
9/1/2017,VA,Virginia,Caroline,51033,5693,4718,975,4739,31,4708,954,41,913,5145,4170,975,3480,2629,851,818,227,55,2380
9/1/2017,VA,Virginia,Carroll,51035,8025,6853,1172,6481,24,6457,1544,13,1531,7580,6408,1172,5842,4915,927,1635,281,107,3819
9/1/2017,VA,Virginia,Charles City,51036,1889,1473,416,1606,19,1587,283,11,272,1732,1316,416,1323,974,349,267,78,17,961
9/1/2017,VA,Virginia,Charlotte,51037,3355,2827,528,2708,12,2696,647,19,628,3166,2638,528,2502,2048,454,807,128,52,1515
9/1/2017,VA,Virginia,Charlottesville City,51540,6167,5425,742,5067,27,5040,1100,49,1051,5527,4786,741,4370,3674,696,1247,159,52,2912
9/1/2017,VA,Virginia,Chesapeake City,51550,36381,29058,7323,31149,261,30888,5232,226,5006,32935,25612,7323,20127,13616,6511,4121,901,250,14855
9/1/2017,VA,Virginia,Chesterfield,51041,57260,43669,13591,49787,186,49601,7473,245,7228,51651,38063,13588,39459,27379,12080,5385,1023,273,32778
9/1/2017,VA,Virginia,Clarke,51043,3175,2810,365,2920,11,2909,255,*,*,2868,2503,365,1921,1641,280,258,72,27,1564
9/1/2017,VA,Virginia,Colonial Heights City,51570,4142,3461,681,3524,*,*,618,16,602,3814,3133,681,2462,1881,581,506,96,24,1836
9/1/2017,VA,Virginia,Covington City,51580,1645,1411,234,1265,11,1254,380,*,*,1535,1301,234,1222,1007,215,358,54,20,790
9/1/2017,VA,Virginia,Craig,51045,1314,1039,275,1027,*,*,287,0,287,1211,936,275,952,691,261,203,45,12,692
9/1/2017,VA,Virginia,Culpeper,51047,8994,7679,1315,7758,38,7720,1236,44,1192,8149,6835,1314,5647,4600,1047,1188,230,65,4164
9/1/2017,VA,Virginia,Cumberland,51049,2250,1745,505,1873,*,*,377,*,*,2090,1585,505,1628,1181,447,426,96,33,1073
9/1/2017,VA,Virginia,Danville City,51590,11135,8969,2166,8735,83,8652,2400,118,2282,10490,8324,2166,8708,7283,1425,3247,425,159,4877
9/1/2017,VA,Virginia,Dickenson,51051,4740,2910,1830,2960,*,*,1780,*,*,4537,2707,1830,3709,2084,1625,1129,206,75,2299
9/1/2017,VA,Virginia,Dinwiddie,51053,5750,4567,1183,4604,34,4570,1146,30,1116,5285,4102,1183,3886,2794,1092,907,186,51,2742
9/1/2017,VA,Virginia,Emporia City,51595,1140,882,258,877,16,861,263,12,251,1062,804,258,866,656,210,411,67,12,376
9/1/2017,VA,Virginia,Essex,51057,2869,2345,524,2444,15,2429,425,14,411,2672,2148,524,1981,1589,392,432,82,23,1444
9/1/2017,VA,Virginia,Fairfax,51059,145612,125031,20581,137330,507,136823,8282,439,7843,117644,97097,20547,67989,49106,18883,13535,2682,500,51272
9/1/2017,VA,Virginia,Fairfax City,51600,3710,3157,553,3432,12,3420,278,12,266,3106,2554,552,1879,1381,498,367,59,11,1442
9/1/2017,VA,Virginia,Falls Church City,51610,1901,1640,261,1813,*,*,88,*,*,1477,1216,261,898,656,242,125,*,*,750
9/1/2017,VA,Virginia,Fauquier,51061,12175,10882,1293,11064,57,11007,1111,40,1071,10819,9526,1293,6818,5778,1040,966,192,55,5605
9/1/2017,VA,Virginia,Floyd,51063,3959,3209,750,3414,15,3399,545,*,*,3697,2947,750,2872,2184,688,567,91,41,2173
9/1/2017,VA,Virginia,Fluvanna,51065,5684,4942,742,5089,20,5069,595,23,572,5209,4467,742,3791,3176,615,528,121,28,3114
9/1/2017,VA,Virginia,Franklin,51067,14335,10534,3801,11938,42,11896,2397,30,2367,13479,9679,3800,10881,7385,3496,1990,473,154,8264
9/1/2017,VA,Virginia,Franklin City,51620,1923,1605,318,1501,21,1480,422,23,399,1806,1488,318,1469,1178,291,563,61,15,830
9/1/2017,VA,Virginia,Frederick,51069,15805,14000,1805,13997,50,13947,1808,55,1753,14403,12600,1803,9844,8448,1396,1498,347,138,7861
9/1/2017,VA,Virginia,Fredericksburg City,51630,3953,3454,499,3222,22,3200,731,31,700,3555,3056,499,2439,1988,451,794,85,38,1522
9/1/2017,VA,Virginia,Galax City,51640,1895,1754,141,1487,*,*,408,11,397,1793,1652,141,1418,1311,107,645,58,28,687
9/1/2017,VA,Virginia,Giles,51071,4596,3541,1055,3627,21,3606,969,17,952,4324,3270,1054,3512,2829,683,811,125,35,2541
9/1/2017,VA,Virginia,Gloucester,51073,8220,6832,1388,7033,38,6995,1187,22,1165,7595,6207,1388,4828,3652,1176,977,172,44,3635
9/1/2017,VA,Virginia,Goochland,51075,5539,4396,1143,5051,20,5031,488,21,467,4993,3850,1143,4065,3150,915,404,100,34,3527
9/1/2017,VA,Virginia,Grayson,51077,4634,3959,675,3786,*,*,848,12,836,4423,3748,675,3316,2752,564,997,177,87,2055
9/1/2017,VA,Virginia,Greene,51079,3600,3146,454,3147,12,3135,453,*,*,3287,2833,454,2357,1967,390,452,82,25,1798
9/1/2017,VA,Virginia,Greensville,51081,2431,1838,593,1937,18,1919,494,15,479,2277,1684,593,1838,1358,480,526,128,27,1157
9/1/2017,VA,Virginia,Halifax,51083,9544,8243,1301,7799,66,7733,1745,57,1688,8999,7698,1301,7217,6087,1130,2157,442,144,4474
9/1/2017,VA,Virginia,Hampton City,51650,24492,18433,6059,20091,193,19898,4401,195,4206,22357,16299,6058,13460,7829,5631,3631,784,173,8872
9/1/2017,VA,Virginia,Hanover,51085,20093,15363,4730,18219,77,18142,1874,48,1826,18294,13565,4729,14583,10755,3828,1379,348,97,12759
9/1/2017,VA,Virginia,Harrisonburg City,51660,5225,4659,566,4422,14,4408,803,21,782,4729,4163,566,3712,3304,408,952,123,33,2604
9/1/2017,VA,Virginia,Henrico,51087,54495,40407,14088,47450,307,47143,7045,291,6754,49289,35203,14086,39505,27387,12118,6241,1387,395,31482
9/1/2017,VA,Virginia,Henry,51089,15015,10896,4119,11890,71,11819,3125,52,3073,14290,10171,4119,12030,8227,3803,3064,706,249,8011
9/1/2017,VA,Virginia,Highland,51091,764,690,74,699,*,*,65,*,*,715,641,74,531,464,67,60,*,*,443
9/1/2017,VA,Virginia,Hopewell City,51670,4486,3577,909,3433,30,3403,1053,29,1024,4180,3271,909,2855,1988,867,988,162,32,1673
9/1/2017,VA,Virginia,Isle of Wight,51093,7922,6239,1683,6924,46,6878,998,34,964,7364,5681,1683,5196,3681,1515,943,196,61,3996
9/1/2017,VA,Virginia,James City,51095,19721,17210,2511,18517,55,18462,1204,57,1147,18232,15724,2508,11538,9607,1931,832,222,59,10425
9/1/2017,VA,Virginia,King and Queen,51097,1722,1434,288,1446,11,1435,276,*,*,1609,1321,288,1175,929,246,270,69,14,822
9/1/2017,VA,Virginia,King George,51099,3725,3345,380,3203,13,3190,522,29,493,3249,2869,380,1629,1303,326,466,82,13,1068
9/1/2017,VA,Virginia,King William,51101,3264,2748,516,2792,24,2768,472,22,450,3009,2493,516,2413,1975,438,382,116,23,1892
9/1/2017,VA,Virginia,Lancaster,51103,4271,3708,563,3914,17,3897,357,15,342,4062,3499,563,2923,2539,384,500,92,17,2314
9/1/2017,VA,Virginia,Lee,51105,6358,3881,2477,4348,16,4332,2010,*,*,6048,3573,2475,4899,2590,2309,1930,247,76,2646
9/1/2017,VA,Virginia,Lexington City,51678,1615,1461,154,1479,11,1468,136,*,*,1497,1343,154,1138,1015,123,216,*,*,882
9/1/2017,VA,Virginia,Loudoun,51107,35037,29644,5393,32628,131,32497,2409,115,2294,29055,23669,5386,19003,14187,4816,3007,633,151,15212
9/1/2017,VA,Virginia,Louisa,51109,7744,6407,1337,6508,34,6474,1236,34,1202,7083,5746,1337,5195,4019,1176,1049,248,70,3828
9/1/2017,VA,Virginia,Lunenburg,51111,3000,2611,389,2457,14,2443,543,22,521,2775,2386,389,2085,1748,337,708,112,45,1220
9/1/2017,VA,Virginia,Lynchburg City,51680,14564,12293,2271,11846,79,11767,2718,109,2609,13511,11240,2271,10922,8950,1972,3051,431,134,7306
9/1/2017,VA,Virginia,Madison,51113,2949,2531,418,2611,14,2597,338,13,325,2746,2328,418,2022,1677,345,393,91,23,1515
9/1/2017,VA,Virginia,Manassas City,51683,4374,3571,803,3830,29,3801,544,44,500,3697,2894,803,2504,1776,728,519,91,35,1859
9/1/2017,VA,Virginia,Manassas Park City,51685,1232,968,264,1064,11,1053,168,13,155,1055,792,263,723,486,237,183,*,*,487
9/1/2017,VA,Virginia,Martinsville City,51690,3923,2930,993,2913,28,2885,1010,40,970,3713,2720,993,3179,2228,951,1303,168,64,1644
9/1/2017,VA,Virginia,Mathews,51115,2818,2381,437,2586,*,*,232,*,*,2672,2235,437,1840,1492,348,267,41,19,1513
9/1/2017,VA,Virginia,Mecklenburg,51117,9073,7226,1847,7482,54,7428,1591,58,1533,8541,6694,1847,6680,5155,1525,1900,379,113,4288
9/1/2017,VA,Virginia,Middlesex,51119,3517,2988,529,3142,18,3124,375,*,*,3327,2798,529,2507,2122,385,452,83,25,1947
9/1/2017,VA,Virginia,Montgomery,51121,13615,11185,2430,11220,38,11182,2395,34,2361,12333,9903,2430,9952,7722,2230,1939,325,121,7567
9/1/2017,VA,Virginia,Nelson,51125,4508,3939,569,3991,16,3975,517,*,*,4139,3570,569,3011,2517,494,592,102,40,2277
9/1/2017,VA,Virginia,New Kent,51127,4273,3500,773,3813,19,3794,460,*,*,3891,3118,773,2718,2125,593,277,82,16,2343
9/1/2017,VA,Virginia,Newport News City,51700,27366,20396,6970,22418,191,22227,4948,245,4703,25062,18094,6968,16206,9670,6536,4684,838,228,10456
9/1/2017,VA,Virginia,Norfolk City,51710,32324,24029,8295,25675,252,25423,6649,336,6313,29169,20874,8295,19493,11633,7860,7218,1336,281,10658
9/1/2017,VA,Virginia,Northampton,51131,3576,2987,589,3040,23,3017,536,27,509,3350,2761,589,2653,2165,488,915,93,31,1614
9/1/2017,VA,Virginia,Northumberland,51133,4585,3964,621,4251,13,4238,334,*,*,4277,3656,621,2825,2458,367,416,89,35,2285
9/1/2017,VA,Virginia,Norton City,51720,1186,812,374,788,*,*,398,*,*,1103,729,374,882,552,330,349,48,17,468
9/1/2017,VA,Virginia,Nottoway,51135,3655,3012,643,2965,28,2937,690,16,674,3400,2757,643,2649,2214,435,921,134,41,1553
9/1/2017,VA,Virginia,Orange,51137,8590,7509,1081,7568,44,7524,1022,36,986,7875,6794,1081,5172,4431,741,976,215,66,3915
9/1/2017,VA,Virginia,Page,51139,6128,5395,733,4995,20,4975,1133,20,1113,5762,5029,733,4199,3581,618,1133,228,85,2753
9/1/2017,VA,Virginia,Patrick,51141,5106,3867,1239,4207,*,*,899,*,*,4858,3620,1238,3956,2906,1050,1021,194,70,2671
9/1/2017,VA,Virginia,Petersburg City,51730,7178,5371,1807,5316,96,5220,1862,86,1776,6539,4733,1806,4728,2990,1738,2046,343,61,2278
9/1/2017,VA,Virginia,Pittsylvania,51143,16012,12456,3556,13099,96,13003,2913,78,2835,15103,11547,3556,12329,9793,2536,3085,554,221,8469
9/1/2017,VA,Virginia,Poquoson City,51735,2511,2209,302,2337,*,*,174,*,*,2316,2014,302,1137,877,260,100,22,14,1001
9/1/2017,VA,Virginia,Portsmouth City,51740,17922,13276,4646,13868,172,13696,4054,207,3847,16039,11395,4644,10571,6164,4407,3870,717,139,5845
9/1/2017,VA,Virginia,Powhatan,51145,5721,4551,1170,5098,19,5079,623,15,608,5242,4072,1170,4131,3147,984,400,109,31,3591
9/1/2017,VA,Virginia,Prince Edward,51147,4594,3777,817,3698,36,3662,896,35,861,4267,3450,817,3291,2680,611,1084,169,50,1988
9/1/2017,VA,Virginia,Prince George,51149,5717,4950,767,4845,25,4820,872,30,842,5307,4540,767,3185,2515,670,560,126,25,2474
9/1/2017,VA,Virginia,Prince William,51153,46164,38004,8160,41047,256,40791,5117,305,4812,39338,31181,8157,22605,15133,7472,5128,990,215,16272
9/1/2017,VA,Virginia,Pulaski,51155,8983,7275,1708,7143,32,7111,1840,30,1810,8382,6674,1708,6395,4838,1557,1626,314,118,4337
9/1/2017,VA,Virginia,Radford City,51750,2031,1644,387,1628,*,*,403,*,*,1877,1490,387,1540,1191,349,343,43,22,1132
9/1/2017,VA,Virginia,Rappahannock,51157,2016,1852,164,1868,*,*,148,*,*,1822,1659,163,1203,1080,123,153,*,*,1005
9/1/2017,VA,Virginia,Richmond,51159,1977,1592,385,1712,13,1699,265,13,252,1838,1453,385,1345,1092,253,299,83,20,943
9/1/2017,VA,Virginia,Richmond City,51760,33279,22426,10853,26056,261,25795,7223,346,6877,29979,19126,10853,25072,14797,10275,8857,1407,296,14512
9/1/2017,VA,Virginia,Roanoke,51161,23116,18234,4882,20513,93,20420,2603,56,2547,21404,16523,4881,16990,12716,4274,1984,437,140,14429
9/1/2017,VA,Virginia,Roanoke City,51770,20363,14623,5740,15202,127,15075,5161,148,5013,18608,12869,5739,14982,9612,5370,4866,844,204,9068
9/1/2017,VA,Virginia,Rockbridge,51163,5890,4992,898,4982,20,4962,908,*,*,5458,4560,898,4063,3327,736,827,178,69,2989
9/1/2017,VA,Virginia,Rockingham,51165,16998,14456,2542,14862,42,14820,2136,36,2100,15697,13155,2542,12107,10291,1816,1804,506,146,9651
9/1/2017,VA,Virginia,Russell,51167,7790,5154,2636,5284,17,5267,2506,15,2491,7478,4842,2636,6360,4182,2178,1699,307,133,4221
9/1/2017,VA,Virginia,Salem City,51775,6024,4834,1190,5074,29,5045,950,16,934,5532,4342,1190,4364,3307,1057,845,144,37,3338
9/1/2017,VA,Virginia,Scott,51169,6584,3340,3244,4902,*,*,1682,14,1668,6327,3083,3244,5464,2283,3181,1512,242,120,3590
9/1/2017,VA,Virginia,Shenandoah,51171,10344,9146,1198,9093,27,9066,1251,28,1223,9670,8472,1198,6755,5816,939,1287,256,100,5112
9/1/2017,VA,Virginia,Smyth,51173,8818,6784,2034,6540,23,6517,2278,23,2255,8310,6276,2034,6726,4915,1811,2183,395,130,4018
9/1/2017,VA,Virginia,Southampton,51175,4055,3403,652,3374,24,3350,681,17,664,3789,3137,652,2952,2389,563,738,127,34,2053
9/1/2017,VA,Virginia,Spotsylvania,51177,20060,17490,2570,17356,101,17255,2704,99,2605,17854,15285,2569,10712,8623,2089,1966,488,133,8125
9/1/2017,VA,Virginia,Stafford,51179,16475,14895,1580,14498,91,14407,1977,80,1897,14439,12859,1580,7201,5904,1297,1340,360,78,5423
9/1/2017,VA,Virginia,Staunton City,51790,6011,5182,829,4965,22,4943,1046,20,1026,5648,4819,829,4397,3715,682,1056,153,61,3127
9/1/2017,VA,Virginia,Suffolk City,51800,15518,12294,3224,12658,94,12564,2860,103,2757,14214,10990,3224,9724,6823,2901,2667,457,110,6490
9/1/2017,VA,Virginia,Surry,51181,1547,1203,344,1302,*,*,245,*,*,1441,1097,344,1038,723,315,206,60,14,758
9/1/2017,VA,Virginia,Sussex,51183,2360,1806,554,1927,28,1899,433,*,*,2197,1643,554,1684,1164,520,476,139,19,1050
9/1/2017,VA,Virginia,Tazewell,51185,11917,8464,3453,8729,34,8695,3188,39,3149,11295,7844,3451,8890,6623,2267,2294,442,186,5968
9/1/2017,VA,Virginia,Unknown,51999,*,*,*,*,*,*,*,*,*,*,*,*,*,*,*,*,*,*,*
9/1/2017,VA,Virginia,Virginia Beach City,51810,68991,56996,11995,60731,339,60392,8260,326,7934,63207,51219,11988,35667,24875,10792,6739,1414,360,27154
9/1/2017,VA,Virginia,Warren,51187,7339,6613,726,6262,28,6234,1077,30,1047,6699,5973,726,4498,3925,573,893,236,75,3294
9/1/2017,VA,Virginia,Washington,51191,14793,9933,4860,11812,41,11771,2981,30,2951,13966,9107,4859,11318,6845,4473,2479,528,165,8146
9/1/2017,VA,Virginia,Waynesboro City,51820,4725,4036,689,3849,14,3835,876,26,850,4401,3712,689,3471,2877,594,880,115,34,2442
9/1/2017,VA,Virginia,Westmoreland,51193,4864,4188,676,4257,25,4232,607,11,596,4440,3764,676,2788,2236,552,739,133,48,1868
9/1/2017,VA,Virginia,Williamsburg City,51830,2536,2143,393,2317,*,*,219,*,*,2345,1952,393,1638,1315,323,232,*,*,1369
9/1/2017,VA,Virginia,Winchester City,51840,5105,4556,549,4336,22,4314,769,16,753,4625,4076,549,3330,2898,432,859,128,53,2290
9/1/2017,VA,Virginia,Wise,51195,10539,6719,3820,7026,24,7002,3513,24,3489,9959,6139,3820,7829,4353,3476,2433,468,168,4760
9/1/2017,VA,Virginia,Wythe,51197,7527,5739,1788,5836,31,5805,1691,21,1670,7121,5333,1788,5526,3970,1556,1509,278,101,3638
9/1/2017,VA,Virginia,York,51199,11473,9951,1522,10511,32,10479,962,29,933,10510,8988,1522,5554,4277,1277,664,166,41,4683
4/1/2018,VA,Virginia,Accomack,51001,8714,7273,1441,7542,43,7499,1172,46,1126,8082,6641,1441,5934,4811,1123,1453,375,91,4015
4/1/2018,VA,Virginia,Albemarle,51003,20439,18238,2201,18888,54,18834,1551,51,1500,18319,16120,2199,14051,12199,1852,1537,300,97,12117
4/1/2018,VA,Virginia,Alexandria City,51510,17603,14954,2649,16209,79,16130,1394,84,1310,14133,11486,2647,8634,6285,2349,2117,311,63,6143
4/1/2018,VA,Virginia,Alleghany,51005,4497,3911,586,3639,24,3615,858,14,844,4263,3677,586,3400,2962,438,789,104,54,2453
4/1/2018,VA,Virginia,Amelia,51007,3044,2335,709,2586,*,*,458,15,443,2808,2099,709,2235,1588,647,467,98,33,1637
4/1/2018,VA,Virginia,Amherst,51009,7758,6385,1373,6485,50,6435,1273,28,1245,7196,5823,1373,5822,4647,1175,1205,235,80,4302
4/1/2018,VA,Virginia,Appomattox,51011,3829,3177,652,3163,17,3146,666,21,645,3594,2942,652,2903,2339,564,673,103,39,2088
4/1/2018,VA,Virginia,Arlington,51013,23930,20790,3140,22354,99,22255,1576,88,1488,18826,15686,3140,11472,8675,2797,2976,353,101,8042
4/1/2018,VA,Virginia,Augusta,51015,18085,15612,2473,15685,60,15625,2400,45,2355,16969,14496,2473,13003,11049,1954,1814,413,139,10637
4/1/2018,VA,Virginia,Bath,51017,1267,1168,99,1120,*,*,147,*,*,1200,1101,99,941,858,83,163,37,22,719
4/1/2018,VA,Virginia,Bedford,51019,19610,16140,3470,16855,91,16764,2755,57,2698,18258,14790,3468,14211,11790,2421,1963,507,154,11587
4/1/2018,VA,Virginia,Bland,51021,1783,1366,417,1403,*,*,380,*,*,1683,1266,417,1275,1043,232,238,51,16,970
4/1/2018,VA,Virginia,Botetourt,51023,8594,6620,1974,7503,50,7453,1091,18,1073,7963,5989,1974,6260,4643,1617,787,190,52,5231
4/1/2018,VA,Virginia,Bristol City,51520,4535,2577,1958,3530,13,3517,1005,18,987,4254,2296,1958,3604,1729,1875,1061,154,51,2338
4/1/2018,VA,Virginia,Brunswick,51025,3956,3308,648,3288,29,3259,668,22,646,3679,3031,648,2909,2367,542,1073,111,36,1689
4/1/2018,VA,Virginia,Buchanan,51027,7293,4252,3041,4651,20,4631,2642,17,2625,7020,3979,3041,5873,3711,2162,1632,402,106,3733
4/1/2018,VA,Virginia,Buckingham,51029,3493,2958,535,2866,21,2845,627,22,605,3252,2717,535,2508,2210,298,730,155,45,1578
4/1/2018,VA,Virginia,Buena Vista City,51530,1448,1206,242,1178,*,*,270,*,*,1352,1110,242,1069,876,193,317,56,21,675
4/1/2018,VA,Virginia,Campbell,51031,12604,10417,2187,10506,79,10427,2098,65,2033,11807,9620,2187,9583,7711,1872,2030,372,159,7022
4/1/2018,VA,Virginia,Caroline,51033,5771,4767,1004,4832,39,4793,939,36,903,5190,4186,1004,3554,2695,859,803,221,50,2480
4/1/2018,VA,Virginia,Carroll,51035,8056,6773,1283,6613,21,6592,1443,*,*,7587,6304,1283,5950,4962,988,1540,270,102,4038
4/1/2018,VA,Virginia,Charles City,51036,1908,1500,408,1622,20,1602,286,15,271,1749,1341,408,1348,1008,340,263,82,18,985
4/1/2018,VA,Virginia,Charlotte,51037,3333,2778,555,2718,16,2702,615,18,597,3144,2589,555,2477,1999,478,771,122,49,1535
4/1/2018,VA,Virginia,Charlottesville City,51540,6208,5572,636,5164,30,5134,1044,37,1007,5535,4900,635,4438,3854,584,1204,149,48,3037
4/1/2018,VA,Virginia,Chesapeake City,51550,37317,29671,7646,32174,302,31872,5143,218,4925,33722,26076,7646,20886,14203,6683,4152,936,230,15568
4/1/2018,VA,Virginia,Chesterfield,51041,58761,44748,14013,51409,245,51164,7352,266,7086,52958,38948,14010,40924,28585,12339,5421,1043,250,34210
4/1/2018,VA,Virginia,Clarke,51043,3259,2855,404,3010,12,2998,249,*,*,2934,2530,404,2004,1697,307,266,74,26,1638
4/1/2018,VA,Virginia,Colonial Heights City,51570,4156,3499,657,3554,*,*,602,15,587,3817,3160,657,2502,1943,559,494,113,25,1870
4/1/2018,VA,Virginia,Covington City,51580,1652,1454,198,1280,12,1268,372,*,*,1529,1332,197,1239,1063,176,349,59,16,815
4/1/2018,VA,Virginia,Craig,51045,1337,1047,290,1042,*,*,295,0,295,1229,939,290,979,717,262,201,45,12,721
4/1/2018,VA,Virginia,Culpeper,51047,9314,7914,1400,8094,41,8053,1220,46,1174,8428,7030,1398,5916,4857,1059,1211,239,76,4390
4/1/2018,VA,Virginia,Cumberland,51049,2264,1778,486,1892,*,*,372,*,*,2096,1610,486,1646,1226,420,418,93,30,1105
4/1/2018,VA,Virginia,Danville City,51590,11139,8684,2455,8820,91,8729,2319,120,2199,10467,8012,2455,8766,7069,1697,3220,409,159,4978
4/1/2018,VA,Virginia,Dickenson,51051,4739,2775,1964,3030,*,*,1709,*,*,4542,2578,1964,3747,2011,1736,1115,202,75,2355
4/1/2018,VA,Virginia,Dinwiddie,51053,5833,4649,1184,4715,36,4679,1118,30,1088,5354,4170,1184,3988,2893,1095,903,194,51,2840
4/1/2018,VA,Virginia,Emporia City,51595,1143,872,271,878,16,862,265,*,*,1057,786,271,875,656,219,411,*,*,389
4/1/2018,VA,Virginia,Essex,51057,2901,2356,545,2493,14,2479,408,12,396,2697,2152,545,2036,1632,404,433,83,25,1495
4/1/2018,VA,Virginia,Fairfax,51059,147284,122497,24787,139215,585,138630,8069,458,7611,118621,93860,24761,70049,49243,20806,13627,2646,507,53269
4/1/2018,VA,Virginia,Fairfax City,51600,3757,3057,700,3499,14,3485,258,14,244,3133,2433,700,1941,1398,543,359,68,12,1502
4/1/2018,VA,Virginia,Falls Church City,51610,1986,1676,310,1901,*,*,85,0,85,1544,1234,310,959,692,267,125,*,*,816
4/1/2018,VA,Virginia,Fauquier,51061,12376,11021,1355,11303,64,11239,1073,39,1034,10972,9617,1355,7046,6097,949,975,189,61,5821
4/1/2018,VA,Virginia,Floyd,51063,4013,3241,772,3471,17,3454,542,*,*,3753,2981,772,2976,2268,708,570,98,41,2267
4/1/2018,VA,Virginia,Fluvanna,51065,5793,5067,726,5219,21,5198,574,20,554,5302,4576,726,3890,3306,584,528,116,25,3221
4/1/2018,VA,Virginia,Franklin,51067,14537,10677,3860,12220,47,12173,2317,33,2284,13669,9809,3860,11107,7670,3437,1978,483,156,8490
4/1/2018,VA,Virginia,Franklin City,51620,1975,1662,313,1548,21,1527,427,23,404,1842,1529,313,1505,1223,282,565,63,13,864
4/1/2018,VA,Virginia,Frederick,51069,16284,14251,2033,14485,57,14428,1799,66,1733,14805,12775,2030,10233,8711,1522,1482,355,123,8273
4/1/2018,VA,Virginia,Fredericksburg City,51630,3988,3501,487,3288,25,3263,700,22,678,3561,3074,487,2492,2073,419,778,95,41,1578
4/1/2018,VA,Virginia,Galax City,51640,1851,1696,155,1476,*,*,375,11,364,1740,1585,155,1393,1281,112,595,54,22,722
4/1/2018,VA,Virginia,Giles,51071,4600,3590,1010,3671,25,3646,929,16,913,4326,3317,1009,3563,2990,573,797,126,39,2601
4/1/2018,VA,Virginia,Gloucester,51073,8411,7008,1403,7241,40,7201,1170,25,1145,7761,6358,1403,4999,3822,1177,990,170,41,3798
4/1/2018,VA,Virginia,Goochland,51075,5679,4474,1205,5191,29,5162,488,19,469,5149,3945,1204,4235,3269,966,396,99,32,3708
4/1/2018,VA,Virginia,Grayson,51077,4686,3908,778,3886,*,*,800,11,789,4453,3675,778,3404,2752,652,984,178,88,2154
4/1/2018,VA,Virginia,Greene,51079,3742,3279,463,3279,16,3263,463,*,*,3410,2947,463,2479,2077,402,453,89,27,1910
4/1/2018,VA,Virginia,Greensville,51081,2442,1833,609,1971,23,1948,471,16,455,2285,1676,609,1853,1388,465,501,126,28,1198
4/1/2018,VA,Virginia,Halifax,51083,9618,8135,1483,7890,75,7815,1728,54,1674,9034,7551,1483,7308,6021,1287,2104,444,146,4614
4/1/2018,VA,Virginia,Hampton City,51650,24738,18610,6128,20402,208,20194,4336,200,4136,22545,16417,6128,13891,8205,5686,3687,793,172,9239
4/1/2018,VA,Virginia,Hanover,51085,20540,15589,4951,18686,91,18595,1854,52,1802,18718,13768,4950,15109,11101,4008,1411,340,95,13263
4/1/2018,VA,Virginia,Harrisonburg City,51660,5353,4736,617,4546,17,4529,807,20,787,4839,4222,617,3865,3432,433,985,142,25,2713
4/1/2018,VA,Virginia,Henrico,51087,55562,41026,14536,48712,354,48358,6850,289,6561,50209,35674,14535,40811,28336,12475,6348,1396,391,32676
4/1/2018,VA,Virginia,Henry,51089,15001,10997,4004,11963,75,11888,3038,58,2980,14263,10259,4004,12081,8455,3626,3005,721,244,8111
4/1/2018,VA,Virginia,Highland,51091,781,709,72,713,*,*,68,*,*,725,653,72,543,483,60,52,*,*,460
4/1/2018,VA,Virginia,Hopewell City,51670,4505,3545,960,3491,31,3460,1014,31,983,4186,3226,960,2917,2003,914,989,162,29,1737
4/1/2018,VA,Virginia,Isle of Wight,51093,8122,6432,1690,7159,52,7107,963,38,925,7525,5835,1690,5351,3833,1518,936,207,65,4143
4/1/2018,VA,Virginia,James City,51095,20236,17562,2674,19047,66,18981,1189,55,1134,18709,16038,2671,11984,9979,2005,831,217,59,10877
4/1/2018,VA,Virginia,King and Queen,51097,1752,1468,284,1478,16,1462,274,*,*,1634,1350,284,1214,973,241,261,70,11,872
4/1/2018,VA,Virginia,King George,51099,3813,3438,375,3304,15,3289,509,25,484,3305,2930,375,1662,1361,301,449,72,15,1126
4/1/2018,VA,Virginia,King William,51101,3348,2833,515,2869,27,2842,479,19,460,3066,2551,515,2478,2051,427,386,114,21,1957
4/1/2018,VA,Virginia,Lancaster,51103,4317,3742,575,3981,20,3961,336,16,320,4095,3520,575,2994,2640,354,493,99,15,2387
4/1/2018,VA,Virginia,Lee,51105,6436,3781,2655,4465,20,4445,1971,13,1958,6122,3469,2653,5005,2543,2462,1936,250,82,2737
4/1/2018,VA,Virginia,Lexington City,51678,1648,1491,157,1520,13,1507,128,*,*,1524,1367,157,1166,1048,118,214,*,*,910
4/1/2018,VA,Virginia,Loudoun,51107,36475,30461,6014,34097,158,33939,2378,104,2274,30194,24184,6010,20032,15000,5032,3054,637,137,16204
4/1/2018,VA,Virginia,Louisa,51109,7972,6515,1457,6733,41,6692,1239,36,1203,7282,5825,1457,5401,4163,1238,1054,254,64,4029
4/1/2018,VA,Virginia,Lunenburg,51111,3018,2635,383,2473,21,2452,545,17,528,2797,2414,383,2132,1804,328,704,115,43,1270
4/1/2018,VA,Virginia,Lynchburg City,51680,14591,12158,2433,11986,94,11892,2605,108,2497,13539,11106,2433,10980,8871,2109,2941,439,125,7475
4/1/2018,VA,Virginia,Madison,51113,2966,2541,425,2642,12,2630,324,13,311,2759,2334,425,2052,1726,326,384,86,22,1560
4/1/2018,VA,Virginia,Manassas City,51683,4428,3593,835,3906,26,3880,522,44,478,3716,2881,835,2586,1878,708,495,89,41,1961
4/1/2018,VA,Virginia,Manassas Park City,51685,1302,998,304,1131,15,1116,171,13,158,1098,795,303,782,515,267,192,*,*,536
4/1/2018,VA,Virginia,Martinsville City,51690,3955,3018,937,2944,36,2908,1011,42,969,3730,2793,937,3228,2342,886,1316,168,63,1681
4/1/2018,VA,Virginia,Mathews,51115,2833,2379,454,2614,*,*,219,*,*,2685,2231,454,1890,1529,361,269,39,19,1563
4/1/2018,VA,Virginia,Mecklenburg,51117,9096,7405,1691,7571,71,7500,1525,61,1464,8532,6841,1691,6740,5380,1360,1833,372,106,4429
4/1/2018,VA,Virginia,Middlesex,51119,3568,3034,534,3203,18,3185,365,*,*,3368,2834,534,2570,2189,381,447,81,30,2012
4/1/2018,VA,Virginia,Montgomery,51121,13803,11355,2448,11535,44,11491,2268,29,2239,12446,9998,2448,10259,8080,2179,1859,355,116,7929
4/1/2018,VA,Virginia,Nelson,51125,4582,3955,627,4073,18,4055,509,*,*,4197,3571,626,3080,2555,525,576,102,42,2360
4/1/2018,VA,Virginia,New Kent,51127,4431,3628,803,3985,21,3964,446,*,*,4025,3222,803,2837,2230,607,282,75,14,2466
4/1/2018,VA,Virginia,Newport News City,51700,27787,20799,6988,22876,219,22657,4911,244,4667,25398,18412,6986,16687,10145,6542,4669,909,225,10884
4/1/2018,VA,Virginia,Norfolk City,51710,32529,24508,8021,26098,280,25818,6431,335,6096,29214,21193,8021,19882,12368,7514,7137,1339,296,11110
4/1/2018,VA,Virginia,Northampton,51131,3626,3030,596,3118,22,3096,508,25,483,3384,2788,596,2727,2243,484,927,92,27,1681
4/1/2018,VA,Virginia,Northumberland,51133,4591,3955,636,4261,19,4242,330,13,317,4278,3642,636,2873,2518,355,423,88,28,2334
4/1/2018,VA,Virginia,Norton City,51720,1189,797,392,812,*,*,377,*,*,1099,707,392,894,548,346,355,50,14,475
4/1/2018,VA,Virginia,Nottoway,51135,3661,3093,568,3012,30,2982,649,16,633,3399,2831,568,2662,2284,378,885,133,41,1603
4/1/2018,VA,Virginia,Orange,51137,8721,7566,1155,7708,47,7661,1013,32,981,7995,6840,1155,5318,4557,761,957,215,65,4081
4/1/2018,VA,Virginia,Page,51139,6167,5329,838,5085,24,5061,1082,23,1059,5787,4949,838,4245,3555,690,1110,247,79,2809
4/1/2018,VA,Virginia,Patrick,51141,5127,3922,1205,4283,*,*,844,*,*,4864,3661,1203,3980,2995,985,1007,188,68,2717
4/1/2018,VA,Virginia,Petersburg City,51730,7151,5478,1673,5346,99,5247,1805,86,1719,6518,4845,1673,4778,3171,1607,2030,346,68,2334
4/1/2018,VA,Virginia,Pittsylvania,51143,16136,12312,3824,13277,92,13185,2859,80,2779,15172,11349,3823,12480,9726,2754,3018,552,208,8702
4/1/2018,VA,Virginia,Poquoson City,51735,2500,2197,303,2327,*,*,173,*,*,2303,2000,303,1179,918,261,99,21,14,1045
4/1/2018,VA,Virginia,Portsmouth City,51740,18040,13657,4383,14099,189,13910,3941,213,3728,16110,11729,4381,10748,6635,4113,3778,724,141,6105
4/1/2018,VA,Virginia,Powhatan,51145,5838,4641,1197,5239,20,5219,599,17,582,5343,4146,1197,4293,3289,1004,389,113,28,3763
4/1/2018,VA,Virginia,Prince Edward,51147,4652,3920,732,3745,37,3708,907,36,871,4308,3576,732,3342,2822,520,1095,171,50,2026
4/1/2018,VA,Virginia,Prince George,51149,5843,5050,793,4959,28,4931,884,34,850,5414,4621,793,3313,2626,687,557,125,29,2602
4/1/2018,VA,Virginia,Prince William,51153,47295,38719,8576,42276,303,41973,5019,305,4714,40291,31719,8572,23519,16015,7504,5079,1049,214,17177
4/1/2018,VA,Virginia,Pulaski,51155,9055,7252,1803,7252,33,7219,1803,30,1773,8435,6632,1803,6915,5368,1547,1604,312,118,4881
4/1/2018,VA,Virginia,Radford City,51750,2037,1680,357,1659,11,1648,378,*,*,1856,1499,357,1563,1244,319,323,44,23,1173
4/1/2018,VA,Virginia,Rappahannock,51157,2001,1807,194,1863,*,*,138,*,*,1812,1619,193,1231,1098,133,147,*,*,1044
4/1/2018,VA,Virginia,Richmond,51159,2025,1636,389,1766,*,*,259,13,246,1878,1489,389,1408,1163,245,297,76,17,1018
4/1/2018,VA,Virginia,Richmond City,51760,33683,23084,10599,26671,292,26379,7012,352,6660,30276,19677,10599,25593,15618,9975,8665,1448,287,15193
4/1/2018,VA,Virginia,Roanoke,51161,23422,18138,5284,20860,105,20755,2562,62,2500,21687,16405,5282,17422,13059,4363,1978,458,135,14851
4/1/2018,VA,Virginia,Roanoke City,51770,20419,14964,5455,15445,135,15310,4974,154,4820,18583,13132,5451,15143,10197,4946,4728,883,215,9317
4/1/2018,VA,Virginia,Rockbridge,51163,5962,5094,868,5084,19,5065,878,11,867,5531,4663,868,4152,3447,705,805,184,61,3102
4/1/2018,VA,Virginia,Rockingham,51165,17315,14851,2464,15202,47,15155,2113,42,2071,15997,13534,2463,12454,10756,1698,1790,504,141,10019
4/1/2018,VA,Virginia,Russell,51167,7831,4889,2942,5456,13,5443,2375,16,2359,7502,4560,2942,6409,4066,2343,1645,321,132,4311
4/1/2018,VA,Virginia,Salem City,51775,6133,4904,1229,5198,27,5171,935,17,918,5636,4407,1229,4483,3423,1060,831,153,36,3463
4/1/2018,VA,Virginia,Scott,51169,6637,3251,3386,5025,11,5014,1612,16,1596,6364,2978,3386,5545,2256,3289,1517,247,105,3676
4/1/2018,VA,Virginia,Shenandoah,51171,10438,9115,1323,9262,31,9231,1176,26,1150,9737,8414,1323,6881,5884,997,1249,266,88,5278
4/1/2018,VA,Virginia,Smyth,51173,8796,6542,2254,6605,31,6574,2191,29,2162,8315,6061,2254,6829,4818,2011,2131,408,128,4162
4/1/2018,VA,Virginia,Southampton,51175,4072,3458,614,3428,35,3393,644,17,627,3783,3169,614,2973,2459,514,693,123,33,2124
4/1/2018,VA,Virginia,Spotsylvania,51177,20536,17972,2564,17879,120,17759,2657,100,2557,18242,15679,2563,11042,9061,1981,1942,525,133,8442
4/1/2018,VA,Virginia,Stafford,51179,17007,15222,1785,14983,102,14881,2024,76,1948,14899,13116,1783,7609,6219,1390,1339,380,87,5803
4/1/2018,VA,Virginia,Staunton City,51790,6197,5438,759,5159,25,5134,1038,16,1022,5820,5061,759,4578,3981,597,1064,149,59,3306
4/1/2018,VA,Virginia,Suffolk City,51800,15929,12730,3199,13129,107,13022,2800,102,2698,14524,11325,3199,10024,7178,2846,2647,469,117,6791
4/1/2018,VA,Virginia,Surry,51181,1575,1243,332,1340,11,1329,235,*,*,1457,1125,332,1060,758,302,203,64,13,780
4/1/2018,VA,Virginia,Sussex,51183,2382,1868,514,1964,31,1933,418,*,*,2207,1693,514,1696,1219,477,464,138,22,1072
4/1/2018,VA,Virginia,Tazewell,51185,12001,8148,3853,8907,43,8864,3094,39,3055,11347,7495,3852,9061,6499,2562,2253,457,185,6166
4/1/2018,VA,Virginia,Unknown,51999,*,*,*,*,*,*,*,*,*,*,*,*,*,*,*,*,*,*,*
4/1/2018,VA,Virginia,Virginia Beach City,51810,70395,57947,12448,62210,396,61814,8185,337,7848,64370,51929,12441,37106,26063,11043,6732,1507,376,28491
4/1/2018,VA,Virginia,Warren,51187,7475,6633,842,6433,27,6406,1042,31,1011,6809,5967,842,4631,3990,641,883,241,69,3438
4/1/2018,VA,Virginia,Washington,51191,14954,9645,5309,12102,44,12058,2852,29,2823,14088,8780,5308,11564,6783,4781,2412,547,180,8425
4/1/2018,VA,Virginia,Waynesboro City,51820,4739,4134,605,3903,22,3881,836,24,812,4425,3820,605,3502,3003,499,869,114,37,2482
4/1/2018,VA,Virginia,Westmoreland,51193,4926,4329,597,4338,26,4312,588,12,576,4480,3883,597,2862,2397,465,731,138,44,1949
4/1/2018,VA,Virginia,Williamsburg City,51830,2565,2188,377,2355,*,*,210,12,198,2365,1988,377,1669,1361,308,225,*,*,1410
4/1/2018,VA,Virginia,Winchester City,51840,5147,4531,616,4395,22,4373,752,17,735,4654,4038,616,3385,2921,464,820,136,48,2381
4/1/2018,VA,Virginia,Wise,51195,10648,6532,4116,7225,32,7193,3423,23,3400,10055,5939,4116,8008,4267,3741,2420,463,166,4959
4/1/2018,VA,Virginia,Wythe,51197,7639,5833,1806,5965,32,5933,1674,24,1650,7207,5402,1805,5835,4297,1538,1543,275,97,3920
4/1/2018,VA,Virginia,York,51199,11761,10181,1580,10788,40,10748,973,31,942,10771,9191,1580,5792,4476,1316,670,171,39,4912
8/1/2018,VA,Virginia,Accomack,51001,8776,7319,1457,7579,39,7540,1197,45,1152,8143,6686,1457,5939,4800,1139,1488,361,88,4002
8/1/2018,VA,Virginia,Albemarle,51003,20663,18413,2250,19085,53,19032,1578,52,1526,18558,16310,2248,14194,12303,1891,1550,306,96,12242
8/1/2018,VA,Virginia,Alexandria City,51510,17868,15146,2722,16453,73,16380,1415,83,1332,14405,11685,2720,8740,6328,2412,2161,309,64,6206
8/1/2018,VA,Virginia,Alleghany,51005,4508,3911,597,3646,21,3625,862,14,848,4287,3690,597,3431,2979,452,794,100,53,2484
8/1/2018,VA,Virginia,Amelia,51007,3053,2340,713,2591,*,*,462,15,447,2822,2109,713,2242,1590,652,470,95,33,1644
8/1/2018,VA,Virginia,Amherst,51009,7835,6442,1393,6531,47,6484,1304,29,1275,7286,5893,1393,5869,4675,1194,1240,231,78,4320
8/1/2018,VA,Virginia,Appomattox,51011,3857,3201,656,3176,15,3161,681,20,661,3633,2977,656,2924,2357,567,683,108,37,2096
8/1/2018,VA,Virginia,Arlington,51013,24273,20997,3276,22681,94,22587,1592,84,1508,19162,15886,3276,11591,8667,2924,3019,352,108,8112
8/1/2018,VA,Virginia,Augusta,51015,18220,15731,2489,15787,54,15733,2433,47,2386,17091,14602,2489,13098,11119,1979,1874,417,139,10668
8/1/2018,VA,Virginia,Bath,51017,1265,1165,100,1115,*,*,150,*,*,1196,1096,100,930,847,83,163,37,22,708
8/1/2018,VA,Virginia,Bedford,51019,19807,16285,3522,16995,85,16910,2812,57,2755,18466,14946,3520,14369,11900,2469,2011,499,149,11710
8/1/2018,VA,Virginia,Bland,51021,1795,1373,422,1407,*,*,388,*,*,1690,1268,422,1282,1043,239,241,54,17,970
8/1/2018,VA,Virginia,Botetourt,51023,8629,6635,1994,7531,46,7485,1098,19,1079,8021,6027,1994,6290,4649,1641,791,190,52,5257
8/1/2018,VA,Virginia,Bristol City,51520,4526,2558,1968,3512,*,*,1014,19,995,4258,2290,1968,3596,1711,1885,1089,149,53,2305
8/1/2018,VA,Virginia,Brunswick,51025,3987,3282,705,3315,27,3288,672,22,650,3718,3013,705,2919,2324,595,1077,114,39,1689
8/1/2018,VA,Virginia,Buchanan,51027,7291,4197,3094,4621,16,4605,2670,16,2654,7047,3953,3094,5895,3673,2222,1665,401,108,3721
8/1/2018,VA,Virginia,Buckingham,51029,3505,2954,551,2867,21,2846,638,22,616,3272,2721,551,2507,2190,317,737,149,47,1574
8/1/2018,VA,Virginia,Buena Vista City,51530,1458,1205,253,1185,*,*,273,*,*,1365,1112,253,1068,865,203,323,53,21,671
8/1/2018,VA,Virginia,Campbell,51031,12693,10475,2218,10554,71,10483,2139,67,2072,11900,9682,2218,9613,7709,1904,2078,362,155,7018
8/1/2018,VA,Virginia,Caroline,51033,5839,4793,1046,4889,37,4852,950,36,914,5270,4224,1046,3591,2691,900,830,217,46,2498
8/1/2018,VA,Virginia,Carroll,51035,8099,6783,1316,6623,19,6604,1476,*,*,7657,6341,1316,6001,4984,1017,1572,269,99,4061
8/1/2018,VA,Virginia,Charles City,51036,1906,1486,420,1621,19,1602,285,16,269,1750,1330,420,1349,995,354,270,82,15,982
8/1/2018,VA,Virginia,Charlotte,51037,3339,2777,562,2722,15,2707,617,18,599,3152,2590,562,2477,1992,485,769,125,49,1534
8/1/2018,VA,Virginia,Charlottesville City,51540,6272,5601,671,5215,26,5189,1057,38,1019,5622,4952,670,4497,3884,613,1233,152,47,3065
8/1/2018,VA,Virginia,Chesapeake City,51550,37853,29998,7855,32605,290,32315,5248,228,5020,34285,26431,7854,21099,14203,6896,4230,919,234,15716
8/1/2018,VA,Virginia,Chesterfield,51041,59554,45200,14354,52084,232,51852,7470,264,7206,53751,39400,14351,41530,28848,12682,5558,1039,257,34676
8/1/2018,VA,Virginia,Clarke,51043,3297,2902,395,3042,12,3030,255,*,*,2979,2584,395,2026,1727,299,273,75,29,1649
8/1/2018,VA,Virginia,Colonial Heights City,51570,4166,3493,673,3553,*,*,613,14,599,3824,3151,673,2505,1928,577,510,110,22,1863
8/1/2018,VA,Virginia,Covington City,51580,1654,1446,208,1277,11,1266,377,*,*,1543,1336,207,1245,1060,185,359,59,15,812
8/1/2018,VA,Virginia,Craig,51045,1342,1044,298,1047,*,*,295,0,295,1234,936,298,977,707,270,203,46,11,717
8/1/2018,VA,Virginia,Culpeper,51047,9403,7951,1452,8157,40,8117,1246,49,1197,8518,7068,1450,5954,4845,1109,1226,236,78,4414
8/1/2018,VA,Virginia,Cumberland,51049,2267,1770,497,1893,*,*,374,*,*,2114,1617,497,1654,1222,432,416,91,31,1116
8/1/2018,VA,Virginia,Danville City,51590,11193,8620,2573,8824,86,8738,2369,118,2251,10522,7949,2573,8778,6969,1809,3278,407,159,4934
8/1/2018,VA,Virginia,Dickenson,51051,4755,2719,2036,3020,*,*,1735,*,*,4562,2526,2036,3755,1946,1809,1132,209,80,2334
8/1/2018,VA,Virginia,Dinwiddie,51053,5898,4681,1217,4755,33,4722,1143,30,1113,5426,4209,1217,4023,2894,1129,926,194,51,2852
8/1/2018,VA,Virginia,Emporia City,51595,1160,874,286,885,16,869,275,*,*,1086,800,286,885,652,233,420,*,*,391
8/1/2018,VA,Virginia,Essex,51057,2935,2377,558,2523,13,2510,412,12,400,2734,2176,558,2050,1634,416,445,86,24,1495
8/1/2018,VA,Virginia,Fairfax,51059,149959,124426,25533,141685,565,141120,8274,464,7810,121167,95661,25506,71300,49802,21498,13939,2663,527,54171
8/1/2018,VA,Virginia,Fairfax City,51600,3819,3098,721,3559,13,3546,260,15,245,3193,2472,721,1970,1404,566,366,66,12,1526
8/1/2018,VA,Virginia,Falls Church City,51610,2020,1705,315,1935,*,*,85,0,85,1577,1262,315,969,697,272,128,*,*,823
8/1/2018,VA,Virginia,Fauquier,51061,12550,11196,1354,11459,62,11397,1091,38,1053,11146,9792,1354,7140,6192,948,987,185,62,5906
8/1/2018,VA,Virginia,Floyd,51063,4050,3275,775,3502,16,3486,548,*,*,3790,3015,775,2997,2284,713,577,98,43,2279
8/1/2018,VA,Virginia,Fluvanna,51065,5862,5119,743,5275,18,5257,587,18,569,5373,4630,743,3927,3328,599,550,112,25,3240
8/1/2018,VA,Virginia,Franklin,51067,14593,10684,3909,12261,45,12216,2332,31,2301,13736,9827,3909,11155,7669,3486,2011,472,154,8518
8/1/2018,VA,Virginia,Franklin City,51620,1982,1645,337,1548,20,1528,434,24,410,1855,1518,337,1514,1208,306,583,61,14,856
8/1/2018,VA,Virginia,Frederick,51069,16436,14414,2022,14617,52,14565,1819,63,1756,14970,12951,2019,10316,8793,1523,1490,356,126,8344
8/1/2018,VA,Virginia,Fredericksburg City,51630,4030,3531,499,3317,23,3294,713,24,689,3597,3098,499,2497,2066,431,797,95,39,1566
8/1/2018,VA,Virginia,Galax City,51640,1840,1673,167,1468,*,*,372,11,361,1731,1564,167,1379,1255,124,586,54,21,718
8/1/2018,VA,Virginia,Giles,51071,4606,3596,1010,3671,20,3651,935,17,918,4356,3346,1010,3581,2999,582,820,124,40,2597
8/1/2018,VA,Virginia,Gloucester,51073,8515,7090,1425,7329,38,7291,1186,23,1163,7870,6445,1425,5069,3867,1202,1000,173,40,3856
8/1/2018,VA,Virginia,Goochland,51075,5789,4571,1218,5292,27,5265,497,18,479,5247,4030,1217,4301,3330,971,404,97,32,3768
8/1/2018,VA,Virginia,Grayson,51077,4683,3878,805,3877,*,*,806,11,795,4456,3651,805,3405,2726,679,987,181,88,2149
8/1/2018,VA,Virginia,Greene,51079,3797,3325,472,3324,16,3308,473,*,*,3459,2987,472,2500,2091,409,461,86,25,1928
8/1/2018,VA,Virginia,Greensville,51081,2466,1846,620,1988,23,1965,478,17,461,2311,1691,620,1853,1380,473,509,121,31,1192
8/1/2018,VA,Virginia,Halifax,51083,9677,8138,1539,7937,71,7866,1740,53,1687,9099,7560,1539,7321,5979,1342,2136,436,147,4602
8/1/2018,VA,Virginia,Hampton City,51650,24946,18630,6316,20540,196,20344,4406,203,4203,22821,16505,6316,13985,8111,5874,3788,778,171,9248
8/1/2018,VA,Virginia,Hanover,51085,20754,15743,5011,18882,86,18796,1872,51,1821,18945,13935,5010,15271,11204,4067,1439,341,94,13397
8/1/2018,VA,Virginia,Harrisonburg City,51660,5364,4744,620,4540,16,4524,824,21,803,4865,4245,620,3885,3449,436,1002,140,25,2718
8/1/2018,VA,Virginia,Henrico,51087,56144,41339,14805,49202,328,48874,6942,280,6662,50800,35996,14804,41204,28455,12749,6498,1393,397,32916
8/1/2018,VA,Virginia,Henry,51089,15034,10970,4064,11963,69,11894,3071,58,3013,14304,10240,4064,12103,8410,3693,3076,710,247,8070
8/1/2018,VA,Virginia,Highland,51091,783,712,71,715,*,*,68,*,*,733,662,71,547,488,59,53,*,*,463
8/1/2018,VA,Virginia,Hopewell City,51670,4520,3526,994,3497,30,3467,1023,31,992,4213,3219,994,2922,1976,946,1012,158,29,1723
8/1/2018,VA,Virginia,Isle of Wight,51093,8231,6512,1719,7243,48,7195,988,37,951,7613,5894,1719,5387,3839,1548,957,203,67,4160
8/1/2018,VA,Virginia,James City,51095,20416,17696,2720,19206,62,19144,1210,56,1154,18901,16184,2717,12110,10080,2030,848,222,57,10983
8/1/2018,VA,Virginia,King and Queen,51097,1769,1470,299,1494,13,1481,275,*,*,1642,1343,299,1223,968,255,271,67,11,874
8/1/2018,VA,Virginia,King George,51099,3868,3489,379,3344,14,3330,524,26,498,3356,2977,379,1675,1368,307,457,73,17,1128
8/1/2018,VA,Virginia,King William,51101,3401,2869,532,2909,26,2883,492,19,473,3117,2585,532,2506,2064,442,402,116,20,1968
8/1/2018,VA,Virginia,Lancaster,51103,4315,3721,594,3973,18,3955,342,16,326,4106,3512,594,2993,2625,368,500,101,16,2376
8/1/2018,VA,Virginia,Lee,51105,6450,3735,2715,4460,19,4441,1990,13,1977,6139,3426,2713,5005,2484,2521,1953,261,87,2704
8/1/2018,VA,Virginia,Lexington City,51678,1658,1500,158,1529,11,1518,129,*,*,1529,1371,158,1172,1051,121,210,33,11,918
8/1/2018,VA,Virginia,Loudoun,51107,37090,30897,6193,34656,152,34504,2434,113,2321,30800,24610,6190,20379,15168,5211,3149,637,145,16448
8/1/2018,VA,Virginia,Louisa,51109,8051,6556,1495,6796,40,6756,1255,34,1221,7377,5882,1495,5442,4171,1271,1082,241,64,4055
8/1/2018,VA,Virginia,Lunenburg,51111,3025,2618,407,2470,21,2449,555,18,537,2799,2392,407,2122,1771,351,710,108,41,1263
8/1/2018,VA,Virginia,Lynchburg City,51680,14658,12169,2489,12020,86,11934,2638,104,2534,13621,11132,2489,11032,8870,2162,2990,449,131,7462
8/1/2018,VA,Virginia,Madison,51113,2983,2552,431,2659,11,2648,324,12,312,2784,2353,431,2067,1736,331,390,84,21,1572
8/1/2018,VA,Virginia,Manassas City,51683,4480,3631,849,3953,22,3931,527,42,485,3772,2923,849,2607,1881,726,511,90,41,1965
8/1/2018,VA,Virginia,Manassas Park City,51685,1321,1012,309,1147,13,1134,174,12,162,1119,811,308,777,501,276,198,*,*,524
8/1/2018,VA,Virginia,Martinsville City,51690,3960,3001,959,2936,36,2900,1024,41,983,3744,2785,959,3219,2312,907,1337,162,61,1659
8/1/2018,VA,Virginia,Mathews,51115,2852,2390,462,2628,*,*,224,*,*,2706,2244,462,1899,1528,371,270,40,19,1570
8/1/2018,VA,Virginia,Mecklenburg,51117,9145,7416,1729,7598,67,7531,1547,59,1488,8615,6886,1729,6780,5377,1403,1870,360,101,4449
8/1/2018,VA,Virginia,Middlesex,51119,3606,3057,549,3239,14,3225,367,*,*,3400,2851,549,2587,2189,398,459,77,29,2022
8/1/2018,VA,Virginia,Montgomery,51121,13917,11411,2506,11619,42,11577,2298,28,2270,12609,10103,2506,10398,8156,2242,1896,358,116,8028
8/1/2018,VA,Virginia,Nelson,51125,4637,3992,645,4126,18,4108,511,*,*,4263,3619,644,3117,2575,542,584,102,43,2388
8/1/2018,VA,Virginia,New Kent,51127,4493,3675,818,4036,19,4017,457,*,*,4100,3282,818,2879,2260,619,298,71,13,2497
8/1/2018,VA,Virginia,Newport News City,51700,28085,20847,7238,23091,209,22882,4994,245,4749,25708,18472,7236,16817,10024,6793,4799,900,227,10891
8/1/2018,VA,Virginia,Norfolk City,51710,32814,24522,8292,26279,266,26013,6535,335,6200,29551,21259,8292,19991,12194,7797,7283,1321,298,11089
8/1/2018,VA,Virginia,Northampton,51131,3645,3012,633,3131,19,3112,514,22,492,3408,2775,633,2725,2203,522,926,91,28,1680
8/1/2018,VA,Virginia,Northumberland,51133,4625,3991,634,4297,17,4280,328,13,315,4322,3688,634,2875,2523,352,428,83,30,2334
8/1/2018,VA,Virginia,Norton City,51720,1186,773,413,808,*,*,378,*,*,1095,682,413,896,529,367,358,53,15,470
8/1/2018,VA,Virginia,Nottoway,51135,3669,3076,593,3005,26,2979,664,17,647,3411,2818,593,2660,2260,400,895,130,42,1593
8/1/2018,VA,Virginia,Orange,51137,8802,7638,1164,7763,45,7718,1039,34,1005,8084,6920,1164,5367,4598,769,985,211,65,4106
8/1/2018,VA,Virginia,Page,51139,6182,5322,860,5081,23,5058,1101,23,1078,5806,4946,860,4252,3542,710,1124,242,80,2806
8/1/2018,VA,Virginia,Patrick,51141,5157,3929,1228,4302,*,*,855,*,*,4897,3671,1226,3997,2995,1002,1019,187,67,2724
8/1/2018,VA,Virginia,Petersburg City,51730,7191,5425,1766,5365,96,5269,1826,89,1737,6581,4815,1766,4790,3090,1700,2079,338,66,2307
8/1/2018,VA,Virginia,Pittsylvania,51143,16250,12328,3922,13331,80,13251,2919,81,2838,15285,11363,3922,12541,9709,2832,3054,542,204,8741
8/1/2018,VA,Virginia,Poquoson City,51735,2527,2218,309,2347,*,*,180,*,*,2327,2018,309,1188,923,265,101,19,13,1055
8/1/2018,VA,Virginia,Portsmouth City,51740,18133,13582,4551,14143,180,13963,3990,215,3775,16231,11682,4549,10808,6523,4285,3892,704,145,6067
8/1/2018,VA,Virginia,Powhatan,51145,5914,4699,1215,5308,20,5288,606,18,588,5421,4206,1215,4356,3331,1025,398,114,29,3815
8/1/2018,VA,Virginia,Prince Edward,51147,4684,3918,766,3767,34,3733,917,35,882,4342,3576,766,3349,2793,556,1105,169,49,2026
8/1/2018,VA,Virginia,Prince George,51149,5927,5121,806,5015,27,4988,912,36,876,5494,4688,806,3332,2637,695,561,124,30,2617
8/1/2018,VA,Virginia,Prince William,51153,48142,39298,8844,43034,280,42754,5108,305,4803,41138,32298,8840,23804,16045,7759,5226,1049,218,17311
8/1/2018,VA,Virginia,Pulaski,51155,9095,7259,1836,7278,32,7246,1817,29,1788,8509,6673,1836,6948,5367,1581,1628,303,113,4904
8/1/2018,VA,Virginia,Radford City,51750,2042,1683,359,1656,*,*,386,*,*,1872,1513,359,1567,1245,322,335,43,24,1165
8/1/2018,VA,Virginia,Rappahannock,51157,2029,1835,194,1886,*,*,143,*,*,1835,1642,193,1240,1110,130,149,*,*,1051
8/1/2018,VA,Virginia,Richmond,51159,2034,1642,392,1771,*,*,263,13,250,1891,1499,392,1410,1161,249,310,69,16,1015
8/1/2018,VA,Virginia,Richmond City,51760,33969,23004,10965,26877,276,26601,7092,358,6734,30613,19648,10965,25813,15470,10343,8898,1407,298,15210
8/1/2018,VA,Virginia,Roanoke,51161,23589,18234,5355,20980,97,20883,2609,62,2547,21849,16496,5353,17511,13070,4441,2017,440,134,14920
8/1/2018,VA,Virginia,Roanoke City,51770,20592,14937,5655,15549,127,15422,5043,158,4885,18744,13093,5651,15227,10075,5152,4855,867,220,9285
8/1/2018,VA,Virginia,Rockbridge,51163,6008,5132,876,5115,17,5098,893,11,882,5592,4716,876,4189,3481,708,818,187,59,3125
8/1/2018,VA,Virginia,Rockingham,51165,17420,14941,2479,15286,44,15242,2134,40,2094,16106,13628,2478,12540,10823,1717,1817,497,141,10085
8/1/2018,VA,Virginia,Russell,51167,7864,4874,2990,5458,11,5447,2406,15,2391,7531,4541,2990,6415,4018,2397,1650,327,136,4302
8/1/2018,VA,Virginia,Salem City,51775,6150,4890,1260,5204,27,5177,946,16,930,5676,4416,1260,4525,3430,1095,854,147,41,3483
8/1/2018,VA,Virginia,Scott,51169,6642,3212,3430,5005,11,4994,1637,18,1619,6382,2952,3430,5534,2205,3329,1529,243,106,3656
8/1/2018,VA,Virginia,Shenandoah,51171,10503,9177,1326,9312,28,9284,1191,28,1163,9817,8491,1326,6916,5915,1001,1254,262,83,5317
8/1/2018,VA,Virginia,Smyth,51173,8821,6487,2334,6617,31,6586,2204,28,2176,8336,6002,2334,6828,4732,2096,2155,416,124,4133
8/1/2018,VA,Virginia,Southampton,51175,4111,3465,646,3458,33,3425,653,20,633,3824,3178,646,2981,2434,547,700,119,33,2129
8/1/2018,VA,Virginia,Spotsylvania,51177,20797,18192,2605,18116,111,18005,2681,99,2582,18499,15895,2604,11146,9139,2007,2018,516,131,8481
8/1/2018,VA,Virginia,Stafford,51179,17291,15488,1803,15216,97,15119,2075,77,1998,15165,13364,1801,7687,6275,1412,1394,378,86,5829
8/1/2018,VA,Virginia,Staunton City,51790,6249,5471,778,5196,24,5172,1053,14,1039,5876,5098,778,4607,3992,615,1086,149,59,3313
8/1/2018,VA,Virginia,Suffolk City,51800,16099,12747,3352,13243,103,13140,2856,99,2757,14736,11384,3352,10124,7123,3001,2724,454,118,6828
8/1/2018,VA,Virginia,Surry,51181,1596,1259,337,1352,11,1341,244,*,*,1471,1134,337,1064,756,308,210,63,13,778
8/1/2018,VA,Virginia,Sussex,51183,2396,1857,539,1963,29,1934,433,*,*,2224,1685,539,1685,1183,502,469,134,22,1060
8/1/2018,VA,Virginia,Tazewell,51185,12029,8129,3900,8894,39,8855,3135,39,3096,11382,7483,3899,9063,6439,2624,2285,455,184,6139
8/1/2018,VA,Virginia,Unknown,51999,*,*,*,*,*,*,*,*,*,*,*,*,*,*,*,*,*,*,*
8/1/2018,VA,Virginia,Virginia Beach City,51810,71313,58543,12770,62919,378,62541,8394,345,8049,65353,52590,12763,37521,26166,11355,6878,1496,384,28763
8/1/2018,VA,Virginia,Warren,51187,7538,6685,853,6479,24,6455,1059,31,1028,6879,6026,853,4651,4007,644,913,231,70,3437
8/1/2018,VA,Virginia,Washington,51191,15045,9654,5391,12156,42,12114,2889,28,2861,14205,8815,5390,11632,6757,4875,2449,537,186,8460
8/1/2018,VA,Virginia,Waynesboro City,51820,4768,4124,644,3914,21,3893,854,26,828,4452,3808,644,3513,2979,534,885,109,39,2480
8/1/2018,VA,Virginia,Westmoreland,51193,4998,4383,615,4394,25,4369,604,12,592,4565,3950,615,2900,2419,481,759,137,46,1958
8/1/2018,VA,Virginia,Williamsburg City,51830,2592,2199,393,2373,*,*,219,12,207,2390,1997,393,1684,1361,323,228,*,*,1422
8/1/2018,VA,Virginia,Winchester City,51840,5191,4566,625,4435,21,4414,756,16,740,4705,4080,625,3398,2924,474,837,138,47,2376
8/1/2018,VA,Virginia,Wise,51195,10708,6480,4228,7214,24,7190,3494,24,3470,10129,5901,4228,8066,4209,3857,2456,467,170,4973
8/1/2018,VA,Virginia,Wythe,51197,7671,5814,1857,5989,28,5961,1682,21,1661,7258,5402,1856,5846,4250,1596,1565,272,109,3900
8/1/2018,VA,Virginia,York,51199,11861,10267,1594,10874,39,10835,987,30,957,10854,9260,1594,5809,4475,1334,680,169,41,4919
12/1/2018,VA,Virginia,Accomack,51001,8831,7371,1460,7617,38,7579,1214,44,1170,8193,6733,1460,5974,4836,1138,1500,367,83,4024
12/1/2018,VA,Virginia,Albemarle,51003,20842,18581,2261,19243,51,19192,1599,47,1552,18692,16433,2259,14294,12385,1909,1570,307,98,12319
12/1/2018,VA,Virginia,Alexandria City,51510,18104,15312,2792,16649,67,16582,1455,87,1368,14565,11775,2790,8846,6364,2482,2206,302,61,6277
12/1/2018,VA,Virginia,Alleghany,51005,4513,3915,598,3640,19,3621,873,12,861,4293,3695,598,3437,2981,456,791,99,52,2495
12/1/2018,VA,Virginia,Amelia,51007,3064,2343,721,2597,*,*,467,13,454,2829,2108,721,2253,1592,661,476,99,33,1645
12/1/2018,VA,Virginia,Amherst,51009,7895,6490,1405,6576,47,6529,1319,28,1291,7335,5930,1405,5890,4684,1206,1262,221,78,4329
12/1/2018,VA,Virginia,Appomattox,51011,3871,3230,641,3179,14,3165,692,20,672,3642,3001,641,2923,2365,558,692,99,39,2093
12/1/2018,VA,Virginia,Arlington,51013,24610,21233,3377,22974,88,22886,1636,87,1549,19332,15955,3377,11686,8665,3021,3051,356,114,8165
12/1/2018,VA,Virginia,Augusta,51015,18369,15857,2512,15909,49,15860,2460,48,2412,17232,14720,2512,13191,11182,2009,1908,404,137,10742
12/1/2018,VA,Virginia,Bath,51017,1263,1163,100,1106,*,*,157,*,*,1195,1095,100,928,844,84,163,35,23,707
12/1/2018,VA,Virginia,Bedford,51019,19897,16370,3527,17042,75,16967,2855,57,2798,18536,15011,3525,14416,11936,2480,2055,490,152,11719
12/1/2018,VA,Virginia,Bland,51021,1801,1373,428,1412,*,*,389,*,*,1700,1272,428,1295,1047,248,244,54,19,978
12/1/2018,VA,Virginia,Botetourt,51023,8657,6639,2018,7537,44,7493,1120,19,1101,8047,6029,2018,6302,4628,1674,799,180,51,5272
12/1/2018,VA,Virginia,Bristol City,51520,4539,2534,2005,3512,*,*,1027,18,1009,4270,2265,2005,3615,1693,1922,1104,152,57,2302
12/1/2018,VA,Virginia,Brunswick,51025,3998,3270,728,3322,27,3295,676,22,654,3723,2995,728,2920,2301,619,1076,115,42,1687
12/1/2018,VA,Virginia,Buchanan,51027,7311,4206,3105,4597,16,4581,2714,15,2699,7068,3963,3105,5924,3683,2241,1690,394,113,3727
12/1/2018,VA,Virginia,Buckingham,51029,3510,2954,556,2867,18,2849,643,21,622,3273,2717,556,2518,2189,329,755,142,47,1574
12/1/2018,VA,Virginia,Buena Vista City,51530,1459,1207,252,1184,*,*,275,*,*,1370,1118,252,1064,862,202,328,50,19,667
12/1/2018,VA,Virginia,Campbell,51031,12705,10492,2213,10535,64,10471,2170,66,2104,11893,9680,2213,9584,7684,1900,2103,362,146,6973
12/1/2018,VA,Virginia,Caroline,51033,5891,4838,1053,4930,33,4897,961,35,926,5307,4254,1053,3613,2708,905,849,209,47,2508
12/1/2018,VA,Virginia,Carroll,51035,8158,6834,1324,6664,18,6646,1494,*,*,7720,6396,1324,6050,5025,1025,1589,263,98,4100
12/1/2018,VA,Virginia,Charles City,51036,1939,1512,427,1651,17,1634,288,16,272,1779,1352,427,1355,994,361,274,81,15,985
12/1/2018,VA,Virginia,Charlotte,51037,3361,2792,569,2730,14,2716,631,17,614,3174,2605,569,2494,2000,494,781,124,49,1540
12/1/2018,VA,Virginia,Charlottesville City,51540,6329,5629,700,5247,26,5221,1082,40,1042,5660,4961,699,4540,3898,642,1265,146,47,3082
12/1/2018,VA,Virginia,Chesapeake City,51550,38270,30278,7992,32933,275,32658,5337,226,5111,34632,26641,7991,21285,14245,7040,4300,903,232,15850
12/1/2018,VA,Virginia,Chesterfield,51041,60224,45735,14489,52622,213,52409,7602,264,7338,54274,39789,14485,41938,29106,12832,5667,1007,264,35000
12/1/2018,VA,Virginia,Clarke,51043,3312,2921,391,3051,*,*,261,*,*,2978,2587,391,2029,1732,297,276,74,28,1651
12/1/2018,VA,Virginia,Colonial Heights City,51570,4182,3487,695,3561,*,*,621,14,607,3830,3135,695,2505,1904,601,520,107,22,1856
12/1/2018,VA,Virginia,Covington City,51580,1645,1433,212,1265,11,1254,380,*,*,1529,1318,211,1228,1038,190,357,58,16,797
12/1/2018,VA,Virginia,Craig,51045,1346,1047,299,1049,*,*,297,0,297,1239,940,299,980,709,271,215,42,13,710
12/1/2018,VA,Virginia,Culpeper,51047,9472,7997,1475,8196,37,8159,1276,48,1228,8585,7112,1473,6011,4880,1131,1266,238,78,4429
12/1/2018,VA,Virginia,Cumberland,51049,2271,1757,514,1896,*,*,375,*,*,2118,1604,514,1650,1201,449,419,90,33,1108
12/1/2018,VA,Virginia,Danville City,51590,11211,8593,2618,8797,76,8721,2414,119,2295,10537,7919,2618,8788,6939,1849,3310,401,160,4917
12/1/2018,VA,Virginia,Dickenson,51051,4772,2682,2090,3002,*,*,1770,*,*,4579,2489,2090,3785,1926,1859,1153,205,78,2349
12/1/2018,VA,Virginia,Dinwiddie,51053,5923,4684,1239,4771,33,4738,1152,30,1122,5450,4211,1239,4028,2875,1153,932,186,53,2857
12/1/2018,VA,Virginia,Emporia City,51595,1171,885,286,888,16,872,283,*,*,1098,812,286,893,661,232,433,*,*,386
12/1/2018,VA,Virginia,Essex,51057,2965,2397,568,2546,13,2533,419,14,405,2751,2183,568,2063,1639,424,455,86,26,1496
12/1/2018,VA,Virginia,Fairfax,51059,152218,126062,26156,143705,538,143167,8513,467,8046,122754,96622,26132,72368,50381,21987,14185,2654,549,54980
12/1/2018,VA,Virginia,Fairfax City,51600,3858,3129,729,3598,*,*,260,16,244,3221,2492,729,1991,1418,573,369,68,13,1541
12/1/2018,VA,Virginia,Falls Church City,51610,2050,1734,316,1959,*,*,91,0,91,1588,1272,316,982,708,274,129,*,*,835
12/1/2018,VA,Virginia,Fauquier,51061,12687,11325,1362,11576,61,11515,1111,41,1070,11284,9922,1362,7206,6251,955,1004,183,59,5960
12/1/2018,VA,Virginia,Floyd,51063,4077,3289,788,3522,17,3505,555,*,*,3801,3013,788,3006,2280,726,586,94,43,2283
12/1/2018,VA,Virginia,Fluvanna,51065,5930,5183,747,5335,16,5319,595,19,576,5432,4685,747,3959,3359,600,559,108,24,3268
12/1/2018,VA,Virginia,Franklin,51067,14668,10717,3951,12310,43,12267,2358,31,2327,13796,9845,3951,11181,7655,3526,2031,473,157,8520
12/1/2018,VA,Virginia,Franklin City,51620,2000,1649,351,1556,20,1536,444,23,421,1865,1514,351,1519,1199,320,591,61,14,853
12/1/2018,VA,Virginia,Frederick,51069,16537,14529,2008,14701,48,14653,1836,59,1777,15045,13040,2005,10375,8862,1513,1514,364,124,8373
12/1/2018,VA,Virginia,Fredericksburg City,51630,4073,3562,511,3346,22,3324,727,25,702,3639,3128,511,2531,2092,439,823,96,35,1577
12/1/2018,VA,Virginia,Galax City,51640,1841,1664,177,1467,*,*,374,11,363,1739,1562,177,1393,1260,133,590,56,23,724
12/1/2018,VA,Virginia,Giles,51071,4606,3595,1011,3668,18,3650,938,15,923,4353,3342,1011,3595,3006,589,834,114,40,2607
12/1/2018,VA,Virginia,Gloucester,51073,8558,7120,1438,7367,34,7333,1191,21,1170,7905,6467,1438,5084,3863,1221,998,175,44,3867
12/1/2018,VA,Virginia,Goochland,51075,5846,4613,1233,5343,27,5316,503,17,486,5312,4080,1232,4363,3374,989,403,98,32,3830
12/1/2018,VA,Virginia,Grayson,51077,4720,3880,840,3896,*,*,824,*,*,4495,3655,840,3426,2709,717,1005,183,87,2151
12/1/2018,VA,Virginia,Greene,51079,3841,3369,472,3356,13,3343,485,*,*,3497,3025,472,2533,2123,410,476,83,23,1951
12/1/2018,VA,Virginia,Greensville,51081,2480,1849,631,1997,22,1975,483,17,466,2317,1686,631,1864,1378,486,523,116,31,1194
12/1/2018,VA,Virginia,Halifax,51083,9700,8152,1548,7959,67,7892,1741,48,1693,9118,7570,1548,7328,5978,1350,2142,428,147,4611
12/1/2018,VA,Virginia,Hampton City,51650,25165,18727,6438,20679,181,20498,4486,204,4282,22960,16522,6438,14104,8096,6008,3876,771,174,9283
12/1/2018,VA,Virginia,Hanover,51085,21006,15941,5065,19108,78,19030,1898,50,1848,19149,14084,5065,15411,11281,4130,1467,331,93,13520
12/1/2018,VA,Virginia,Harrisonburg City,51660,5426,4796,630,4581,15,4566,845,22,823,4917,4287,630,3921,3476,445,1031,139,27,2724
12/1/2018,VA,Virginia,Henrico,51087,56706,41690,15016,49649,303,49346,7057,283,6774,51206,36191,15015,41525,28540,12985,6611,1366,398,33150
12/1/2018,VA,Virginia,Henry,51089,15066,10986,4080,11964,66,11898,3102,58,3044,14324,10244,4080,12115,8400,3715,3127,714,250,8024
12/1/2018,VA,Virginia,Highland,51091,780,712,68,711,*,*,69,*,*,732,664,68,538,483,55,51,*,*,459
12/1/2018,VA,Virginia,Hopewell City,51670,4555,3540,1015,3513,28,3485,1042,32,1010,4230,3215,1015,2945,1979,966,1041,151,31,1722
12/1/2018,VA,Virginia,Isle of Wight,51093,8320,6583,1737,7317,45,7272,1003,35,968,7672,5935,1737,5420,3852,1568,977,193,67,4183
12/1/2018,VA,Virginia,James City,51095,20558,17847,2711,19332,55,19277,1226,56,1170,19015,16307,2708,12184,10159,2025,871,219,64,11030
12/1/2018,VA,Virginia,King and Queen,51097,1780,1481,299,1502,13,1489,278,*,*,1648,1349,299,1222,966,256,274,69,12,867
12/1/2018,VA,Virginia,King George,51099,3919,3538,381,3382,13,3369,537,25,512,3399,3018,381,1704,1395,309,469,71,18,1146
12/1/2018,VA,Virginia,King William,51101,3432,2888,544,2933,23,2910,499,19,480,3142,2598,544,2527,2074,453,417,115,20,1975
12/1/2018,VA,Virginia,Lancaster,51103,4333,3739,594,3988,18,3970,345,17,328,4120,3526,594,2990,2624,366,502,95,13,2380
12/1/2018,VA,Virginia,Lee,51105,6448,3700,2748,4437,16,4421,2011,12,1999,6124,3378,2746,4995,2436,2559,1969,255,86,2685
12/1/2018,VA,Virginia,Lexington City,51678,1643,1486,157,1514,*,*,129,*,*,1515,1358,157,1162,1042,120,205,33,12,912
12/1/2018,VA,Virginia,Loudoun,51107,37652,31291,6361,35165,142,35023,2487,111,2376,31172,24815,6357,20669,15305,5364,3218,635,148,16668
12/1/2018,VA,Virginia,Louisa,51109,8123,6620,1503,6849,38,6811,1274,35,1239,7449,5946,1503,5489,4210,1279,1093,247,61,4088
12/1/2018,VA,Virginia,Lunenburg,51111,3051,2633,418,2486,19,2467,565,18,547,2817,2399,418,2143,1783,360,723,104,39,1277
12/1/2018,VA,Virginia,Lynchburg City,51680,14701,12205,2496,12035,80,11955,2666,102,2564,13639,11143,2496,11033,8857,2176,3029,437,131,7436
12/1/2018,VA,Virginia,Madison,51113,3011,2575,436,2679,11,2668,332,12,320,2795,2359,436,2068,1732,336,396,84,21,1567
12/1/2018,VA,Virginia,Manassas City,51683,4553,3681,872,4008,20,3988,545,42,503,3822,2950,872,2658,1908,750,547,90,37,1984
12/1/2018,VA,Virginia,Manassas Park City,51685,1345,1027,318,1165,13,1152,180,12,168,1131,813,318,791,506,285,210,*,*,523
12/1/2018,VA,Virginia,Martinsville City,51690,3969,3012,957,2939,35,2904,1030,41,989,3760,2803,957,3218,2311,907,1350,159,57,1652
12/1/2018,VA,Virginia,Mathews,51115,2858,2396,462,2633,*,*,225,*,*,2709,2247,462,1897,1526,371,274,40,20,1563
12/1/2018,VA,Virginia,Mecklenburg,51117,9165,7378,1787,7604,60,7544,1561,59,1502,8625,6838,1787,6771,5306,1465,1870,348,98,4455
12/1/2018,VA,Virginia,Middlesex,51119,3629,3074,555,3256,14,3242,373,*,*,3422,2867,555,2594,2189,405,463,77,29,2025
12/1/2018,VA,Virginia,Montgomery,51121,14030,11513,2517,11706,40,11666,2324,30,2294,12677,10160,2517,10442,8183,2259,1929,345,122,8046
12/1/2018,VA,Virginia,Nelson,51125,4684,4035,649,4158,14,4144,526,*,*,4308,3660,648,3143,2597,546,596,104,43,2400
12/1/2018,VA,Virginia,New Kent,51127,4553,3732,821,4088,17,4071,465,*,*,4142,3321,821,2905,2285,620,298,71,13,2523
12/1/2018,VA,Virginia,Newport News City,51700,28348,20958,7390,23260,192,23068,5088,243,4845,25939,18550,7389,16956,10002,6954,4937,877,222,10920
12/1/2018,VA,Virginia,Norfolk City,51710,33154,24645,8509,26514,251,26263,6640,337,6303,29830,21321,8509,20136,12111,8025,7410,1312,294,11120
12/1/2018,VA,Virginia,Northampton,51131,3664,3010,654,3146,19,3127,518,22,496,3419,2765,654,2738,2192,546,934,92,29,1683
12/1/2018,VA,Virginia,Northumberland,51133,4642,3996,646,4306,16,4290,336,14,322,4354,3708,646,2901,2541,360,436,88,30,2347
12/1/2018,VA,Virginia,Norton City,51720,1192,767,425,805,*,*,387,*,*,1100,675,425,903,523,380,362,52,13,476
12/1/2018,VA,Virginia,Nottoway,51135,3656,3048,608,2986,22,2964,670,16,654,3401,2793,608,2654,2231,423,893,129,38,1594
12/1/2018,VA,Virginia,Orange,51137,8862,7698,1164,7805,44,7761,1057,35,1022,8126,6962,1164,5405,4636,769,1013,204,62,4126
12/1/2018,VA,Virginia,Page,51139,6219,5348,871,5108,22,5086,1111,23,1088,5828,4957,871,4262,3540,722,1128,244,83,2807
12/1/2018,VA,Virginia,Patrick,51141,5176,3947,1229,4307,*,*,869,11,858,4909,3682,1227,4007,3003,1004,1036,186,70,2715
12/1/2018,VA,Virginia,Petersburg City,51730,7207,5368,1839,5352,87,5265,1855,86,1769,6583,4744,1839,4800,3028,1772,2108,335,64,2293
12/1/2018,VA,Virginia,Pittsylvania,51143,16365,12364,4001,13398,73,13325,2967,81,2886,15395,11394,4001,12625,9736,2889,3113,524,212,8776
12/1/2018,VA,Virginia,Poquoson City,51735,2542,2232,310,2360,*,*,182,*,*,2340,2030,310,1196,930,266,103,*,*,1061
12/1/2018,VA,Virginia,Portsmouth City,51740,18265,13584,4681,14198,160,14038,4067,215,3852,16345,11666,4679,10872,6456,4416,3991,684,143,6054
12/1/2018,VA,Virginia,Powhatan,51145,5990,4766,1224,5377,19,5358,613,19,594,5489,4265,1224,4409,3375,1034,416,111,29,3853
12/1/2018,VA,Virginia,Prince Edward,51147,4700,3927,773,3770,33,3737,930,34,896,4364,3591,773,3357,2794,563,1104,167,48,2038
12/1/2018,VA,Virginia,Prince George,51149,5994,5180,814,5064,27,5037,930,37,893,5546,4732,814,3350,2645,705,574,118,32,2626
12/1/2018,VA,Virginia,Prince William,51153,48895,39857,9038,43643,261,43382,5252,305,4947,41672,32638,9034,24069,16124,7945,5351,1065,218,17435
12/1/2018,VA,Virginia,Pulaski,51155,9143,7298,1845,7289,27,7262,1854,29,1825,8540,6695,1845,6973,5388,1585,1653,296,109,4915
12/1/2018,VA,Virginia,Radford City,51750,2058,1693,365,1666,*,*,392,*,*,1884,1519,365,1578,1251,327,345,42,26,1165
12/1/2018,VA,Virginia,Rappahannock,51157,2049,1851,198,1902,*,*,147,*,*,1854,1657,197,1257,1122,135,152,*,*,1059
12/1/2018,VA,Virginia,Richmond,51159,2050,1653,397,1786,*,*,264,13,251,1900,1503,397,1415,1162,253,315,67,15,1018
12/1/2018,VA,Virginia,Richmond City,51760,34194,22965,11229,27019,258,26761,7175,357,6818,30772,19543,11229,25957,15341,10616,9077,1393,295,15192
12/1/2018,VA,Virginia,Roanoke,51161,23709,18308,5401,21051,84,20967,2658,63,2595,21936,16537,5399,17588,13089,4499,2058,444,136,14950
12/1/2018,VA,Virginia,Roanoke City,51770,20713,14922,5791,15619,118,15501,5094,154,4940,18841,13054,5787,15297,10000,5297,4914,851,219,9313
12/1/2018,VA,Virginia,Rockbridge,51163,6045,5160,885,5138,12,5126,907,11,896,5615,4730,885,4208,3489,719,834,183,62,3129
12/1/2018,VA,Virginia,Rockingham,51165,17536,15065,2471,15367,37,15330,2169,40,2129,16208,13738,2470,12608,10891,1717,1834,491,141,10142
12/1/2018,VA,Virginia,Russell,51167,7909,4875,3034,5458,*,*,2451,16,2435,7579,4546,3033,6415,3974,2441,1673,329,141,4272
12/1/2018,VA,Virginia,Salem City,51775,6134,4866,1268,5178,27,5151,956,15,941,5657,4389,1268,4519,3415,1104,839,150,42,3488
12/1/2018,VA,Virginia,Scott,51169,6648,3179,3469,4999,11,4988,1649,15,1634,6389,2920,3469,5552,2183,3369,1537,247,104,3664
12/1/2018,VA,Virginia,Shenandoah,51171,10568,9236,1332,9361,26,9335,1207,28,1179,9881,8549,1332,6956,5944,1012,1270,266,84,5336
12/1/2018,VA,Virginia,Smyth,51173,8809,6421,2388,6582,27,6555,2227,25,2202,8324,5936,2388,6818,4664,2154,2156,406,128,4128
12/1/2018,VA,Virginia,Southampton,51175,4150,3495,655,3484,28,3456,666,21,645,3858,3203,655,3012,2453,559,707,118,37,2150
12/1/2018,VA,Virginia,Spotsylvania,51177,21035,18407,2628,18284,100,18184,2751,101,2650,18681,16054,2627,11218,9186,2032,2086,507,129,8496
12/1/2018,VA,Virginia,Stafford,51179,17554,15738,1816,15443,88,15355,2111,80,2031,15350,13536,1814,7754,6329,1425,1431,372,89,5862
12/1/2018,VA,Virginia,Staunton City,51790,6284,5484,800,5220,23,5197,1064,13,1051,5900,5100,800,4634,3996,638,1109,148,60,3317
12/1/2018,VA,Virginia,Suffolk City,51800,16256,12814,3442,13352,99,13253,2904,101,2803,14867,11425,3442,10169,7077,3092,2768,449,119,6833
12/1/2018,VA,Virginia,Surry,51181,1630,1285,345,1386,11,1375,244,*,*,1498,1153,345,1082,764,318,209,61,13,799
12/1/2018,VA,Virginia,Sussex,51183,2420,1874,546,1978,28,1950,442,*,*,2249,1703,546,1709,1200,509,478,134,23,1074
12/1/2018,VA,Virginia,Tazewell,51185,12071,8125,3946,8878,35,8843,3193,41,3152,11438,7493,3945,9125,6432,2693,2323,457,186,6159
12/1/2018,VA,Virginia,Unknown,51999,*,*,*,*,*,*,*,*,*,*,*,*,*,*,*,*,*,*,*
12/1/2018,VA,Virginia,Virginia Beach City,51810,72109,59126,12983,63587,357,63230,8522,336,8186,65977,53001,12976,37898,26299,11599,7003,1486,398,29011
12/1/2018,VA,Virginia,Warren,51187,7620,6766,854,6542,19,6523,1078,30,1048,6958,6104,854,4689,4043,646,933,228,69,3459
12/1/2018,VA,Virginia,Washington,51191,15081,9610,5471,12163,36,12127,2918,28,2890,14241,8771,5470,11695,6736,4959,2502,539,193,8461
12/1/2018,VA,Virginia,Waynesboro City,51820,4795,4130,665,3929,20,3909,866,27,839,4464,3799,665,3515,2958,557,898,109,38,2470
12/1/2018,VA,Virginia,Westmoreland,51193,5017,4407,610,4395,19,4376,622,13,609,4584,3974,610,2911,2430,481,772,134,48,1957
12/1/2018,VA,Virginia,Williamsburg City,51830,2604,2215,389,2382,*,*,222,12,210,2393,2004,389,1689,1369,320,235,*,*,1423
12/1/2018,VA,Virginia,Winchester City,51840,5211,4592,619,4442,21,4421,769,16,753,4727,4108,619,3398,2929,469,850,134,46,2368
12/1/2018,VA,Virginia,Wise,51195,10760,6420,4340,7210,24,7186,3550,25,3525,10183,5843,4340,8128,4155,3973,2495,463,180,4990
12/1/2018,VA,Virginia,Wythe,51197,7701,5831,1870,5990,26,5964,1711,17,1694,7297,5428,1869,5873,4260,1613,1595,271,108,3899
12/1/2018,VA,Virginia,York,51199,11987,10385,1602,10973,36,10937,1014,29,985,10969,9367,1602,5849,4504,1345,702,170,40,4937
2/1/2018,VA,Virginia,Accomack,51001,8688,7255,1433,7523,49,7474,1165,43,1122,8084,6651,1433,5943,4835,1108,1445,379,93,4026
2/1/2018,VA,Virginia,Albemarle,51003,20357,18171,2186,18812,56,18756,1545,54,1491,18263,16079,2184,14002,12169,1833,1512,324,102,12064
2/1/2018,VA,Virginia,Alexandria City,51510,17499,14886,2613,16123,82,16041,1376,83,1293,14094,11483,2611,8616,6303,2313,2076,329,66,6145
2/1/2018,VA,Virginia,Alleghany,51005,4503,3931,572,3654,26,3628,849,14,835,4263,3691,572,3409,2988,421,782,107,54,2466
2/1/2018,VA,Virginia,Amelia,51007,3045,2349,696,2584,*,*,461,15,446,2811,2115,696,2226,1592,634,457,103,36,1630
2/1/2018,VA,Virginia,Amherst,51009,7733,6371,1362,6471,55,6416,1262,28,1234,7174,5812,1362,5807,4644,1163,1195,234,82,4296
2/1/2018,VA,Virginia,Appomattox,51011,3809,3175,634,3148,17,3131,661,21,640,3580,2946,634,2891,2344,547,662,103,42,2084
2/1/2018,VA,Virginia,Arlington,51013,23782,20690,3092,22213,105,22108,1569,90,1479,18766,15674,3092,11443,8701,2742,2949,365,106,8023
2/1/2018,VA,Virginia,Augusta,51015,18050,15592,2458,15671,63,15608,2379,45,2334,16937,14479,2458,12986,11060,1926,1789,423,140,10634
2/1/2018,VA,Virginia,Bath,51017,1263,1168,95,1117,*,*,146,*,*,1194,1099,95,938,859,79,162,36,24,716
2/1/2018,VA,Virginia,Bedford,51019,19517,16044,3473,16783,95,16688,2734,57,2677,18175,14704,3471,14172,11756,2416,1942,521,154,11555
2/1/2018,VA,Virginia,Bland,51021,1781,1360,421,1403,*,*,378,*,*,1686,1265,421,1278,1043,235,238,50,17,973
2/1/2018,VA,Virginia,Botetourt,51023,8568,6604,1964,7479,51,7428,1089,19,1070,7959,5995,1964,6254,4646,1608,796,196,53,5209
2/1/2018,VA,Virginia,Bristol City,51520,4525,2602,1923,3525,14,3511,1000,18,982,4250,2327,1923,3598,1759,1839,1050,155,54,2339
2/1/2018,VA,Virginia,Brunswick,51025,3939,3307,632,3274,29,3245,665,22,643,3671,3039,632,2918,2390,528,1081,112,42,1683
2/1/2018,VA,Virginia,Buchanan,51027,7281,4274,3007,4659,22,4637,2622,17,2605,7001,3994,3007,5843,3716,2127,1603,404,109,3727
2/1/2018,VA,Virginia,Buckingham,51029,3490,2964,526,2867,21,2846,623,22,601,3249,2723,526,2507,2224,283,719,158,49,1581
2/1/2018,VA,Virginia,Buena Vista City,51530,1448,1205,243,1178,*,*,270,*,*,1352,1109,243,1072,879,193,315,55,21,681
2/1/2018,VA,Virginia,Campbell,51031,12569,10412,2157,10493,80,10413,2076,65,2011,11778,9621,2157,9561,7718,1843,2012,387,169,6993
2/1/2018,VA,Virginia,Caroline,51033,5756,4754,1002,4822,40,4782,934,38,896,5186,4184,1002,3556,2703,853,797,228,52,2479
2/1/2018,VA,Virginia,Carroll,51035,8037,6772,1265,6605,22,6583,1432,*,*,7566,6301,1265,5930,4968,962,1533,277,107,4013
2/1/2018,VA,Virginia,Charles City,51036,1907,1497,410,1627,20,1607,280,15,265,1747,1337,410,1349,1009,340,262,85,18,984
2/1/2018,VA,Virginia,Charlotte,51037,3325,2793,532,2714,16,2698,611,18,593,3130,2598,532,2478,2023,455,770,126,50,1532
2/1/2018,VA,Virginia,Charlottesville City,51540,6179,5562,617,5140,31,5109,1039,39,1000,5507,4891,616,4417,3853,564,1186,153,50,3028
2/1/2018,VA,Virginia,Chesapeake City,51550,37158,29604,7554,32054,312,31742,5104,219,4885,33604,26051,7553,20813,14235,6578,4080,955,247,15531
2/1/2018,VA,Virginia,Chesterfield,51041,58432,44553,13879,51138,252,50886,7294,264,7030,52691,38815,13876,40751,28548,12203,5360,1076,273,34042
2/1/2018,VA,Virginia,Clarke,51043,3235,2831,404,2988,12,2976,247,*,*,2914,2510,404,1986,1677,309,264,74,27,1621
2/1/2018,VA,Virginia,Colonial Heights City,51570,4153,3501,652,3559,*,*,594,14,580,3816,3164,652,2506,1954,552,493,114,27,1872
2/1/2018,VA,Virginia,Covington City,51580,1647,1459,188,1279,12,1267,368,*,*,1531,1344,187,1239,1072,167,347,60,19,813
2/1/2018,VA,Virginia,Craig,51045,1333,1051,282,1038,*,*,295,0,295,1228,946,282,977,723,254,201,45,11,720
2/1/2018,VA,Virginia,Culpeper,51047,9283,7905,1378,8075,43,8032,1208,47,1161,8416,7040,1376,5912,4877,1035,1197,250,81,4384
2/1/2018,VA,Virginia,Cumberland,51049,2247,1770,477,1880,*,*,367,*,*,2080,1603,477,1636,1225,411,408,93,32,1103
2/1/2018,VA,Virginia,Danville City,51590,11128,8770,2358,8826,95,8731,2302,120,2182,10471,8113,2358,8766,7164,1602,3197,416,170,4983
2/1/2018,VA,Virginia,Dickenson,51051,4733,2793,1940,3035,*,*,1698,*,*,4531,2591,1940,3741,2028,1713,1109,209,78,2345
2/1/2018,VA,Virginia,Dinwiddie,51053,5810,4642,1168,4698,39,4659,1112,29,1083,5332,4164,1168,3970,2893,1077,894,197,54,2825
2/1/2018,VA,Virginia,Emporia City,51595,1150,884,266,885,16,869,265,11,254,1068,802,266,885,670,215,412,*,*,395
2/1/2018,VA,Virginia,Essex,51057,2895,2354,541,2489,16,2473,406,12,394,2699,2158,541,2037,1638,399,429,89,24,1495
2/1/2018,VA,Virginia,Fairfax,51059,146262,121766,24496,138266,596,137670,7996,457,7539,118031,93563,24468,69743,49250,20493,13457,2750,529,53007
2/1/2018,VA,Virginia,Fairfax City,51600,3741,3044,697,3483,14,3469,258,12,246,3124,2427,697,1928,1391,537,355,67,12,1494
2/1/2018,VA,Virginia,Falls Church City,51610,1964,1657,307,1882,*,*,82,0,82,1534,1227,307,960,696,264,125,*,*,817
2/1/2018,VA,Virginia,Fauquier,51061,12319,10984,1335,11254,66,11188,1065,39,1026,10931,9596,1335,7029,6097,932,968,197,63,5801
2/1/2018,VA,Virginia,Floyd,51063,4003,3235,768,3466,17,3449,537,*,*,3748,2980,768,2974,2271,703,563,101,45,2265
2/1/2018,VA,Virginia,Fluvanna,51065,5762,5045,717,5193,21,5172,569,20,549,5274,4557,717,3872,3297,575,520,120,27,3205
2/1/2018,VA,Virginia,Franklin,51067,14496,10695,3801,12192,51,12141,2304,31,2273,13627,9826,3801,11077,7698,3379,1945,496,159,8477
2/1/2018,VA,Virginia,Franklin City,51620,1969,1655,314,1549,23,1526,420,22,398,1841,1527,314,1510,1229,281,566,64,15,865
2/1/2018,VA,Virginia,Frederick,51069,16219,14192,2027,14442,58,14384,1777,65,1712,14757,12733,2024,10198,8683,1515,1456,368,124,8250
2/1/2018,VA,Virginia,Fredericksburg City,51630,3981,3493,488,3282,25,3257,699,22,677,3558,3070,488,2497,2077,420,774,98,43,1582
2/1/2018,VA,Virginia,Galax City,51640,1845,1692,153,1475,*,*,370,11,359,1735,1582,153,1392,1283,109,590,56,22,724
2/1/2018,VA,Virginia,Giles,51071,4594,3588,1006,3673,25,3648,921,16,905,4314,3309,1005,3554,2989,565,786,131,38,2599
2/1/2018,VA,Virginia,Gloucester,51073,8389,7004,1385,7230,40,7190,1159,25,1134,7748,6363,1385,5002,3847,1155,993,175,41,3793
2/1/2018,VA,Virginia,Goochland,51075,5653,4468,1185,5164,29,5135,489,20,469,5123,3939,1184,4207,3261,946,397,101,35,3674
2/1/2018,VA,Virginia,Grayson,51077,4675,3911,764,3882,11,3871,793,12,781,4446,3682,764,3407,2770,637,976,183,88,2160
2/1/2018,VA,Virginia,Greene,51079,3721,3272,449,3263,16,3247,458,*,*,3390,2941,449,2472,2085,387,452,88,30,1902
2/1/2018,VA,Virginia,Greensville,51081,2432,1828,604,1967,23,1944,465,15,450,2278,1674,604,1856,1397,459,503,130,33,1190
2/1/2018,VA,Virginia,Halifax,51083,9621,8172,1449,7906,76,7830,1715,55,1660,9042,7593,1449,7309,6058,1251,2104,455,150,4600
2/1/2018,VA,Virginia,Hampton City,51650,24661,18633,6028,20371,215,20156,4290,202,4088,22485,16457,6028,13831,8246,5585,3642,788,179,9222
2/1/2018,VA,Virginia,Hanover,51085,20449,15515,4934,18606,91,18515,1843,51,1792,18658,13725,4933,15061,11076,3985,1389,351,104,13217
2/1/2018,VA,Virginia,Harrisonburg City,51660,5338,4736,602,4540,19,4521,798,21,777,4830,4228,602,3849,3434,415,970,140,29,2710
2/1/2018,VA,Virginia,Henrico,51087,55424,41047,14377,48614,363,48251,6810,290,6520,50115,35739,14376,40694,28385,12309,6277,1435,413,32569
2/1/2018,VA,Virginia,Henry,51089,15004,11035,3969,11986,78,11908,3018,59,2959,14263,10294,3969,12092,8503,3589,2976,744,253,8119
2/1/2018,VA,Virginia,Highland,51091,773,700,73,707,*,*,66,*,*,721,648,73,544,483,61,54,*,*,459
2/1/2018,VA,Virginia,Hopewell City,51670,4509,3558,951,3494,32,3462,1015,32,983,4193,3242,951,2920,2015,905,981,167,32,1740
2/1/2018,VA,Virginia,Isle of Wight,51093,8104,6427,1677,7152,55,7097,952,37,915,7515,5838,1677,5334,3832,1502,923,206,67,4138
2/1/2018,VA,Virginia,James City,51095,20166,17507,2659,18988,66,18922,1178,55,1123,18639,15983,2656,11937,9947,1990,815,220,63,10839
2/1/2018,VA,Virginia,King and Queen,51097,1744,1467,277,1472,16,1456,272,*,*,1627,1350,277,1205,972,233,258,70,13,864
2/1/2018,VA,Virginia,King George,51099,3789,3417,372,3288,16,3272,501,25,476,3282,2910,372,1655,1356,299,437,73,15,1130
2/1/2018,VA,Virginia,King William,51101,3327,2815,512,2850,28,2822,477,19,458,3059,2547,512,2484,2060,424,385,122,22,1955
2/1/2018,VA,Virginia,Lancaster,51103,4314,3740,574,3982,20,3962,332,15,317,4089,3515,574,2993,2646,347,483,98,17,2395
2/1/2018,VA,Virginia,Lee,51105,6424,3795,2629,4468,20,4448,1956,13,1943,6107,3480,2627,4993,2560,2433,1920,257,86,2730
2/1/2018,VA,Virginia,Lexington City,51678,1654,1499,155,1527,14,1513,127,*,*,1531,1376,155,1165,1049,116,211,33,12,909
2/1/2018,VA,Virginia,Loudoun,51107,36240,30283,5957,33888,161,33727,2352,105,2247,30056,24103,5953,19961,14988,4973,3026,661,151,16123
2/1/2018,VA,Virginia,Louisa,51109,7945,6518,1427,6713,41,6672,1232,38,1194,7251,5824,1427,5391,4181,1210,1042,261,70,4018
2/1/2018,VA,Virginia,Lunenburg,51111,3012,2642,370,2469,21,2448,543,17,526,2790,2420,370,2135,1821,314,697,119,44,1275
2/1/2018,VA,Virginia,Lynchburg City,51680,14602,12196,2406,12015,97,11918,2587,110,2477,13550,11144,2406,11014,8937,2077,2932,461,127,7494
2/1/2018,VA,Virginia,Madison,51113,2961,2536,425,2637,12,2625,324,13,311,2759,2334,425,2056,1731,325,379,87,24,1566
2/1/2018,VA,Virginia,Manassas City,51683,4414,3587,827,3899,27,3872,515,45,470,3714,2887,827,2583,1884,699,489,95,41,1958
2/1/2018,VA,Virginia,Manassas Park City,51685,1291,985,306,1122,15,1107,169,13,156,1095,790,305,775,506,269,189,*,*,527
2/1/2018,VA,Virginia,Martinsville City,51690,3960,3056,904,2960,37,2923,1000,40,960,3738,2834,904,3230,2376,854,1305,169,66,1690
2/1/2018,VA,Virginia,Mathews,51115,2827,2379,448,2610,*,*,217,*,*,2681,2233,448,1882,1526,356,272,38,17,1555
2/1/2018,VA,Virginia,Mecklenburg,51117,9102,7426,1676,7582,71,7511,1520,60,1460,8539,6863,1676,6757,5414,1343,1831,376,113,4437
2/1/2018,VA,Virginia,Middlesex,51119,3568,3038,530,3205,18,3187,363,*,*,3369,2839,530,2575,2197,378,440,86,31,2018
2/1/2018,VA,Virginia,Montgomery,51121,13760,11332,2428,11495,45,11450,2265,28,2237,12429,10001,2428,10259,8104,2155,1857,356,118,7928
2/1/2018,VA,Virginia,Nelson,51125,4555,3948,607,4053,18,4035,502,*,*,4174,3568,606,3060,2554,506,573,100,45,2342
2/1/2018,VA,Virginia,New Kent,51127,4413,3607,806,3967,22,3945,446,*,*,4016,3210,806,2838,2230,608,277,77,15,2469
2/1/2018,VA,Virginia,Newport News City,51700,27694,20827,6867,22831,226,22605,4863,245,4618,25329,18464,6865,16660,10238,6422,4605,924,230,10901
2/1/2018,VA,Virginia,Norfolk City,51710,32410,24517,7893,26043,291,25752,6367,332,6035,29141,21248,7893,19849,12464,7385,7048,1368,306,11127
2/1/2018,VA,Virginia,Northampton,51131,3623,3032,591,3115,24,3091,508,25,483,3389,2798,591,2738,2260,478,925,99,29,1685
2/1/2018,VA,Virginia,Northumberland,51133,4601,3972,629,4271,19,4252,330,13,317,4291,3662,629,2874,2531,343,420,89,32,2333
2/1/2018,VA,Virginia,Norton City,51720,1196,806,390,817,*,*,379,*,*,1104,714,390,901,557,344,357,53,16,475
2/1/2018,VA,Virginia,Nottoway,51135,3662,3117,545,3013,32,2981,649,17,632,3403,2858,545,2657,2305,352,878,137,45,1597
2/1/2018,VA,Virginia,Orange,51137,8693,7547,1146,7691,49,7642,1002,33,969,7977,6831,1146,5322,4570,752,942,223,67,4090
2/1/2018,VA,Virginia,Page,51139,6160,5364,796,5091,25,5066,1069,23,1046,5780,4984,796,4236,3588,648,1097,253,81,2805
2/1/2018,VA,Virginia,Patrick,51141,5119,3911,1208,4280,*,*,839,*,*,4856,3650,1206,3982,2998,984,997,194,69,2722
2/1/2018,VA,Virginia,Petersburg City,51730,7141,5544,1597,5344,103,5241,1797,86,1711,6518,4921,1597,4771,3243,1528,2009,356,66,2340
2/1/2018,VA,Virginia,Pittsylvania,51143,16096,12328,3768,13256,98,13158,2840,80,2760,15145,11377,3768,12468,9773,2695,2995,577,211,8685
2/1/2018,VA,Virginia,Poquoson City,51735,2495,2195,300,2322,*,*,173,*,*,2299,1999,300,1174,916,258,100,22,15,1037
2/1/2018,VA,Virginia,Portsmouth City,51740,17980,13648,4332,14066,195,13871,3914,212,3702,16080,11750,4330,10741,6684,4057,3733,743,139,6126
2/1/2018,VA,Virginia,Powhatan,51145,5821,4636,1185,5230,22,5208,591,17,574,5328,4143,1185,4261,3270,991,380,109,28,3744
2/1/2018,VA,Virginia,Prince Edward,51147,4656,3946,710,3755,40,3715,901,37,864,4311,3601,710,3349,2855,494,1099,177,50,2023
2/1/2018,VA,Virginia,Prince George,51149,5818,5035,783,4944,31,4913,874,35,839,5390,4607,783,3314,2637,677,547,127,31,2609
2/1/2018,VA,Virginia,Prince William,51153,46999,38573,8426,42024,305,41719,4975,309,4666,40049,31627,8422,23391,16035,7356,4991,1079,225,17096
2/1/2018,VA,Virginia,Pulaski,51155,9027,7248,1779,7241,36,7205,1786,28,1758,8404,6625,1779,6888,5363,1525,1589,318,127,4854
2/1/2018,VA,Virginia,Radford City,51750,2032,1681,351,1651,11,1640,381,*,*,1861,1510,351,1559,1246,313,322,46,23,1168
2/1/2018,VA,Virginia,Rappahannock,51157,1989,1798,191,1852,*,*,137,*,*,1807,1617,190,1226,1096,130,145,*,*,1041
2/1/2018,VA,Virginia,Richmond,51159,2029,1645,384,1772,*,*,257,14,243,1883,1499,384,1411,1170,241,296,83,19,1013
2/1/2018,VA,Virginia,Richmond City,51760,33542,23138,10404,26582,294,26288,6960,351,6609,30139,19735,10404,25493,15722,9771,8536,1483,299,15175
2/1/2018,VA,Virginia,Roanoke,51161,23401,18146,5255,20861,108,20753,2540,61,2479,21672,16419,5253,17409,13081,4328,1968,465,147,14829
2/1/2018,VA,Virginia,Roanoke City,51770,20419,15094,5325,15458,140,15318,4961,158,4803,18599,13278,5321,15160,10342,4818,4698,905,214,9343
2/1/2018,VA,Virginia,Rockbridge,51163,5941,5086,855,5066,20,5046,875,11,864,5504,4649,855,4131,3437,694,796,190,68,3077
2/1/2018,VA,Virginia,Rockingham,51165,17250,14786,2464,15164,49,15115,2086,41,2045,15945,13482,2463,12410,10727,1683,1774,513,146,9977
2/1/2018,VA,Virginia,Russell,51167,7828,4912,2916,5469,15,5454,2359,16,2343,7502,4586,2916,6423,4105,2318,1634,325,138,4326
2/1/2018,VA,Virginia,Salem City,51775,6127,4932,1195,5198,28,5170,929,16,913,5619,4424,1195,4477,3452,1025,815,155,39,3468
2/1/2018,VA,Virginia,Scott,51169,6633,3263,3370,5032,12,5020,1601,16,1585,6363,2993,3370,5540,2268,3272,1502,256,113,3669
2/1/2018,VA,Virginia,Shenandoah,51171,10424,9110,1314,9250,31,9219,1174,26,1148,9730,8416,1314,6871,5883,988,1242,275,92,5262
2/1/2018,VA,Virginia,Smyth,51173,8810,6577,2233,6628,33,6595,2182,29,2153,8331,6098,2233,6844,4858,1986,2134,415,130,4165
2/1/2018,VA,Virginia,Southampton,51175,4066,3461,605,3428,36,3392,638,18,620,3783,3178,605,2981,2481,500,695,128,33,2125
2/1/2018,VA,Virginia,Spotsylvania,51177,20481,17951,2530,17846,123,17723,2635,100,2535,18211,15682,2529,11024,9078,1946,1936,531,135,8422
2/1/2018,VA,Virginia,Stafford,51179,16913,15138,1775,14907,103,14804,2006,76,1930,14835,13062,1773,7596,6219,1377,1318,390,94,5794
2/1/2018,VA,Virginia,Staunton City,51790,6183,5436,747,5155,25,5130,1028,15,1013,5801,5054,747,4562,3977,585,1049,151,62,3300
2/1/2018,VA,Virginia,Suffolk City,51800,15865,12721,3144,13079,110,12969,2786,102,2684,14481,11337,3144,10018,7233,2785,2629,482,121,6786
2/1/2018,VA,Virginia,Surry,51181,1568,1236,332,1334,11,1323,234,*,*,1453,1121,332,1061,759,302,202,64,13,782
2/1/2018,VA,Virginia,Sussex,51183,2372,1871,501,1956,33,1923,416,*,*,2202,1701,501,1696,1232,464,457,140,24,1075
2/1/2018,VA,Virginia,Tazewell,51185,11989,8165,3824,8907,45,8862,3082,41,3041,11348,7525,3823,9066,6537,2529,2244,461,187,6174
2/1/2018,VA,Virginia,Unknown,51999,*,*,*,*,*,*,*,*,*,*,*,*,*,*,*,*,*,*,*
2/1/2018,VA,Virginia,Virginia Beach City,51810,70041,57706,12335,61957,410,61547,8084,332,7752,64105,51777,12328,36946,26036,10910,6653,1532,390,28371
2/1/2018,VA,Virginia,Warren,51187,7432,6607,825,6407,28,6379,1025,31,994,6769,5944,825,4619,3997,622,865,242,74,3438
2/1/2018,VA,Virginia,Washington,51191,14927,9640,5287,12096,46,12050,2831,29,2802,14065,8779,5286,11541,6792,4749,2387,558,182,8414
2/1/2018,VA,Virginia,Waynesboro City,51820,4743,4142,601,3914,22,3892,829,24,805,4438,3837,601,3512,3020,492,863,115,40,2494
2/1/2018,VA,Virginia,Westmoreland,51193,4913,4325,588,4332,27,4305,581,12,569,4466,3878,588,2858,2402,456,722,144,52,1940
2/1/2018,VA,Virginia,Williamsburg City,51830,2562,2185,377,2357,*,*,205,12,193,2362,1985,377,1673,1367,306,225,*,*,1412
2/1/2018,VA,Virginia,Winchester City,51840,5139,4538,601,4390,22,4368,749,18,731,4652,4051,601,3378,2929,449,806,139,52,2381
2/1/2018,VA,Virginia,Wise,51195,10633,6588,4045,7239,32,7207,3394,24,3370,10040,5995,4045,8014,4343,3671,2408,486,177,4943
2/1/2018,VA,Virginia,Wythe,51197,7623,5853,1770,5953,33,5920,1670,25,1645,7193,5424,1769,5826,4328,1498,1529,283,99,3915
2/1/2018,VA,Virginia,York,51199,11694,10128,1566,10728,43,10685,966,33,933,10720,9154,1566,5781,4478,1303,665,177,42,4897
1/1/2018,VA,Virginia,Accomack,51001,8681,7247,1434,7522,52,7470,1159,45,1114,8076,6642,1434,5939,4829,1110,1432,380,90,4037
1/1/2018,VA,Virginia,Albemarle,51003,20329,18151,2178,18795,58,18737,1534,53,1481,18239,16063,2176,13967,12146,1821,1505,323,104,12035
1/1/2018,VA,Virginia,Alexandria City,51510,17465,14873,2592,16093,85,16008,1372,83,1289,14066,11476,2590,8584,6295,2289,2059,331,66,6128
1/1/2018,VA,Virginia,Alleghany,51005,4501,3931,570,3661,27,3634,840,14,826,4264,3694,570,3410,2999,411,779,104,52,2475
1/1/2018,VA,Virginia,Amelia,51007,3038,2340,698,2577,*,*,461,15,446,2804,2106,698,2224,1590,634,458,101,36,1629
1/1/2018,VA,Virginia,Amherst,51009,7720,6359,1361,6467,55,6412,1253,27,1226,7167,5806,1361,5805,4646,1159,1187,238,81,4299
1/1/2018,VA,Virginia,Appomattox,51011,3801,3165,636,3144,17,3127,657,21,636,3575,2939,636,2886,2337,549,662,103,41,2080
1/1/2018,VA,Virginia,Arlington,51013,23732,20647,3085,22165,107,22058,1567,91,1476,18760,15675,3085,11410,8674,2736,2931,371,106,8002
1/1/2018,VA,Virginia,Augusta,51015,18029,15586,2443,15659,63,15596,2370,46,2324,16929,14486,2443,12970,11058,1912,1782,426,141,10621
1/1/2018,VA,Virginia,Bath,51017,1261,1166,95,1116,*,*,145,*,*,1193,1098,95,935,857,78,162,36,23,714
1/1/2018,VA,Virginia,Bedford,51019,19507,16025,3482,16783,98,16685,2724,57,2667,18182,14702,3480,14187,11768,2419,1948,523,153,11563
1/1/2018,VA,Virginia,Bland,51021,1786,1364,422,1408,*,*,378,*,*,1691,1269,422,1280,1046,234,238,51,17,974
1/1/2018,VA,Virginia,Botetourt,51023,8559,6605,1954,7471,51,7420,1088,19,1069,7945,5991,1954,6240,4643,1597,795,196,52,5197
1/1/2018,VA,Virginia,Bristol City,51520,4539,2612,1927,3540,15,3525,999,18,981,4263,2336,1927,3612,1772,1840,1042,162,55,2353
1/1/2018,VA,Virginia,Brunswick,51025,3932,3310,622,3274,29,3245,658,22,636,3672,3050,622,2908,2392,516,1082,110,42,1674
1/1/2018,VA,Virginia,Buchanan,51027,7289,4275,3014,4672,24,4648,2617,16,2601,7005,3991,3014,5848,3718,2130,1605,405,110,3728
1/1/2018,VA,Virginia,Buckingham,51029,3485,2952,533,2866,22,2844,619,22,597,3247,2714,533,2504,2222,282,715,155,48,1586
1/1/2018,VA,Virginia,Buena Vista City,51530,1445,1207,238,1177,*,*,268,*,*,1348,1110,238,1064,876,188,314,54,19,677
1/1/2018,VA,Virginia,Campbell,51031,12567,10405,2162,10495,80,10415,2072,65,2007,11775,9613,2162,9559,7711,1848,2005,392,172,6990
1/1/2018,VA,Virginia,Caroline,51033,5746,4752,994,4813,41,4772,933,37,896,5177,4183,994,3552,2706,846,796,229,53,2474
1/1/2018,VA,Virginia,Carroll,51035,8056,6778,1278,6632,24,6608,1424,*,*,7593,6315,1278,5947,4977,970,1531,281,108,4027
1/1/2018,VA,Virginia,Charles City,51036,1912,1503,409,1633,21,1612,279,15,264,1753,1344,409,1352,1013,339,266,84,17,985
1/1/2018,VA,Virginia,Charlotte,51037,3334,2801,533,2723,17,2706,611,18,593,3138,2605,533,2489,2034,455,771,128,50,1540
1/1/2018,VA,Virginia,Charlottesville City,51540,6160,5556,604,5123,31,5092,1037,41,996,5497,4894,603,4404,3854,550,1171,157,50,3026
1/1/2018,VA,Virginia,Chesapeake City,51550,37068,29563,7505,31991,320,31671,5077,220,4857,33553,26049,7504,20776,14259,6517,4062,961,248,15505
1/1/2018,VA,Virginia,Chesterfield,51041,58305,44446,13859,51042,255,50787,7263,257,7006,52597,38741,13856,40686,28517,12169,5344,1075,277,33990
1/1/2018,VA,Virginia,Clarke,51043,3234,2828,406,2986,12,2974,248,*,*,2919,2513,406,1987,1677,310,260,75,27,1625
1/1/2018,VA,Virginia,Colonial Heights City,51570,4167,3519,648,3571,*,*,596,14,582,3828,3180,648,2512,1965,547,494,116,28,1874
1/1/2018,VA,Virginia,Covington City,51580,1652,1467,185,1286,12,1274,366,*,*,1538,1354,184,1244,1080,164,349,59,19,817
1/1/2018,VA,Virginia,Craig,51045,1332,1054,278,1039,*,*,293,0,293,1228,950,278,975,725,250,198,45,13,719
1/1/2018,VA,Virginia,Culpeper,51047,9277,7903,1374,8074,44,8030,1203,46,1157,8415,7043,1372,5905,4878,1027,1188,255,77,4385
1/1/2018,VA,Virginia,Cumberland,51049,2251,1774,477,1885,*,*,366,*,*,2082,1605,477,1641,1230,411,406,95,34,1106
1/1/2018,VA,Virginia,Danville City,51590,11142,8790,2352,8848,97,8751,2294,121,2173,10478,8126,2352,8770,7176,1594,3186,418,172,4994
1/1/2018,VA,Virginia,Dickenson,51051,4735,2799,1936,3043,*,*,1692,*,*,4535,2599,1936,3748,2040,1708,1102,208,77,2361
1/1/2018,VA,Virginia,Dinwiddie,51053,5807,4650,1157,4701,40,4661,1106,30,1076,5330,4173,1157,3968,2902,1066,888,195,53,2832
1/1/2018,VA,Virginia,Emporia City,51595,1147,880,267,885,16,869,262,*,*,1064,797,267,884,670,214,410,*,*,397
1/1/2018,VA,Virginia,Essex,51057,2903,2363,540,2495,17,2478,408,12,396,2705,2165,540,2037,1639,398,428,88,24,1497
1/1/2018,VA,Virginia,Fairfax,51059,145809,121516,24293,137867,604,137263,7942,458,7484,117769,93505,24264,69469,49176,20293,13355,2747,528,52839
1/1/2018,VA,Virginia,Fairfax City,51600,3730,3034,696,3473,14,3459,257,12,245,3121,2425,696,1927,1389,538,356,67,12,1492
1/1/2018,VA,Virginia,Falls Church City,51610,1953,1649,304,1872,*,*,81,0,81,1529,1225,304,959,698,261,124,*,*,816
1/1/2018,VA,Virginia,Fauquier,51061,12293,10969,1324,11240,66,11174,1053,37,1016,10915,9591,1324,7001,6084,917,959,198,64,5780
1/1/2018,VA,Virginia,Floyd,51063,3999,3245,754,3467,17,3450,532,*,*,3744,2990,754,2962,2274,688,562,100,42,2258
1/1/2018,VA,Virginia,Fluvanna,51065,5753,5045,708,5190,21,5169,563,19,544,5256,4548,708,3849,3283,566,513,120,30,3186
1/1/2018,VA,Virginia,Franklin,51067,14469,10673,3796,12174,52,12122,2295,31,2264,13605,9809,3796,11064,7692,3372,1936,499,159,8470
1/1/2018,VA,Virginia,Franklin City,51620,1965,1652,313,1548,23,1525,417,21,396,1844,1531,313,1512,1233,279,569,65,15,863
1/1/2018,VA,Virginia,Frederick,51069,16187,14147,2040,14420,59,14361,1767,65,1702,14728,12691,2037,10179,8652,1527,1454,364,124,8237
1/1/2018,VA,Virginia,Fredericksburg City,51630,3983,3501,482,3284,26,3258,699,22,677,3564,3082,482,2501,2087,414,768,98,43,1592
1/1/2018,VA,Virginia,Galax City,51640,1852,1697,155,1482,*,*,370,11,359,1743,1588,155,1397,1287,110,595,55,23,724
1/1/2018,VA,Virginia,Giles,51071,4587,3585,1002,3674,25,3649,913,16,897,4310,3309,1001,3549,2988,561,778,135,38,2598
1/1/2018,VA,Virginia,Gloucester,51073,8379,7002,1377,7227,43,7184,1152,24,1128,7747,6370,1377,4992,3845,1147,984,174,39,3795
1/1/2018,VA,Virginia,Goochland,51075,5639,4451,1188,5151,30,5121,488,21,467,5118,3931,1187,4199,3250,949,396,100,37,3666
1/1/2018,VA,Virginia,Grayson,51077,4673,3909,764,3880,11,3869,793,13,780,4448,3684,764,3410,2773,637,973,187,87,2163
1/1/2018,VA,Virginia,Greene,51079,3714,3267,447,3256,17,3239,458,*,*,3381,2934,447,2463,2079,384,454,87,31,1891
1/1/2018,VA,Virginia,Greensville,51081,2431,1825,606,1969,23,1946,462,15,447,2281,1675,606,1861,1398,463,502,131,32,1196
1/1/2018,VA,Virginia,Halifax,51083,9611,8171,1440,7898,77,7821,1713,57,1656,9039,7599,1440,7300,6060,1240,2093,451,152,4604
1/1/2018,VA,Virginia,Hampton City,51650,24627,18650,5977,20351,222,20129,4276,203,4073,22479,16502,5977,13827,8299,5528,3615,797,182,9233
1/1/2018,VA,Virginia,Hanover,51085,20408,15496,4912,18573,93,18480,1835,52,1783,18627,13716,4911,15033,11068,3965,1380,351,104,13198
1/1/2018,VA,Virginia,Harrisonburg City,51660,5332,4729,603,4536,19,4517,796,21,775,4829,4226,603,3841,3428,413,964,140,29,2708
1/1/2018,VA,Virginia,Henrico,51087,55370,41072,14298,48585,369,48216,6785,290,6495,50052,35755,14297,40642,28427,12215,6253,1438,407,32544
1/1/2018,VA,Virginia,Henry,51089,15031,11063,3968,12016,80,11936,3015,60,2955,14283,10315,3968,12102,8519,3583,2962,755,250,8135
1/1/2018,VA,Virginia,Highland,51091,775,700,75,709,*,*,66,*,*,724,649,75,543,480,63,54,*,*,458
1/1/2018,VA,Virginia,Hopewell City,51670,4505,3572,933,3485,32,3453,1020,33,987,4189,3256,933,2914,2027,887,982,168,30,1734
1/1/2018,VA,Virginia,Isle of Wight,51093,8087,6413,1674,7142,57,7085,945,37,908,7500,5826,1674,5337,3838,1499,927,208,68,4134
1/1/2018,VA,Virginia,James City,51095,20151,17489,2662,18970,67,18903,1181,55,1126,18628,15969,2659,11936,9946,1990,815,222,65,10834
1/1/2018,VA,Virginia,King and Queen,51097,1744,1470,274,1475,16,1459,269,*,*,1628,1354,274,1207,977,230,261,71,14,861
1/1/2018,VA,Virginia,King George,51099,3781,3410,371,3284,16,3268,497,25,472,3287,2916,371,1659,1359,300,438,75,16,1130
1/1/2018,VA,Virginia,King William,51101,3323,2808,515,2846,29,2817,477,20,457,3061,2546,515,2475,2049,426,384,124,22,1945
1/1/2018,VA,Virginia,Lancaster,51103,4320,3745,575,3989,20,3969,331,15,316,4099,3524,575,2993,2645,348,480,99,17,2397
1/1/2018,VA,Virginia,Lee,51105,6430,3815,2615,4480,21,4459,1950,13,1937,6109,3496,2613,4997,2575,2422,1918,261,85,2733
1/1/2018,VA,Virginia,Lexington City,51678,1652,1499,153,1526,14,1512,126,*,*,1531,1378,153,1164,1050,114,208,31,12,913
1/1/2018,VA,Virginia,Loudoun,51107,36151,30202,5949,33815,162,33653,2336,102,2234,29998,24053,5945,19920,14953,4967,2999,669,151,16101
1/1/2018,VA,Virginia,Louisa,51109,7936,6515,1421,6701,42,6659,1235,38,1197,7245,5824,1421,5388,4184,1204,1033,262,71,4022
1/1/2018,VA,Virginia,Lunenburg,51111,3016,2650,366,2476,21,2455,540,17,523,2794,2428,366,2134,1825,309,693,121,44,1276
1/1/2018,VA,Virginia,Lynchburg City,51680,14627,12228,2399,12043,100,11943,2584,110,2474,13570,11171,2399,11028,8962,2066,2922,461,130,7515
1/1/2018,VA,Virginia,Madison,51113,2963,2542,421,2640,12,2628,323,13,310,2767,2346,421,2060,1738,322,375,89,24,1572
1/1/2018,VA,Virginia,Manassas City,51683,4402,3582,820,3887,28,3859,515,45,470,3704,2884,820,2577,1880,697,488,91,41,1957
1/1/2018,VA,Virginia,Manassas Park City,51685,1283,981,302,1115,15,1100,168,13,155,1088,787,301,771,507,264,188,*,*,525
1/1/2018,VA,Virginia,Martinsville City,51690,3977,3076,901,2974,39,2935,1003,42,961,3756,2855,901,3246,2396,850,1303,174,66,1703
1/1/2018,VA,Virginia,Mathews,51115,2825,2379,446,2608,11,2597,217,*,*,2678,2232,446,1878,1523,355,266,39,20,1553
1/1/2018,VA,Virginia,Mecklenburg,51117,9105,7445,1660,7586,72,7514,1519,60,1459,8549,6889,1660,6766,5440,1326,1833,385,113,4435
1/1/2018,VA,Virginia,Middlesex,51119,3571,3042,529,3205,19,3186,366,*,*,3376,2847,529,2577,2202,375,448,88,30,2011
1/1/2018,VA,Virginia,Montgomery,51121,13745,11321,2424,11486,45,11441,2259,29,2230,12430,10006,2424,10248,8099,2149,1855,357,114,7922
1/1/2018,VA,Virginia,Nelson,51125,4548,3944,604,4048,18,4030,500,11,489,4166,3563,603,3058,2558,500,573,101,44,2340
1/1/2018,VA,Virginia,New Kent,51127,4395,3593,802,3953,22,3931,442,*,*,4001,3199,802,2832,2228,604,277,77,16,2462
1/1/2018,VA,Virginia,Newport News City,51700,27673,20871,6802,22830,231,22599,4843,246,4597,25328,18528,6800,16650,10294,6356,4580,924,233,10913
1/1/2018,VA,Virginia,Norfolk City,51710,32359,24596,7763,26019,299,25720,6340,333,6007,29127,21364,7763,19821,12568,7253,7000,1375,300,11146
1/1/2018,VA,Virginia,Northampton,51131,3615,3034,581,3106,24,3082,509,26,483,3383,2802,581,2732,2264,468,924,99,28,1681
1/1/2018,VA,Virginia,Northumberland,51133,4592,3969,623,4267,19,4248,325,12,313,4281,3658,623,2863,2526,337,416,86,32,2329
1/1/2018,VA,Virginia,Norton City,51720,1193,809,384,816,*,*,377,*,*,1103,719,384,898,560,338,354,53,15,476
1/1/2018,VA,Virginia,Nottoway,51135,3657,3116,541,3012,32,2980,645,17,628,3395,2854,541,2657,2315,342,879,139,45,1594
1/1/2018,VA,Virginia,Orange,51137,8677,7529,1148,7681,50,7631,996,32,964,7969,6821,1148,5314,4563,751,941,224,70,4079
1/1/2018,VA,Virginia,Page,51139,6160,5364,796,5093,26,5067,1067,22,1045,5782,4986,796,4238,3592,646,1090,252,82,2814
1/1/2018,VA,Virginia,Patrick,51141,5129,3928,1201,4287,*,*,842,*,*,4867,3668,1199,3993,3017,976,995,195,68,2735
1/1/2018,VA,Virginia,Petersburg City,51730,7155,5579,1576,5360,103,5257,1795,87,1708,6532,4956,1576,4775,3268,1507,2003,362,65,2345
1/1/2018,VA,Virginia,Pittsylvania,51143,16101,12340,3761,13269,100,13169,2832,81,2751,15150,11389,3761,12470,9786,2684,2987,579,214,8690
1/1/2018,VA,Virginia,Poquoson City,51735,2496,2195,301,2324,*,*,172,*,*,2298,1997,301,1169,910,259,97,22,16,1034
1/1/2018,VA,Virginia,Portsmouth City,51740,17960,13702,4258,14057,196,13861,3903,213,3690,16061,11806,4255,10725,6745,3980,3706,743,142,6134
1/1/2018,VA,Virginia,Powhatan,51145,5804,4614,1190,5216,23,5193,588,17,571,5310,4120,1190,4253,3256,997,376,110,31,3736
1/1/2018,VA,Virginia,Prince Edward,51147,4656,3951,705,3756,40,3716,900,38,862,4316,3611,705,3350,2862,488,1099,173,49,2029
1/1/2018,VA,Virginia,Prince George,51149,5813,5024,789,4945,32,4913,868,34,834,5392,4603,789,3309,2629,680,545,126,32,2606
1/1/2018,VA,Virginia,Prince William,51153,46876,38487,8389,41938,310,41628,4938,307,4631,39966,31581,8385,23335,16025,7310,4949,1079,222,17085
1/1/2018,VA,Virginia,Pulaski,51155,9030,7256,1774,7248,38,7210,1782,28,1754,8403,6629,1774,6900,5379,1521,1582,321,128,4869
1/1/2018,VA,Virginia,Radford City,51750,2033,1681,352,1653,11,1642,380,*,*,1865,1513,352,1559,1246,313,320,46,23,1170
1/1/2018,VA,Virginia,Rappahannock,51157,1987,1798,189,1852,*,*,135,*,*,1803,1615,188,1214,1085,129,143,*,*,1030
1/1/2018,VA,Virginia,Richmond,51159,2026,1645,381,1770,*,*,256,14,242,1876,1495,381,1409,1171,238,292,84,19,1014
1/1/2018,VA,Virginia,Richmond City,51760,33503,23265,10238,26552,296,26256,6951,351,6600,30110,19872,10238,25453,15850,9603,8487,1505,299,15162
1/1/2018,VA,Virginia,Roanoke,51161,23411,18164,5247,20880,110,20770,2531,59,2472,21692,16447,5245,17398,13080,4318,1959,463,149,14827
1/1/2018,VA,Virginia,Roanoke City,51770,20385,15127,5258,15440,141,15299,4945,159,4786,18579,13325,5254,15135,10385,4750,4665,911,212,9347
1/1/2018,VA,Virginia,Rockbridge,51163,5939,5089,850,5065,21,5044,874,11,863,5502,4652,850,4130,3442,688,793,192,68,3077
1/1/2018,VA,Virginia,Rockingham,51165,17241,14773,2468,15166,51,15115,2075,41,2034,15935,13468,2467,12392,10712,1680,1760,516,148,9968
1/1/2018,VA,Virginia,Russell,51167,7835,4930,2905,5482,15,5467,2353,16,2337,7504,4599,2905,6429,4122,2307,1644,324,138,4323
1/1/2018,VA,Virginia,Salem City,51775,6144,4962,1182,5219,30,5189,925,16,909,5639,4457,1182,4492,3482,1010,820,154,39,3479
1/1/2018,VA,Virginia,Scott,51169,6635,3267,3368,5035,12,5023,1600,16,1584,6362,2994,3368,5537,2267,3270,1498,258,114,3667
1/1/2018,VA,Virginia,Shenandoah,51171,10414,9105,1309,9239,32,9207,1175,26,1149,9717,8408,1309,6850,5872,978,1234,273,93,5250
1/1/2018,VA,Virginia,Smyth,51173,8829,6613,2216,6648,35,6613,2181,28,2153,8342,6126,2216,6841,4873,1968,2136,415,130,4160
1/1/2018,VA,Virginia,Southampton,51175,4069,3474,595,3431,37,3394,638,18,620,3791,3196,595,2975,2484,491,695,129,34,2117
1/1/2018,VA,Virginia,Spotsylvania,51177,20438,17923,2515,17814,124,17690,2624,101,2523,18181,15667,2514,11009,9080,1929,1927,526,135,8421
1/1/2018,VA,Virginia,Stafford,51179,16868,15089,1779,14881,105,14776,1987,74,1913,14811,13034,1777,7582,6202,1380,1304,384,91,5803
1/1/2018,VA,Virginia,Staunton City,51790,6180,5439,741,5155,26,5129,1025,15,1010,5794,5053,741,4556,3976,580,1041,153,63,3299
1/1/2018,VA,Virginia,Suffolk City,51800,15843,12720,3123,13075,115,12960,2768,102,2666,14462,11339,3123,10021,7262,2759,2614,485,121,6801
1/1/2018,VA,Virginia,Surry,51181,1566,1235,331,1334,12,1322,232,*,*,1452,1121,331,1062,761,301,199,64,12,787
1/1/2018,VA,Virginia,Sussex,51183,2371,1871,500,1956,33,1923,415,*,*,2206,1706,500,1695,1233,462,459,136,24,1076
1/1/2018,VA,Virginia,Tazewell,51185,11989,8166,3823,8916,45,8871,3073,41,3032,11353,7531,3822,9063,6545,2518,2237,462,188,6176
1/1/2018,VA,Virginia,Unknown,51999,*,*,*,*,*,*,*,*,*,*,*,*,*,*,*,*,*,*,*
1/1/2018,VA,Virginia,Virginia Beach City,51810,69963,57704,12259,61915,416,61499,8048,328,7720,64061,51809,12252,36902,26077,10825,6609,1538,395,28360
1/1/2018,VA,Virginia,Warren,51187,7418,6596,822,6394,28,6366,1024,32,992,6754,5932,822,4599,3977,622,855,245,74,3425
1/1/2018,VA,Virginia,Washington,51191,14943,9662,5281,12111,46,12065,2832,30,2802,14078,8798,5280,11551,6816,4735,2387,560,181,8423
1/1/2018,VA,Virginia,Waynesboro City,51820,4744,4144,600,3915,22,3893,829,25,804,4427,3827,600,3506,3017,489,859,113,40,2494
1/1/2018,VA,Virginia,Westmoreland,51193,4894,4310,584,4321,27,4294,573,12,561,4451,3867,584,2850,2399,451,712,142,53,1943
1/1/2018,VA,Virginia,Williamsburg City,51830,2562,2187,375,2359,*,*,203,11,192,2366,1991,375,1671,1368,303,220,*,*,1413
1/1/2018,VA,Virginia,Winchester City,51840,5138,4534,604,4392,22,4370,746,19,727,4655,4051,604,3381,2929,452,811,138,54,2378
1/1/2018,VA,Virginia,Wise,51195,10621,6589,4032,7248,32,7216,3373,24,3349,10031,5999,4032,7997,4341,3656,2402,482,177,4936
1/1/2018,VA,Virginia,Wythe,51197,7604,5832,1772,5940,34,5906,1664,25,1639,7178,5407,1771,5824,4328,1496,1519,285,102,3918
1/1/2018,VA,Virginia,York,51199,11672,10108,1564,10709,44,10665,963,33,930,10705,9141,1564,5772,4474,1298,664,177,42,4889
7/1/2018,VA,Virginia,Accomack,51001,8756,7310,1446,7566,42,7524,1190,45,1145,8125,6679,1446,5932,4804,1128,1480,367,92,3993
7/1/2018,VA,Virginia,Albemarle,51003,20606,18356,2250,19034,53,18981,1572,52,1520,18502,16254,2248,14146,12260,1886,1545,301,94,12206
7/1/2018,VA,Virginia,Alexandria City,51510,17798,15095,2703,16390,74,16316,1408,85,1323,14370,11669,2701,8696,6303,2393,2146,308,64,6178
7/1/2018,VA,Virginia,Alleghany,51005,4511,3912,599,3648,22,3626,863,14,849,4291,3692,599,3427,2974,453,794,100,53,2480
7/1/2018,VA,Virginia,Amelia,51007,3055,2341,714,2591,*,*,464,15,449,2823,2109,714,2239,1585,654,474,95,33,1637
7/1/2018,VA,Virginia,Amherst,51009,7807,6421,1386,6510,48,6462,1297,28,1269,7262,5876,1386,5847,4659,1188,1231,228,77,4311
7/1/2018,VA,Virginia,Appomattox,51011,3847,3192,655,3171,16,3155,676,20,656,3628,2973,655,2917,2351,566,677,106,37,2097
7/1/2018,VA,Virginia,Arlington,51013,24170,20932,3238,22586,94,22492,1584,85,1499,19091,15853,3238,11529,8642,2887,3002,351,106,8070
7/1/2018,VA,Virginia,Augusta,51015,18187,15703,2484,15761,55,15706,2426,47,2379,17064,14580,2484,13068,11094,1974,1853,420,138,10657
7/1/2018,VA,Virginia,Bath,51017,1259,1160,99,1110,*,*,149,*,*,1192,1093,99,930,848,82,162,37,22,709
7/1/2018,VA,Virginia,Bedford,51019,19763,16259,3504,16962,86,16876,2801,57,2744,18421,14919,3502,14327,11875,2452,2003,499,149,11676
7/1/2018,VA,Virginia,Bland,51021,1791,1371,420,1405,*,*,386,*,*,1686,1266,420,1277,1041,236,239,55,16,967
7/1/2018,VA,Virginia,Botetourt,51023,8610,6622,1988,7517,47,7470,1093,17,1076,7996,6008,1988,6278,4644,1634,789,190,51,5248
7/1/2018,VA,Virginia,Bristol City,51520,4534,2566,1968,3521,11,3510,1013,19,994,4271,2303,1968,3601,1717,1884,1086,149,53,2313
7/1/2018,VA,Virginia,Brunswick,51025,3985,3294,691,3309,27,3282,676,22,654,3713,3022,691,2929,2346,583,1079,115,38,1697
7/1/2018,VA,Virginia,Buchanan,51027,7292,4209,3083,4628,16,4612,2664,17,2647,7045,3962,3083,5890,3678,2212,1652,405,108,3725
7/1/2018,VA,Virginia,Buckingham,51029,3510,2963,547,2873,21,2852,637,22,615,3276,2729,547,2509,2199,310,737,151,48,1573
7/1/2018,VA,Virginia,Buena Vista City,51530,1457,1205,252,1184,*,*,273,*,*,1364,1112,252,1071,869,202,321,54,21,675
7/1/2018,VA,Virginia,Campbell,51031,12676,10468,2208,10545,72,10473,2131,66,2065,11886,9678,2208,9604,7712,1892,2065,364,157,7018
7/1/2018,VA,Virginia,Caroline,51033,5827,4797,1030,4879,37,4842,948,36,912,5261,4231,1030,3572,2686,886,827,214,49,2482
7/1/2018,VA,Virginia,Carroll,51035,8091,6790,1301,6623,20,6603,1468,*,*,7652,6351,1301,5993,4989,1004,1567,268,100,4058
7/1/2018,VA,Virginia,Charles City,51036,1906,1489,417,1619,19,1600,287,16,271,1750,1333,417,1344,994,350,268,83,15,978
7/1/2018,VA,Virginia,Charlotte,51037,3327,2766,561,2710,15,2695,617,18,599,3142,2581,561,2470,1986,484,769,125,49,1527
7/1/2018,VA,Virginia,Charlottesville City,51540,6253,5584,669,5199,26,5173,1054,38,1016,5610,4942,668,4481,3871,610,1224,152,47,3058
7/1/2018,VA,Virginia,Chesapeake City,51550,37741,29922,7819,32512,293,32219,5229,227,5002,34193,26375,7818,21051,14191,6860,4219,921,231,15680
7/1/2018,VA,Virginia,Chesterfield,51041,59345,45069,14276,51893,236,51657,7452,266,7186,53597,39324,14273,41345,28745,12600,5517,1038,254,34536
7/1/2018,VA,Virginia,Clarke,51043,3295,2898,397,3039,12,3027,256,*,*,2977,2580,397,2024,1724,300,275,73,26,1650
7/1/2018,VA,Virginia,Colonial Heights City,51570,4169,3505,664,3558,*,*,611,15,596,3831,3167,664,2502,1934,568,507,110,23,1862
7/1/2018,VA,Virginia,Covington City,51580,1658,1454,204,1279,12,1267,379,*,*,1544,1341,203,1241,1060,181,354,60,15,812
7/1/2018,VA,Virginia,Craig,51045,1339,1043,296,1043,*,*,296,0,296,1231,935,296,977,709,268,203,46,11,717
7/1/2018,VA,Virginia,Culpeper,51047,9372,7940,1432,8138,40,8098,1234,47,1187,8498,7068,1430,5941,4849,1092,1219,237,79,4406
7/1/2018,VA,Virginia,Cumberland,51049,2260,1763,497,1888,*,*,372,*,*,2108,1611,497,1649,1217,432,415,91,31,1112
7/1/2018,VA,Virginia,Danville City,51590,11171,8637,2534,8811,87,8724,2360,120,2240,10508,7974,2534,8762,6990,1772,3266,408,159,4929
7/1/2018,VA,Virginia,Dickenson,51051,4747,2732,2015,3019,*,*,1728,*,*,4553,2538,2015,3754,1964,1790,1132,206,79,2337
7/1/2018,VA,Virginia,Dinwiddie,51053,5885,4676,1209,4746,35,4711,1139,31,1108,5411,4202,1209,4013,2892,1121,914,196,51,2852
7/1/2018,VA,Virginia,Emporia City,51595,1154,869,285,881,16,865,273,*,*,1077,792,285,880,648,232,417,*,*,387
7/1/2018,VA,Virginia,Essex,51057,2927,2377,550,2513,13,2500,414,12,402,2726,2176,550,2046,1639,407,444,82,24,1496
7/1/2018,VA,Virginia,Fairfax,51059,149282,123937,25345,141060,569,140491,8222,464,7758,120771,95453,25318,70857,49543,21314,13873,2656,518,53810
7/1/2018,VA,Virginia,Fairfax City,51600,3805,3090,715,3546,13,3533,259,15,244,3181,2466,715,1958,1398,560,365,66,12,1515
7/1/2018,VA,Virginia,Falls Church City,51610,2005,1691,314,1920,*,*,85,0,85,1566,1252,314,966,695,271,128,*,*,821
7/1/2018,VA,Virginia,Fauquier,51061,12499,11148,1351,11409,63,11346,1090,38,1052,11105,9754,1351,7110,6164,946,987,183,62,5878
7/1/2018,VA,Virginia,Floyd,51063,4042,3268,774,3497,17,3480,545,*,*,3779,3005,774,2986,2274,712,572,98,43,2273
7/1/2018,VA,Virginia,Fluvanna,51065,5845,5100,745,5261,19,5242,584,18,566,5354,4609,745,3920,3320,600,546,111,25,3238
7/1/2018,VA,Virginia,Franklin,51067,14568,10659,3909,12242,46,12196,2326,31,2295,13714,9805,3909,11133,7649,3484,2002,475,155,8501
7/1/2018,VA,Virginia,Franklin City,51620,1979,1651,328,1548,20,1528,431,24,407,1850,1522,328,1511,1214,297,580,62,13,856
7/1/2018,VA,Virginia,Frederick,51069,16386,14358,2028,14576,55,14521,1810,62,1748,14940,12915,2025,10290,8765,1525,1493,357,126,8314
7/1/2018,VA,Virginia,Fredericksburg City,51630,4023,3523,500,3312,24,3288,711,23,688,3594,3094,500,2490,2058,432,791,94,38,1567
7/1/2018,VA,Virginia,Galax City,51640,1844,1679,165,1472,*,*,372,11,361,1733,1568,165,1384,1261,123,591,54,21,718
7/1/2018,VA,Virginia,Giles,51071,4602,3596,1006,3671,21,3650,931,17,914,4350,3345,1005,3574,2999,575,814,123,40,2597
7/1/2018,VA,Virginia,Gloucester,51073,8485,7069,1416,7298,38,7260,1187,24,1163,7838,6422,1416,5050,3857,1193,1002,174,40,3834
7/1/2018,VA,Virginia,Goochland,51075,5763,4545,1218,5267,27,5240,496,18,478,5228,4011,1217,4285,3314,971,403,100,32,3750
7/1/2018,VA,Virginia,Grayson,51077,4679,3881,798,3875,*,*,804,11,793,4451,3653,798,3406,2732,674,989,181,90,2146
7/1/2018,VA,Virginia,Greene,51079,3783,3315,468,3312,16,3296,471,*,*,3449,2981,468,2490,2085,405,457,87,26,1920
7/1/2018,VA,Virginia,Greensville,51081,2463,1844,619,1985,23,1962,478,17,461,2307,1688,619,1848,1376,472,503,122,30,1193
7/1/2018,VA,Virginia,Halifax,51083,9651,8123,1528,7912,72,7840,1739,52,1687,9077,7549,1528,7315,5983,1332,2123,439,149,4604
7/1/2018,VA,Virginia,Hampton City,51650,24881,18620,6261,20494,196,20298,4387,204,4183,22750,16489,6261,13932,8110,5822,3764,776,171,9221
7/1/2018,VA,Virginia,Hanover,51085,20706,15707,4999,18836,88,18748,1870,51,1819,18915,13917,4998,15232,11175,4057,1432,342,93,13365
7/1/2018,VA,Virginia,Harrisonburg City,51660,5363,4745,618,4542,16,4526,821,20,801,4864,4246,618,3866,3431,435,995,140,27,2704
7/1/2018,VA,Virginia,Henrico,51087,55963,41247,14716,49061,331,48730,6902,282,6620,50653,35938,14715,41101,28437,12664,6461,1393,390,32857
7/1/2018,VA,Virginia,Henry,51089,15027,10965,4062,11964,71,11893,3063,58,3005,14302,10240,4062,12090,8401,3689,3063,707,245,8075
7/1/2018,VA,Virginia,Highland,51091,782,711,71,714,*,*,68,*,*,732,661,71,546,487,59,54,*,*,461
7/1/2018,VA,Virginia,Hopewell City,51670,4521,3537,984,3505,31,3474,1016,31,985,4217,3233,984,2923,1987,936,1009,159,29,1726
7/1/2018,VA,Virginia,Isle of Wight,51093,8197,6490,1707,7215,49,7166,982,37,945,7590,5883,1707,5364,3828,1536,945,202,68,4149
7/1/2018,VA,Virginia,James City,51095,20384,17662,2722,19175,62,19113,1209,56,1153,18886,16167,2719,12094,10064,2030,843,220,58,10973
7/1/2018,VA,Virginia,King and Queen,51097,1757,1461,296,1482,14,1468,275,*,*,1636,1340,296,1216,964,252,269,68,11,868
7/1/2018,VA,Virginia,King George,51099,3853,3472,381,3333,14,3319,520,26,494,3347,2966,381,1663,1355,308,454,68,16,1125
7/1/2018,VA,Virginia,King William,51101,3390,2864,526,2904,26,2878,486,19,467,3113,2587,526,2502,2066,436,397,113,20,1972
7/1/2018,VA,Virginia,Lancaster,51103,4321,3726,595,3980,19,3961,341,16,325,4110,3515,595,2996,2629,367,503,101,15,2377
7/1/2018,VA,Virginia,Lee,51105,6459,3756,2703,4470,19,4451,1989,13,1976,6145,3444,2701,5008,2500,2508,1954,259,85,2710
7/1/2018,VA,Virginia,Lexington City,51678,1654,1496,158,1525,12,1513,129,*,*,1530,1372,158,1170,1049,121,208,34,11,917
7/1/2018,VA,Virginia,Loudoun,51107,36905,30749,6156,34486,152,34334,2419,113,2306,30677,24524,6153,20246,15074,5172,3112,639,143,16352
7/1/2018,VA,Virginia,Louisa,51109,8024,6536,1488,6772,40,6732,1252,34,1218,7347,5859,1488,5411,4146,1265,1068,241,63,4039
7/1/2018,VA,Virginia,Lunenburg,51111,3023,2623,400,2472,21,2451,551,17,534,2801,2401,400,2120,1776,344,708,110,42,1260
7/1/2018,VA,Virginia,Lynchburg City,51680,14623,12139,2484,11994,88,11906,2629,106,2523,13589,11105,2484,11002,8846,2156,2984,447,130,7441
7/1/2018,VA,Virginia,Madison,51113,2978,2546,432,2654,11,2643,324,13,311,2785,2353,432,2072,1740,332,389,87,21,1575
7/1/2018,VA,Virginia,Manassas City,51683,4474,3625,849,3945,23,3922,529,42,487,3777,2928,849,2602,1878,724,514,88,41,1959
7/1/2018,VA,Virginia,Manassas Park City,51685,1317,1010,307,1143,15,1128,174,12,162,1115,809,306,774,502,272,196,*,*,527
7/1/2018,VA,Virginia,Martinsville City,51690,3958,3004,954,2937,36,2901,1021,41,980,3743,2789,954,3219,2318,901,1331,162,62,1664
7/1/2018,VA,Virginia,Mathews,51115,2842,2383,459,2619,*,*,223,*,*,2700,2241,459,1898,1530,368,270,39,19,1570
7/1/2018,VA,Virginia,Mecklenburg,51117,9127,7414,1713,7588,67,7521,1539,60,1479,8590,6877,1713,6758,5374,1384,1858,365,101,4434
7/1/2018,VA,Virginia,Middlesex,51119,3593,3048,545,3227,15,3212,366,*,*,3387,2842,545,2574,2181,393,454,81,28,2011
7/1/2018,VA,Virginia,Montgomery,51121,13891,11390,2501,11601,43,11558,2290,28,2262,12583,10082,2501,10366,8132,2234,1894,356,116,8000
7/1/2018,VA,Virginia,Nelson,51125,4626,3982,644,4117,18,4099,509,*,*,4257,3614,643,3111,2569,542,583,103,42,2383
7/1/2018,VA,Virginia,New Kent,51127,4472,3660,812,4017,18,3999,455,*,*,4078,3266,812,2863,2249,614,291,72,14,2486
7/1/2018,VA,Virginia,Newport News City,51700,27999,20834,7165,23020,212,22808,4979,244,4735,25642,18479,7163,16754,10031,6723,4771,895,226,10862
7/1/2018,VA,Virginia,Norfolk City,51710,32731,24493,8238,26215,270,25945,6516,338,6178,29483,21245,8238,19942,12204,7738,7241,1331,294,11076
7/1/2018,VA,Virginia,Northampton,51131,3640,3013,627,3127,20,3107,513,23,490,3404,2777,627,2717,2201,516,925,90,27,1675
7/1/2018,VA,Virginia,Northumberland,51133,4621,3987,634,4293,17,4276,328,13,315,4314,3680,634,2868,2513,355,420,83,28,2337
7/1/2018,VA,Virginia,Norton City,51720,1186,775,411,809,*,*,377,*,*,1097,686,411,895,531,364,358,51,15,471
7/1/2018,VA,Virginia,Nottoway,51135,3656,3067,589,2997,26,2971,659,17,642,3397,2808,589,2658,2262,396,894,128,42,1594
7/1/2018,VA,Virginia,Orange,51137,8783,7623,1160,7752,46,7706,1031,33,998,8065,6905,1160,5350,4588,762,983,210,65,4092
7/1/2018,VA,Virginia,Page,51139,6176,5326,850,5078,23,5055,1098,23,1075,5801,4951,850,4245,3544,701,1117,245,75,2808
7/1/2018,VA,Virginia,Patrick,51141,5151,3927,1224,4299,*,*,852,*,*,4889,3667,1222,3995,2992,1003,1018,186,67,2724
7/1/2018,VA,Virginia,Petersburg City,51730,7180,5444,1736,5352,98,5254,1828,89,1739,6577,4841,1736,4775,3104,1671,2063,341,65,2306
7/1/2018,VA,Virginia,Pittsylvania,51143,16218,12316,3902,13311,85,13226,2907,82,2825,15259,11357,3902,12521,9706,2815,3051,548,205,8717
7/1/2018,VA,Virginia,Poquoson City,51735,2518,2211,307,2339,*,*,179,*,*,2321,2014,307,1184,920,264,100,19,14,1051
7/1/2018,VA,Virginia,Portsmouth City,51740,18092,13577,4515,14112,182,13930,3980,213,3767,16189,11676,4513,10773,6524,4249,3858,707,144,6064
7/1/2018,VA,Virginia,Powhatan,51145,5901,4690,1211,5295,20,5275,606,18,588,5414,4203,1211,4343,3322,1021,400,115,28,3800
7/1/2018,VA,Virginia,Prince Edward,51147,4668,3909,759,3752,35,3717,916,35,881,4326,3567,759,3338,2790,548,1099,168,50,2021
7/1/2018,VA,Virginia,Prince George,51149,5913,5105,808,5007,27,4980,906,37,869,5480,4672,808,3329,2631,698,560,124,30,2615
7/1/2018,VA,Virginia,Prince William,51153,47926,39152,8774,42846,287,42559,5080,302,4778,40945,32175,8770,23696,16003,7693,5177,1053,214,17252
7/1/2018,VA,Virginia,Pulaski,51155,9103,7270,1833,7282,32,7250,1821,31,1790,8511,6678,1833,6959,5382,1577,1627,304,114,4914
7/1/2018,VA,Virginia,Radford City,51750,2037,1678,359,1656,*,*,381,*,*,1866,1507,359,1567,1245,322,331,42,24,1170
7/1/2018,VA,Virginia,Rappahannock,51157,2020,1826,194,1880,*,*,140,*,*,1834,1641,193,1240,1110,130,147,*,*,1052
7/1/2018,VA,Virginia,Richmond,51159,2030,1638,392,1769,*,*,261,13,248,1887,1495,392,1411,1162,249,307,71,16,1017
7/1/2018,VA,Virginia,Richmond City,51760,33879,23012,10867,26811,280,26531,7068,353,6715,30532,19665,10867,25732,15484,10248,8828,1412,295,15197
7/1/2018,VA,Virginia,Roanoke,51161,23558,18217,5341,20966,98,20868,2592,62,2530,21844,16505,5339,17511,13086,4425,2012,443,132,14924
7/1/2018,VA,Virginia,Roanoke City,51770,20558,14950,5608,15532,130,15402,5026,157,4869,18721,13117,5604,15200,10097,5103,4823,872,213,9292
7/1/2018,VA,Virginia,Rockbridge,51163,5987,5115,872,5103,17,5086,884,11,873,5567,4695,872,4161,3457,704,807,185,60,3109
7/1/2018,VA,Virginia,Rockingham,51165,17367,14887,2480,15241,44,15197,2126,41,2085,16068,13589,2479,12499,10780,1719,1804,498,145,10052
7/1/2018,VA,Virginia,Russell,51167,7872,4894,2978,5470,11,5459,2402,16,2386,7537,4559,2978,6416,4036,2380,1654,324,136,4302
7/1/2018,VA,Virginia,Salem City,51775,6147,4890,1257,5203,27,5176,944,17,927,5677,4420,1257,4524,3433,1091,854,146,40,3484
7/1/2018,VA,Virginia,Scott,51169,6635,3210,3425,5006,11,4995,1629,16,1613,6371,2946,3425,5535,2210,3325,1523,245,105,3662
7/1/2018,VA,Virginia,Shenandoah,51171,10484,9152,1332,9297,30,9267,1187,28,1159,9799,8467,1332,6899,5892,1007,1257,262,85,5295
7/1/2018,VA,Virginia,Smyth,51173,8820,6499,2321,6615,31,6584,2205,28,2177,8339,6018,2321,6836,4755,2081,2163,417,124,4132
7/1/2018,VA,Virginia,Southampton,51175,4103,3459,644,3452,34,3418,651,19,632,3817,3173,644,2980,2434,546,698,117,31,2134
7/1/2018,VA,Virginia,Spotsylvania,51177,20737,18137,2600,18061,115,17946,2676,100,2576,18467,15868,2599,11102,9096,2006,1986,519,131,8466
7/1/2018,VA,Virginia,Stafford,51179,17208,15404,1804,15140,97,15043,2068,77,1991,15110,13308,1802,7641,6227,1414,1383,378,85,5795
7/1/2018,VA,Virginia,Staunton City,51790,6231,5454,777,5177,24,5153,1054,14,1040,5858,5081,777,4596,3980,616,1085,150,59,3302
7/1/2018,VA,Virginia,Suffolk City,51800,16048,12737,3311,13205,105,13100,2843,101,2742,14684,11373,3311,10093,7130,2963,2708,458,118,6809
7/1/2018,VA,Virginia,Surry,51181,1590,1255,335,1346,11,1335,244,*,*,1464,1129,335,1062,756,306,210,64,13,775
7/1/2018,VA,Virginia,Sussex,51183,2392,1856,536,1962,29,1933,430,*,*,2223,1687,536,1686,1187,499,468,134,22,1062
7/1/2018,VA,Virginia,Tazewell,51185,12030,8137,3893,8896,42,8854,3134,39,3095,11378,7486,3892,9067,6455,2612,2283,459,185,6140
7/1/2018,VA,Virginia,Unknown,51999,*,*,*,*,*,*,*,*,*,*,*,*,*,*,*,*,*,*,*
7/1/2018,VA,Virginia,Virginia Beach City,51810,71127,58414,12713,62787,386,62401,8340,337,8003,65194,52488,12706,37439,26145,11294,6852,1498,379,28710
7/1/2018,VA,Virginia,Warren,51187,7512,6658,854,6459,24,6435,1053,31,1022,6856,6002,854,4633,3987,646,911,230,70,3422
7/1/2018,VA,Virginia,Washington,51191,15027,9655,5372,12146,42,12104,2881,29,2852,14181,8810,5371,11618,6765,4853,2443,539,188,8448
7/1/2018,VA,Virginia,Waynesboro City,51820,4761,4123,638,3913,21,3892,848,25,823,4451,3813,638,3505,2977,528,884,110,38,2473
7/1/2018,VA,Virginia,Westmoreland,51193,4975,4359,616,4375,25,4350,600,12,588,4546,3930,616,2886,2404,482,750,132,46,1958
7/1/2018,VA,Virginia,Williamsburg City,51830,2591,2201,390,2373,*,*,218,12,206,2392,2002,390,1684,1365,319,228,*,*,1422
7/1/2018,VA,Virginia,Winchester City,51840,5180,4553,627,4427,22,4405,753,16,737,4700,4073,627,3394,2919,475,834,138,48,2374
7/1/2018,VA,Virginia,Wise,51195,10685,6492,4193,7208,24,7184,3477,24,3453,10119,5926,4193,8045,4223,3822,2447,464,171,4963
7/1/2018,VA,Virginia,Wythe,51197,7661,5823,1838,5980,28,5952,1681,23,1658,7244,5407,1837,5832,4256,1576,1553,277,105,3897
7/1/2018,VA,Virginia,York,51199,11828,10231,1597,10845,39,10806,983,29,954,10830,9233,1597,5799,4462,1337,681,170,41,4907
6/1/2018,VA,Virginia,Accomack,51001,8729,7288,1441,7545,43,7502,1184,46,1138,8086,6645,1441,5922,4797,1125,1470,369,91,3992
6/1/2018,VA,Virginia,Albemarle,51003,20541,18313,2228,18974,54,18920,1567,52,1515,18400,16174,2226,14120,12241,1879,1544,303,94,12179
6/1/2018,VA,Virginia,Alexandria City,51510,17723,15051,2672,16321,75,16246,1402,84,1318,14201,11531,2670,8656,6283,2373,2133,309,62,6152
6/1/2018,VA,Virginia,Alleghany,51005,4509,3909,600,3646,24,3622,863,14,849,4277,3677,600,3416,2964,452,792,101,53,2470
6/1/2018,VA,Virginia,Amelia,51007,3044,2334,710,2585,*,*,459,14,445,2811,2101,710,2235,1586,649,470,97,33,1635
6/1/2018,VA,Virginia,Amherst,51009,7778,6395,1383,6490,48,6442,1288,28,1260,7216,5833,1383,5825,4639,1186,1222,232,76,4295
6/1/2018,VA,Virginia,Appomattox,51011,3850,3197,653,3176,16,3160,674,21,653,3622,2969,653,2917,2353,564,676,106,38,2097
6/1/2018,VA,Virginia,Arlington,51013,24080,20877,3203,22500,94,22406,1580,86,1494,18905,15702,3203,11471,8606,2865,2988,351,102,8030
6/1/2018,VA,Virginia,Augusta,51015,18144,15671,2473,15728,57,15671,2416,46,2370,17005,14532,2473,13028,11062,1966,1848,421,138,10621
6/1/2018,VA,Virginia,Bath,51017,1260,1161,99,1110,*,*,150,*,*,1192,1093,99,932,849,83,164,37,22,709
6/1/2018,VA,Virginia,Bedford,51019,19720,16234,3486,16929,88,16841,2791,58,2733,18352,14868,3484,14283,11842,2441,1998,501,148,11636
6/1/2018,VA,Virginia,Bland,51021,1785,1366,419,1402,*,*,383,*,*,1681,1262,419,1275,1041,234,235,56,16,968
6/1/2018,VA,Virginia,Botetourt,51023,8600,6627,1973,7509,48,7461,1091,17,1074,7971,5998,1973,6250,4632,1618,782,191,51,5226
6/1/2018,VA,Virginia,Bristol City,51520,4531,2574,1957,3518,12,3506,1013,19,994,4257,2300,1957,3593,1719,1874,1075,155,53,2310
6/1/2018,VA,Virginia,Brunswick,51025,3979,3294,685,3302,28,3274,677,21,656,3701,3016,685,2923,2346,577,1080,114,37,1692
6/1/2018,VA,Virginia,Buchanan,51027,7291,4217,3074,4632,17,4615,2659,16,2643,7030,3956,3074,5882,3680,2202,1650,405,107,3720
6/1/2018,VA,Virginia,Buckingham,51029,3503,2958,545,2870,21,2849,633,22,611,3262,2717,545,2510,2202,308,733,155,48,1574
6/1/2018,VA,Virginia,Buena Vista City,51530,1453,1205,248,1179,*,*,274,*,*,1357,1109,248,1069,871,198,318,56,21,674
6/1/2018,VA,Virginia,Campbell,51031,12643,10452,2191,10528,75,10453,2115,66,2049,11839,9648,2191,9581,7706,1875,2044,372,164,7001
6/1/2018,VA,Virginia,Caroline,51033,5795,4767,1028,4853,38,4815,942,37,905,5218,4190,1028,3566,2681,885,819,219,50,2478
6/1/2018,VA,Virginia,Carroll,51035,8080,6786,1294,6625,20,6605,1455,*,*,7615,6321,1294,5975,4977,998,1557,269,100,4049
6/1/2018,VA,Virginia,Charles City,51036,1904,1489,415,1619,19,1600,285,15,270,1745,1330,415,1343,995,348,267,82,17,977
6/1/2018,VA,Virginia,Charlotte,51037,3319,2756,563,2704,15,2689,615,18,597,3131,2568,563,2459,1974,485,766,125,49,1519
6/1/2018,VA,Virginia,Charlottesville City,51540,6234,5581,653,5182,27,5155,1052,38,1014,5574,4922,652,4465,3865,600,1219,150,48,3048
6/1/2018,VA,Virginia,Chesapeake City,51550,37562,29835,7727,32357,294,32063,5205,225,4980,33906,26180,7726,20928,14161,6767,4179,931,230,15588
6/1/2018,VA,Virginia,Chesterfield,51041,59111,44951,14160,51686,236,51450,7425,266,7159,53213,39056,14157,41110,28610,12500,5485,1038,255,34332
6/1/2018,VA,Virginia,Clarke,51043,3277,2874,403,3023,12,3011,254,*,*,2950,2547,403,2020,1714,306,273,73,26,1648
6/1/2018,VA,Virginia,Colonial Heights City,51570,4164,3505,659,3558,11,3547,606,15,591,3817,3158,659,2495,1933,562,504,111,22,1858
6/1/2018,VA,Virginia,Covington City,51580,1655,1452,203,1276,12,1264,379,*,*,1536,1334,202,1238,1057,181,353,60,15,810
6/1/2018,VA,Virginia,Craig,51045,1337,1042,295,1041,*,*,296,0,296,1228,933,295,975,708,267,203,45,11,716
6/1/2018,VA,Virginia,Culpeper,51047,9350,7935,1415,8125,41,8084,1225,46,1179,8449,7036,1413,5927,4850,1077,1219,237,78,4393
6/1/2018,VA,Virginia,Cumberland,51049,2260,1764,496,1889,*,*,371,*,*,2102,1606,496,1649,1217,432,419,91,31,1108
6/1/2018,VA,Virginia,Danville City,51590,11157,8645,2512,8813,90,8723,2344,119,2225,10485,7973,2512,8759,7005,1754,3262,413,156,4928
6/1/2018,VA,Virginia,Dickenson,51051,4745,2743,2002,3020,*,*,1725,*,*,4542,2540,2002,3747,1968,1779,1131,202,79,2335
6/1/2018,VA,Virginia,Dinwiddie,51053,5860,4651,1209,4730,36,4694,1130,31,1099,5373,4164,1209,3996,2876,1120,909,195,52,2840
6/1/2018,VA,Virginia,Emporia City,51595,1148,867,281,879,16,863,269,*,*,1066,785,281,876,648,228,416,*,*,383
6/1/2018,VA,Virginia,Essex,51057,2918,2366,552,2507,13,2494,411,12,399,2714,2162,552,2043,1634,409,436,85,25,1497
6/1/2018,VA,Virginia,Fairfax,51059,148572,123492,25080,140385,574,139811,8187,464,7723,119451,94398,25053,70493,49392,21101,13790,2651,515,53537
6/1/2018,VA,Virginia,Fairfax City,51600,3787,3081,706,3529,13,3516,258,14,244,3149,2443,706,1944,1393,551,362,67,12,1503
6/1/2018,VA,Virginia,Falls Church City,51610,1997,1686,311,1911,*,*,86,0,86,1545,1234,311,962,694,268,125,*,*,819
6/1/2018,VA,Virginia,Fauquier,51061,12443,11096,1347,11356,64,11292,1087,39,1048,11027,9680,1347,7081,6138,943,986,185,62,5848
6/1/2018,VA,Virginia,Floyd,51063,4021,3253,768,3475,17,3458,546,*,*,3753,2985,768,2972,2266,706,570,97,43,2262
6/1/2018,VA,Virginia,Fluvanna,51065,5824,5093,731,5244,19,5225,580,20,560,5325,4594,731,3898,3309,589,538,111,25,3224
6/1/2018,VA,Virginia,Franklin,51067,14559,10674,3885,12239,47,12192,2320,31,2289,13688,9803,3885,11110,7650,3460,1996,478,154,8482
6/1/2018,VA,Virginia,Franklin City,51620,1978,1648,330,1546,20,1526,432,24,408,1842,1512,330,1505,1206,299,573,65,13,854
6/1/2018,VA,Virginia,Frederick,51069,16351,14326,2025,14543,56,14487,1808,62,1746,14865,12843,2022,10259,8735,1524,1491,354,127,8287
6/1/2018,VA,Virginia,Fredericksburg City,51630,4005,3515,490,3299,24,3275,706,23,683,3566,3076,490,2485,2062,423,787,95,40,1563
6/1/2018,VA,Virginia,Galax City,51640,1847,1684,163,1475,*,*,372,11,361,1733,1570,163,1386,1265,121,593,53,22,718
6/1/2018,VA,Virginia,Giles,51071,4609,3595,1014,3676,21,3655,933,17,916,4341,3328,1013,3572,2993,579,814,122,40,2596
6/1/2018,VA,Virginia,Gloucester,51073,8450,7031,1419,7267,39,7228,1183,25,1158,7793,6374,1419,5022,3827,1195,992,174,42,3814
6/1/2018,VA,Virginia,Goochland,51075,5720,4510,1210,5229,28,5201,491,18,473,5182,3973,1209,4253,3287,966,401,100,31,3721
6/1/2018,VA,Virginia,Grayson,51077,4686,3891,795,3881,*,*,805,11,794,4451,3656,795,3407,2739,668,994,180,90,2143
6/1/2018,VA,Virginia,Greene,51079,3768,3305,463,3298,16,3282,470,*,*,3434,2971,463,2476,2074,402,457,87,26,1906
6/1/2018,VA,Virginia,Greensville,51081,2451,1837,614,1975,23,1952,476,17,459,2289,1675,614,1843,1374,469,502,122,29,1190
6/1/2018,VA,Virginia,Halifax,51083,9639,8128,1511,7902,73,7829,1737,53,1684,9049,7538,1511,7307,5989,1318,2120,441,149,4597
6/1/2018,VA,Virginia,Hampton City,51650,24803,18616,6187,20445,199,20246,4358,201,4157,22608,16421,6187,13886,8136,5750,3725,782,172,9207
6/1/2018,VA,Virginia,Hanover,51085,20636,15653,4983,18771,89,18682,1865,51,1814,18805,13823,4982,15171,11131,4040,1424,342,93,13312
6/1/2018,VA,Virginia,Harrisonburg City,51660,5354,4735,619,4539,16,4523,815,20,795,4848,4229,619,3859,3425,434,992,143,27,2697
6/1/2018,VA,Virginia,Henrico,51087,55774,41137,14637,48897,338,48559,6877,283,6594,50359,35723,14636,40929,28336,12593,6405,1393,389,32742
6/1/2018,VA,Virginia,Henry,51089,15012,10967,4045,11957,72,11885,3055,58,2997,14269,10224,4045,12063,8393,3670,3035,710,249,8069
6/1/2018,VA,Virginia,Highland,51091,781,710,71,713,*,*,68,*,*,729,658,71,545,486,59,53,*,*,461
6/1/2018,VA,Virginia,Hopewell City,51670,4515,3535,980,3497,31,3466,1018,32,986,4198,3218,980,2914,1982,932,1000,161,30,1723
6/1/2018,VA,Virginia,Isle of Wight,51093,8161,6457,1704,7190,49,7141,971,37,934,7553,5849,1704,5355,3821,1534,944,203,69,4139
6/1/2018,VA,Virginia,James City,51095,20331,17649,2682,19127,63,19064,1204,56,1148,18794,16115,2679,12047,10031,2016,838,218,59,10932
6/1/2018,VA,Virginia,King and Queen,51097,1758,1462,296,1482,15,1467,276,*,*,1637,1341,296,1220,968,252,268,69,11,872
6/1/2018,VA,Virginia,King George,51099,3838,3461,377,3322,15,3307,516,26,490,3317,2940,377,1661,1358,303,449,70,15,1127
6/1/2018,VA,Virginia,King William,51101,3375,2850,525,2889,27,2862,486,19,467,3089,2564,525,2487,2052,435,391,113,20,1963
6/1/2018,VA,Virginia,Lancaster,51103,4317,3740,577,3976,20,3956,341,16,325,4096,3519,577,2994,2638,356,500,102,15,2377
6/1/2018,VA,Virginia,Lee,51105,6450,3765,2685,4462,20,4442,1988,13,1975,6129,3446,2683,5005,2514,2491,1945,261,85,2714
6/1/2018,VA,Virginia,Lexington City,51678,1652,1495,157,1523,13,1510,129,*,*,1525,1368,157,1164,1045,119,210,33,11,910
6/1/2018,VA,Virginia,Loudoun,51107,36751,30659,6092,34348,155,34193,2403,110,2293,30359,24270,6089,20142,15028,5114,3092,641,144,16265
6/1/2018,VA,Virginia,Louisa,51109,7991,6516,1475,6743,41,6702,1248,35,1213,7297,5822,1475,5408,4153,1255,1066,244,64,4034
6/1/2018,VA,Virginia,Lunenburg,51111,3024,2631,393,2474,21,2453,550,17,533,2800,2407,393,2120,1783,337,706,113,42,1259
6/1/2018,VA,Virginia,Lynchburg City,51680,14600,12141,2459,11979,90,11889,2621,106,2515,13531,11072,2459,10960,8826,2134,2970,443,126,7421
6/1/2018,VA,Virginia,Madison,51113,2973,2548,425,2648,12,2636,325,14,311,2770,2345,425,2058,1732,326,390,87,21,1560
6/1/2018,VA,Virginia,Manassas City,51683,4460,3623,837,3932,23,3909,528,43,485,3736,2899,837,2586,1875,711,504,89,40,1953
6/1/2018,VA,Virginia,Manassas Park City,51685,1308,1000,308,1136,15,1121,172,12,160,1101,794,307,777,505,272,194,*,*,531
6/1/2018,VA,Virginia,Martinsville City,51690,3964,3017,947,2948,36,2912,1016,42,974,3737,2790,947,3224,2328,896,1330,163,61,1670
6/1/2018,VA,Virginia,Mathews,51115,2841,2383,458,2618,*,*,223,*,*,2695,2237,458,1889,1523,366,269,39,19,1562
6/1/2018,VA,Virginia,Mecklenburg,51117,9115,7423,1692,7584,69,7515,1531,61,1470,8559,6867,1692,6733,5368,1365,1850,369,104,4410
6/1/2018,VA,Virginia,Middlesex,51119,3577,3039,538,3211,17,3194,366,*,*,3371,2833,538,2572,2185,387,454,84,29,2005
6/1/2018,VA,Virginia,Montgomery,51121,13847,11367,2480,11565,43,11522,2282,28,2254,12506,10026,2480,10309,8098,2211,1878,361,116,7954
6/1/2018,VA,Virginia,Nelson,51125,4607,3969,638,4100,18,4082,507,*,*,4230,3593,637,3095,2557,538,581,101,42,2371
6/1/2018,VA,Virginia,New Kent,51127,4453,3647,806,3999,20,3979,454,*,*,4053,3247,806,2853,2241,612,287,74,14,2478
6/1/2018,VA,Virginia,Newport News City,51700,27892,20787,7105,22935,213,22722,4957,245,4712,25460,18357,7103,16686,10021,6665,4727,902,227,10830
6/1/2018,VA,Virginia,Norfolk City,51710,32637,24487,8150,26151,276,25875,6486,335,6151,29302,21152,8150,19883,12235,7648,7208,1334,293,11048
6/1/2018,VA,Virginia,Northampton,51131,3632,3014,618,3118,20,3098,514,25,489,3388,2770,618,2717,2211,506,929,89,27,1672
6/1/2018,VA,Virginia,Northumberland,51133,4608,3975,633,4280,17,4263,328,13,315,4291,3658,633,2869,2516,353,422,83,28,2336
6/1/2018,VA,Virginia,Norton City,51720,1188,785,403,811,*,*,377,*,*,1098,695,403,895,538,357,359,50,15,471
6/1/2018,VA,Virginia,Nottoway,51135,3654,3072,582,2997,27,2970,657,17,640,3387,2805,582,2647,2257,390,894,129,42,1582
6/1/2018,VA,Virginia,Orange,51137,8758,7610,1148,7729,46,7683,1029,33,996,8020,6872,1148,5322,4566,756,968,212,65,4077
6/1/2018,VA,Virginia,Page,51139,6180,5329,851,5084,23,5061,1096,24,1072,5794,4943,851,4243,3541,702,1115,244,76,2808
6/1/2018,VA,Virginia,Patrick,51141,5147,3930,1217,4297,*,*,850,*,*,4878,3663,1215,3989,2993,996,1015,188,67,2719
6/1/2018,VA,Virginia,Petersburg City,51730,7168,5446,1722,5346,98,5248,1822,87,1735,6537,4815,1722,4764,3106,1658,2043,350,65,2306
6/1/2018,VA,Virginia,Pittsylvania,51143,16180,12301,3879,13290,86,13204,2890,81,2809,15212,11333,3879,12486,9690,2796,3034,551,204,8697
6/1/2018,VA,Virginia,Poquoson City,51735,2509,2204,305,2332,*,*,177,*,*,2310,2005,305,1178,915,263,101,19,13,1045
6/1/2018,VA,Virginia,Portsmouth City,51740,18062,13590,4472,14095,184,13911,3967,212,3755,16108,11638,4470,10742,6536,4206,3830,714,143,6055
6/1/2018,VA,Virginia,Powhatan,51145,5890,4684,1206,5288,20,5268,602,18,584,5392,4186,1206,4327,3313,1014,399,115,28,3785
6/1/2018,VA,Virginia,Prince Edward,51147,4665,3912,753,3752,36,3716,913,35,878,4312,3559,753,3337,2796,541,1095,172,50,2020
6/1/2018,VA,Virginia,Prince George,51149,5879,5075,804,4980,28,4952,899,37,862,5437,4633,804,3310,2612,698,555,123,30,2602
6/1/2018,VA,Virginia,Prince William,51153,47684,39002,8682,42632,291,42341,5052,302,4750,40503,31825,8678,23597,15982,7615,5136,1060,214,17187
6/1/2018,VA,Virginia,Pulaski,51155,9082,7257,1825,7268,32,7236,1814,31,1783,8463,6638,1825,6927,5357,1570,1614,306,115,4892
6/1/2018,VA,Virginia,Radford City,51750,2039,1681,358,1657,11,1646,382,*,*,1861,1503,358,1563,1242,321,325,45,23,1170
6/1/2018,VA,Virginia,Rappahannock,51157,2022,1830,192,1882,*,*,140,*,*,1829,1638,191,1245,1115,130,149,*,*,1055
6/1/2018,VA,Virginia,Richmond,51159,2028,1635,393,1770,*,*,258,13,245,1884,1491,393,1409,1161,248,302,74,17,1016
6/1/2018,VA,Virginia,Richmond City,51760,33817,23054,10763,26757,284,26473,7060,354,6706,30371,19608,10763,25630,15484,10146,8775,1425,291,15139
6/1/2018,VA,Virginia,Roanoke,51161,23517,18189,5328,20938,99,20839,2579,62,2517,21762,16436,5326,17476,13064,4412,2005,447,130,14894
6/1/2018,VA,Virginia,Roanoke City,51770,20506,14948,5558,15495,131,15364,5011,157,4854,18648,13094,5554,15158,10108,5050,4787,871,214,9286
6/1/2018,VA,Virginia,Rockbridge,51163,5977,5110,867,5099,18,5081,878,*,*,5545,4678,867,4152,3448,704,806,183,61,3102
6/1/2018,VA,Virginia,Rockingham,51165,17344,14871,2473,15223,45,15178,2121,41,2080,16007,13535,2472,12460,10748,1712,1797,499,143,10021
6/1/2018,VA,Virginia,Russell,51167,7855,4885,2970,5462,12,5450,2393,16,2377,7511,4541,2970,6412,4036,2376,1657,327,134,4294
6/1/2018,VA,Virginia,Salem City,51775,6139,4890,1249,5201,27,5174,938,17,921,5648,4399,1249,4500,3418,1082,848,145,39,3468
6/1/2018,VA,Virginia,Scott,51169,6634,3229,3405,5009,11,4998,1625,16,1609,6368,2963,3405,5523,2217,3306,1520,243,106,3654
6/1/2018,VA,Virginia,Shenandoah,51171,10450,9125,1325,9273,30,9243,1177,27,1150,9751,8426,1325,6870,5871,999,1252,261,90,5267
6/1/2018,VA,Virginia,Smyth,51173,8820,6521,2299,6622,31,6591,2198,27,2171,8340,6041,2299,6827,4770,2057,2154,418,126,4129
6/1/2018,VA,Virginia,Southampton,51175,4086,3451,635,3439,34,3405,647,17,630,3793,3158,635,2977,2439,538,700,120,33,2124
6/1/2018,VA,Virginia,Spotsylvania,51177,20660,18083,2577,17981,117,17864,2679,101,2578,18336,15760,2576,11065,9071,1994,1971,527,134,8433
6/1/2018,VA,Virginia,Stafford,51179,17132,15333,1799,15076,100,14976,2056,75,1981,14984,13187,1797,7614,6207,1407,1358,379,87,5790
6/1/2018,VA,Virginia,Staunton City,51790,6208,5442,766,5162,25,5137,1046,15,1031,5836,5070,766,4587,3981,606,1082,151,59,3295
6/1/2018,VA,Virginia,Suffolk City,51800,15981,12719,3262,13158,105,13053,2823,103,2720,14568,11306,3262,10041,7127,2914,2684,458,118,6781
6/1/2018,VA,Virginia,Surry,51181,1583,1248,335,1340,11,1329,243,*,*,1458,1123,335,1058,752,306,208,64,13,773
6/1/2018,VA,Virginia,Sussex,51183,2388,1860,528,1957,30,1927,431,*,*,2213,1685,528,1687,1196,491,467,137,22,1061
6/1/2018,VA,Virginia,Tazewell,51185,12016,8143,3873,8898,42,8856,3118,39,3079,11354,7482,3872,9058,6468,2590,2277,458,184,6139
6/1/2018,VA,Virginia,Unknown,51999,*,*,*,*,*,*,*,*,*,*,*,*,*,*,*,*,*,*,*
6/1/2018,VA,Virginia,Virginia Beach City,51810,70839,58249,12590,62551,390,62161,8288,337,7951,64736,52153,12583,37269,26076,11193,6812,1504,375,28578
6/1/2018,VA,Virginia,Warren,51187,7500,6651,849,6449,25,6424,1051,31,1020,6826,5977,849,4633,3988,645,905,231,71,3426
6/1/2018,VA,Virginia,Washington,51191,14994,9656,5338,12127,43,12084,2867,29,2838,14133,8796,5337,11595,6778,4817,2433,538,185,8439
6/1/2018,VA,Virginia,Waynesboro City,51820,4749,4126,623,3909,21,3888,840,24,816,4434,3811,623,3499,2984,515,881,111,39,2468
6/1/2018,VA,Virginia,Westmoreland,51193,4955,4347,608,4360,25,4335,595,12,583,4506,3898,608,2872,2396,476,743,134,46,1949
6/1/2018,VA,Virginia,Williamsburg City,51830,2585,2203,382,2369,*,*,216,11,205,2376,1994,382,1680,1367,313,227,*,*,1419
6/1/2018,VA,Virginia,Winchester City,51840,5166,4539,627,4413,22,4391,753,16,737,4669,4042,627,3377,2901,476,828,136,48,2365
6/1/2018,VA,Virginia,Wise,51195,10671,6511,4160,7212,25,7187,3459,24,3435,10075,5915,4160,8018,4232,3786,2442,464,170,4942
6/1/2018,VA,Virginia,Wythe,51197,7651,5819,1832,5973,30,5943,1678,23,1655,7221,5390,1831,5828,4262,1566,1557,278,101,3892
6/1/2018,VA,Virginia,York,51199,11801,10208,1593,10821,39,10782,980,30,950,10800,9207,1593,5800,4468,1332,678,173,41,4908
3/1/2018,VA,Virginia,Accomack,51001,8704,7274,1430,7531,46,7485,1173,46,1127,8085,6655,1430,5945,4835,1110,1445,382,96,4022
3/1/2018,VA,Virginia,Albemarle,51003,20404,18212,2192,18853,55,18798,1551,53,1498,18299,16109,2190,14048,12207,1841,1529,317,101,12101
3/1/2018,VA,Virginia,Alexandria City,51510,17562,14925,2637,16174,82,16092,1388,83,1305,14119,11484,2635,8630,6295,2335,2102,325,66,6137
3/1/2018,VA,Virginia,Alleghany,51005,4503,3922,581,3650,25,3625,853,14,839,4264,3683,581,3409,2977,432,789,104,54,2462
3/1/2018,VA,Virginia,Amelia,51007,3046,2340,706,2586,*,*,460,15,445,2812,2106,706,2234,1590,644,463,101,37,1633
3/1/2018,VA,Virginia,Amherst,51009,7743,6374,1369,6477,54,6423,1266,28,1238,7178,5809,1369,5810,4640,1170,1197,236,83,4294
3/1/2018,VA,Virginia,Appomattox,51011,3825,3174,651,3161,17,3144,664,21,643,3590,2939,651,2895,2332,563,666,102,41,2086
3/1/2018,VA,Virginia,Arlington,51013,23849,20734,3115,22276,101,22175,1573,87,1486,18799,15684,3115,11471,8702,2769,2968,367,104,8032
3/1/2018,VA,Virginia,Augusta,51015,18077,15611,2466,15683,63,15620,2394,46,2348,16955,14489,2466,12997,11054,1943,1802,422,140,10633
3/1/2018,VA,Virginia,Bath,51017,1266,1168,98,1119,*,*,147,*,*,1198,1100,98,939,857,82,162,36,24,717
3/1/2018,VA,Virginia,Bedford,51019,19580,16112,3468,16833,93,16740,2747,57,2690,18233,14767,3466,14204,11783,2421,1953,518,156,11577
3/1/2018,VA,Virginia,Bland,51021,1788,1370,418,1407,*,*,381,*,*,1688,1270,418,1279,1046,233,242,51,17,969
3/1/2018,VA,Virginia,Botetourt,51023,8579,6610,1969,7493,50,7443,1086,18,1068,7960,5991,1969,6250,4639,1611,790,196,54,5210
3/1/2018,VA,Virginia,Bristol City,51520,4529,2589,1940,3527,13,3514,1002,18,984,4250,2310,1940,3605,1749,1856,1058,154,55,2338
3/1/2018,VA,Virginia,Brunswick,51025,3949,3309,640,3282,29,3253,667,22,645,3679,3039,640,2913,2378,535,1077,112,42,1682
3/1/2018,VA,Virginia,Buchanan,51027,7285,4267,3018,4656,20,4636,2629,17,2612,7008,3990,3018,5862,3721,2141,1610,409,109,3734
3/1/2018,VA,Virginia,Buckingham,51029,3491,2963,528,2865,21,2844,626,22,604,3250,2722,528,2507,2215,292,725,157,48,1577
3/1/2018,VA,Virginia,Buena Vista City,51530,1449,1207,242,1180,*,*,269,*,*,1352,1110,242,1072,879,193,316,56,23,677
3/1/2018,VA,Virginia,Campbell,51031,12591,10412,2179,10498,80,10418,2093,65,2028,11789,9610,2179,9569,7706,1863,2024,385,168,6992
3/1/2018,VA,Virginia,Caroline,51033,5766,4763,1003,4824,40,4784,942,37,905,5191,4188,1003,3559,2703,856,801,227,52,2479
3/1/2018,VA,Virginia,Carroll,51035,8041,6776,1265,6606,21,6585,1435,*,*,7571,6306,1265,5940,4975,965,1538,275,107,4020
3/1/2018,VA,Virginia,Charles City,51036,1910,1498,412,1627,20,1607,283,15,268,1753,1341,412,1354,1012,342,263,85,18,988
3/1/2018,VA,Virginia,Charlotte,51037,3329,2792,537,2717,16,2701,612,18,594,3134,2597,537,2473,2014,459,771,126,51,1525
3/1/2018,VA,Virginia,Charlottesville City,51540,6190,5572,618,5151,30,5121,1039,37,1002,5519,4902,617,4425,3859,566,1191,153,49,3032
3/1/2018,VA,Virginia,Chesapeake City,51550,37246,29646,7600,32120,306,31814,5126,218,4908,33671,26071,7600,20854,14224,6630,4119,956,243,15536
3/1/2018,VA,Virginia,Chesterfield,51041,58605,44651,13954,51278,247,51031,7327,265,7062,52815,38864,13951,40831,28552,12279,5396,1072,269,34094
3/1/2018,VA,Virginia,Clarke,51043,3245,2839,406,2998,12,2986,247,*,*,2929,2523,406,1996,1686,310,266,75,25,1630
3/1/2018,VA,Virginia,Colonial Heights City,51570,4152,3494,658,3554,*,*,598,14,584,3816,3158,658,2507,1949,558,494,114,27,1872
3/1/2018,VA,Virginia,Covington City,51580,1650,1455,195,1280,12,1268,370,*,*,1533,1339,194,1240,1067,173,348,61,19,812
3/1/2018,VA,Virginia,Craig,51045,1336,1051,285,1042,*,*,294,0,294,1228,943,285,979,722,257,200,46,12,721
3/1/2018,VA,Virginia,Culpeper,51047,9302,7900,1402,8089,41,8048,1213,47,1166,8427,7027,1400,5922,4863,1059,1206,248,80,4388
3/1/2018,VA,Virginia,Cumberland,51049,2256,1776,480,1886,*,*,370,*,*,2088,1608,480,1642,1228,414,412,96,32,1102
3/1/2018,VA,Virginia,Danville City,51590,11137,8736,2401,8825,91,8734,2312,119,2193,10470,8069,2401,8762,7116,1646,3204,413,171,4974
3/1/2018,VA,Virginia,Dickenson,51051,4730,2783,1947,3031,*,*,1699,*,*,4531,2584,1947,3742,2021,1721,1113,210,78,2341
3/1/2018,VA,Virginia,Dinwiddie,51053,5813,4644,1169,4700,36,4664,1113,30,1083,5336,4167,1169,3972,2893,1079,894,196,52,2830
3/1/2018,VA,Virginia,Emporia City,51595,1145,879,266,879,16,863,266,11,255,1062,796,266,880,665,215,409,*,*,393
3/1/2018,VA,Virginia,Essex,51057,2898,2356,542,2491,15,2476,407,12,395,2699,2157,542,2041,1640,401,433,88,26,1494
3/1/2018,VA,Virginia,Fairfax,51059,146796,122167,24629,138763,587,138176,8033,457,7576,118348,93747,24601,69971,49337,20634,13545,2751,536,53139
3/1/2018,VA,Virginia,Fairfax City,51600,3746,3045,701,3487,14,3473,259,14,245,3126,2425,701,1936,1395,541,355,69,14,1498
3/1/2018,VA,Virginia,Falls Church City,51610,1974,1669,305,1889,*,*,85,0,85,1541,1236,305,956,694,262,125,*,*,813
3/1/2018,VA,Virginia,Fauquier,51061,12352,11004,1348,11281,65,11216,1071,38,1033,10948,9600,1348,7047,6105,942,974,193,63,5817
3/1/2018,VA,Virginia,Floyd,51063,4006,3238,768,3467,17,3450,539,*,*,3745,2977,768,2974,2270,704,567,102,46,2259
3/1/2018,VA,Virginia,Fluvanna,51065,5782,5061,721,5206,21,5185,576,20,556,5290,4569,721,3882,3303,579,528,118,26,3210
3/1/2018,VA,Virginia,Franklin,51067,14509,10677,3832,12204,48,12156,2305,32,2273,13641,9809,3832,11093,7684,3409,1959,490,159,8485
3/1/2018,VA,Virginia,Franklin City,51620,1969,1657,312,1545,21,1524,424,22,402,1837,1525,312,1507,1227,280,565,63,15,864
3/1/2018,VA,Virginia,Frederick,51069,16259,14230,2029,14470,58,14412,1789,66,1723,14787,12761,2026,10231,8715,1516,1475,366,124,8266
3/1/2018,VA,Virginia,Fredericksburg City,51630,3983,3500,483,3284,25,3259,699,21,678,3558,3075,483,2494,2079,415,776,99,44,1575
3/1/2018,VA,Virginia,Galax City,51640,1846,1692,154,1473,*,*,373,11,362,1737,1583,154,1393,1283,110,591,57,21,724
3/1/2018,VA,Virginia,Giles,51071,4591,3584,1007,3665,25,3640,926,16,910,4307,3301,1006,3553,2983,570,792,129,39,2593
3/1/2018,VA,Virginia,Gloucester,51073,8392,7008,1384,7227,40,7187,1165,25,1140,7747,6363,1384,4996,3839,1157,991,173,41,3791
3/1/2018,VA,Virginia,Goochland,51075,5674,4481,1193,5184,29,5155,490,20,470,5146,3954,1192,4223,3267,956,397,102,35,3689
3/1/2018,VA,Virginia,Grayson,51077,4683,3914,769,3885,11,3874,798,12,786,4450,3681,769,3404,2762,642,982,182,87,2153
3/1/2018,VA,Virginia,Greene,51079,3729,3271,458,3268,16,3252,461,*,*,3402,2944,458,2483,2087,396,454,89,29,1911
3/1/2018,VA,Virginia,Greensville,51081,2438,1828,610,1970,23,1947,468,16,452,2281,1671,610,1858,1393,465,503,130,33,1192
3/1/2018,VA,Virginia,Halifax,51083,9621,8149,1472,7898,76,7822,1723,55,1668,9041,7569,1472,7312,6037,1275,2107,457,149,4599
3/1/2018,VA,Virginia,Hampton City,51650,24694,18626,6068,20378,213,20165,4316,201,4115,22508,16440,6068,13872,8247,5625,3677,801,177,9217
3/1/2018,VA,Virginia,Hanover,51085,20501,15558,4943,18653,91,18562,1848,52,1796,18694,13752,4942,15093,11095,3998,1400,349,102,13242
3/1/2018,VA,Virginia,Harrisonburg City,51660,5347,4737,610,4545,19,4526,802,20,782,4833,4223,610,3863,3439,424,985,143,29,2706
3/1/2018,VA,Virginia,Henrico,51087,55528,41057,14471,48696,358,48338,6832,290,6542,50178,35708,14470,40790,28388,12402,6310,1434,414,32632
3/1/2018,VA,Virginia,Henry,51089,15009,11030,3979,11982,76,11906,3027,57,2970,14263,10284,3979,12097,8497,3600,2996,747,251,8103
3/1/2018,VA,Virginia,Highland,51091,776,704,72,709,*,*,67,*,*,723,651,72,545,485,60,52,*,*,462
3/1/2018,VA,Virginia,Hopewell City,51670,4508,3554,954,3494,32,3462,1014,31,983,4188,3234,954,2924,2016,908,988,167,32,1737
3/1/2018,VA,Virginia,Isle of Wight,51093,8103,6424,1679,7149,52,7097,954,37,917,7512,5833,1679,5342,3837,1505,926,211,68,4137
3/1/2018,VA,Virginia,James City,51095,20214,17545,2669,19029,66,18963,1185,54,1131,18675,16009,2666,11967,9967,2000,823,220,61,10863
3/1/2018,VA,Virginia,King and Queen,51097,1749,1470,279,1476,16,1460,273,*,*,1632,1353,279,1210,974,236,259,70,13,868
3/1/2018,VA,Virginia,King George,51099,3807,3433,374,3301,15,3286,506,25,481,3300,2926,374,1661,1360,301,445,73,15,1128
3/1/2018,VA,Virginia,King William,51101,3340,2825,515,2861,27,2834,479,19,460,3066,2551,515,2486,2059,427,390,121,22,1953
3/1/2018,VA,Virginia,Lancaster,51103,4320,3745,575,3986,20,3966,334,15,319,4093,3518,575,2994,2645,349,486,98,15,2395
3/1/2018,VA,Virginia,Lee,51105,6430,3786,2644,4467,20,4447,1963,13,1950,6112,3470,2642,5000,2549,2451,1926,258,88,2728
3/1/2018,VA,Virginia,Lexington City,51678,1654,1498,156,1526,13,1513,128,*,*,1529,1373,156,1166,1049,117,213,33,11,909
3/1/2018,VA,Virginia,Loudoun,51107,36346,30362,5984,33982,159,33823,2364,104,2260,30126,24146,5980,20002,15004,4998,3034,663,146,16159
3/1/2018,VA,Virginia,Louisa,51109,7957,6516,1441,6721,41,6680,1236,36,1200,7264,5823,1441,5395,4173,1222,1051,258,68,4018
3/1/2018,VA,Virginia,Lunenburg,51111,3022,2643,379,2476,21,2455,546,17,529,2797,2418,379,2138,1815,323,701,121,44,1272
3/1/2018,VA,Virginia,Lynchburg City,51680,14590,12179,2411,11999,96,11903,2591,110,2481,13538,11127,2411,10994,8909,2085,2936,454,127,7477
3/1/2018,VA,Virginia,Madison,51113,2958,2535,423,2636,12,2624,322,13,309,2755,2332,423,2053,1730,323,381,87,22,1563
3/1/2018,VA,Virginia,Manassas City,51683,4417,3587,830,3899,27,3872,518,45,473,3707,2877,830,2584,1882,702,493,92,42,1957
3/1/2018,VA,Virginia,Manassas Park City,51685,1294,988,306,1124,15,1109,170,13,157,1095,790,305,778,509,269,191,*,*,528
3/1/2018,VA,Virginia,Martinsville City,51690,3962,3041,921,2954,37,2917,1008,42,966,3735,2814,921,3238,2367,871,1316,170,65,1687
3/1/2018,VA,Virginia,Mathews,51115,2835,2386,449,2617,*,*,218,*,*,2687,2238,449,1889,1532,357,272,39,19,1559
3/1/2018,VA,Virginia,Mecklenburg,51117,9095,7414,1681,7572,71,7501,1523,60,1463,8532,6851,1681,6744,5394,1350,1835,373,115,4421
3/1/2018,VA,Virginia,Middlesex,51119,3568,3035,533,3203,18,3185,365,*,*,3369,2836,533,2570,2190,380,443,85,31,2011
3/1/2018,VA,Virginia,Montgomery,51121,13769,11335,2434,11502,44,11458,2267,29,2238,12430,9996,2434,10258,8095,2163,1857,359,117,7925
3/1/2018,VA,Virginia,Nelson,51125,4569,3947,622,4061,18,4043,508,*,*,4186,3565,621,3068,2548,520,574,102,45,2347
3/1/2018,VA,Virginia,New Kent,51127,4431,3626,805,3985,22,3963,446,*,*,4027,3222,805,2842,2232,610,282,76,14,2470
3/1/2018,VA,Virginia,Newport News City,51700,27752,20834,6918,22863,223,22640,4889,245,4644,25360,18444,6916,16686,10212,6474,4642,924,230,10890
3/1/2018,VA,Virginia,Norfolk City,51710,32488,24528,7960,26079,284,25795,6409,334,6075,29183,21223,7960,19880,12426,7454,7096,1365,306,11113
3/1/2018,VA,Virginia,Northampton,51131,3628,3038,590,3116,24,3092,512,25,487,3391,2801,590,2741,2264,477,932,97,27,1685
3/1/2018,VA,Virginia,Northumberland,51133,4605,3973,632,4274,19,4255,331,13,318,4292,3660,632,2873,2525,348,422,90,31,2330
3/1/2018,VA,Virginia,Norton City,51720,1192,802,390,815,*,*,377,*,*,1101,711,390,895,551,344,354,52,16,473
3/1/2018,VA,Virginia,Nottoway,51135,3654,3100,554,3008,30,2978,646,16,630,3392,2838,554,2659,2296,363,878,136,44,1601
3/1/2018,VA,Virginia,Orange,51137,8713,7561,1152,7706,48,7658,1007,32,975,7991,6839,1152,5326,4567,759,950,220,67,4089
3/1/2018,VA,Virginia,Page,51139,6181,5374,807,5097,24,5073,1084,23,1061,5797,4990,807,4253,3593,660,1111,251,81,2810
3/1/2018,VA,Virginia,Patrick,51141,5123,3914,1209,4280,*,*,843,*,*,4859,3652,1207,3980,2993,987,1001,194,68,2717
3/1/2018,VA,Virginia,Petersburg City,51730,7144,5511,1633,5339,101,5238,1805,86,1719,6519,4886,1633,4774,3209,1565,2021,353,67,2333
3/1/2018,VA,Virginia,Pittsylvania,51143,16130,12336,3794,13276,93,13183,2854,80,2774,15172,11379,3793,12485,9761,2724,3011,569,213,8692
3/1/2018,VA,Virginia,Poquoson City,51735,2502,2199,303,2330,*,*,172,*,*,2302,1999,303,1175,914,261,98,22,15,1040
3/1/2018,VA,Virginia,Portsmouth City,51740,18022,13667,4355,14089,191,13898,3933,212,3721,16100,11747,4353,10760,6679,4081,3763,741,142,6114
3/1/2018,VA,Virginia,Powhatan,51145,5829,4636,1193,5236,22,5214,593,17,576,5337,4144,1193,4277,3278,999,386,110,28,3753
3/1/2018,VA,Virginia,Prince Edward,51147,4657,3938,719,3753,39,3714,904,36,868,4313,3594,719,3352,2847,505,1105,178,50,2019
3/1/2018,VA,Virginia,Prince George,51149,5832,5043,789,4954,28,4926,878,34,844,5406,4617,789,3318,2635,683,552,128,30,2608
3/1/2018,VA,Virginia,Prince William,51153,47159,38673,8486,42163,302,41861,4996,307,4689,40173,31691,8482,23475,16061,7414,5039,1086,223,17127
3/1/2018,VA,Virginia,Pulaski,51155,9036,7246,1790,7242,35,7207,1794,30,1764,8415,6625,1790,6897,5363,1534,1595,317,126,4859
3/1/2018,VA,Virginia,Radford City,51750,2036,1683,353,1658,11,1647,378,*,*,1857,1504,353,1566,1251,315,326,45,23,1172
3/1/2018,VA,Virginia,Rappahannock,51157,2002,1810,192,1864,*,*,138,*,*,1815,1624,191,1231,1100,131,145,*,*,1046
3/1/2018,VA,Virginia,Richmond,51159,2035,1647,388,1776,*,*,259,14,245,1888,1500,388,1418,1173,245,296,83,19,1020
3/1/2018,VA,Virginia,Richmond City,51760,33609,23098,10511,26630,293,26337,6979,347,6632,30206,19695,10511,25553,15672,9881,8618,1483,295,15157
3/1/2018,VA,Virginia,Roanoke,51161,23430,18153,5277,20875,107,20768,2555,62,2493,21692,16417,5275,17421,13069,4352,1979,466,146,14830
3/1/2018,VA,Virginia,Roanoke City,51770,20411,15018,5393,15445,137,15308,4966,155,4811,18580,13191,5389,15151,10265,4886,4715,908,219,9309
3/1/2018,VA,Virginia,Rockbridge,51163,5947,5080,867,5071,19,5052,876,11,865,5513,4646,867,4137,3433,704,802,185,68,3082
3/1/2018,VA,Virginia,Rockingham,51165,17279,14814,2465,15182,48,15134,2097,41,2056,15967,13503,2464,12432,10743,1689,1779,518,145,9990
3/1/2018,VA,Virginia,Russell,51167,7836,4899,2937,5469,14,5455,2367,16,2351,7510,4573,2937,6428,4092,2336,1640,325,136,4327
3/1/2018,VA,Virginia,Salem City,51775,6136,4928,1208,5206,27,5179,930,16,914,5628,4420,1208,4484,3445,1039,822,154,39,3469
3/1/2018,VA,Virginia,Scott,51169,6641,3259,3382,5035,11,5024,1606,16,1590,6367,2985,3382,5548,2264,3284,1514,252,112,3670
3/1/2018,VA,Virginia,Shenandoah,51171,10435,9117,1318,9259,31,9228,1176,26,1150,9735,8417,1318,6874,5883,991,1248,269,92,5265
3/1/2018,VA,Virginia,Smyth,51173,8802,6558,2244,6615,31,6584,2187,29,2158,8323,6079,2244,6835,4837,1998,2130,417,129,4159
3/1/2018,VA,Virginia,Southampton,51175,4067,3458,609,3426,36,3390,641,17,624,3780,3171,609,2979,2473,506,692,128,33,2126
3/1/2018,VA,Virginia,Spotsylvania,51177,20524,17993,2531,17876,123,17753,2648,100,2548,18243,15713,2530,11063,9112,1951,1941,537,136,8449
3/1/2018,VA,Virginia,Stafford,51179,16959,15179,1780,14941,103,14838,2018,76,1942,14860,13082,1778,7598,6212,1386,1330,387,95,5786
3/1/2018,VA,Virginia,Staunton City,51790,6194,5442,752,5159,25,5134,1035,16,1019,5813,5061,752,4576,3986,590,1062,150,62,3302
3/1/2018,VA,Virginia,Suffolk City,51800,15915,12747,3168,13114,110,13004,2801,102,2699,14507,11339,3168,10039,7228,2811,2651,479,123,6786
3/1/2018,VA,Virginia,Surry,51181,1576,1245,331,1339,11,1328,237,*,*,1458,1127,331,1061,760,301,204,66,13,778
3/1/2018,VA,Virginia,Sussex,51183,2388,1881,507,1968,32,1936,420,*,*,2212,1705,507,1706,1236,470,463,144,24,1075
3/1/2018,VA,Virginia,Tazewell,51185,12001,8164,3837,8914,45,8869,3087,41,3046,11353,7517,3836,9069,6526,2543,2241,458,191,6179
3/1/2018,VA,Virginia,Unknown,51999,*,*,*,*,*,*,*,*,*,*,*,*,*,*,*,*,*,*,*
3/1/2018,VA,Virginia,Virginia Beach City,51810,70251,57859,12392,62107,399,61708,8144,335,7809,64271,51886,12385,37047,26076,10971,6695,1539,395,28418
3/1/2018,VA,Virginia,Warren,51187,7454,6624,830,6420,27,6393,1034,31,1003,6788,5958,830,4625,3997,628,872,246,73,3434
3/1/2018,VA,Virginia,Washington,51191,14941,9637,5304,12099,45,12054,2842,29,2813,14084,8781,5303,11560,6788,4772,2405,553,185,8417
3/1/2018,VA,Virginia,Waynesboro City,51820,4749,4147,602,3916,22,3894,833,25,808,4435,3833,602,3513,3018,495,868,116,39,2490
3/1/2018,VA,Virginia,Westmoreland,51193,4924,4331,593,4341,26,4315,583,12,571,4476,3883,593,2867,2407,460,730,146,52,1939
3/1/2018,VA,Virginia,Williamsburg City,51830,2563,2187,376,2355,*,*,208,12,196,2364,1988,376,1672,1367,305,224,*,*,1412
3/1/2018,VA,Virginia,Winchester City,51840,5144,4533,611,4393,22,4371,751,18,733,4657,4046,611,3385,2926,459,813,139,53,2380
3/1/2018,VA,Virginia,Wise,51195,10637,6551,4086,7231,32,7199,3406,23,3383,10046,5960,4086,8016,4305,3711,2415,483,173,4945
3/1/2018,VA,Virginia,Wythe,51197,7630,5836,1794,5963,33,5930,1667,24,1643,7198,5405,1793,5835,4311,1524,1543,281,97,3914
3/1/2018,VA,Virginia,York,51199,11737,10163,1574,10764,41,10723,973,33,940,10751,9177,1574,5794,4484,1310,674,176,42,4902
5/1/2018,VA,Virginia,Accomack,51001,8715,7274,1441,7538,43,7495,1177,46,1131,8079,6638,1441,5925,4800,1125,1466,370,90,3999
5/1/2018,VA,Virginia,Albemarle,51003,20487,18276,2211,18927,54,18873,1560,52,1508,18351,16142,2209,14070,12210,1860,1545,299,96,12130
5/1/2018,VA,Virginia,Alexandria City,51510,17653,14994,2659,16255,76,16179,1398,84,1314,14156,11499,2657,8636,6277,2359,2125,309,62,6140
5/1/2018,VA,Virginia,Alleghany,51005,4497,3906,591,3639,24,3615,858,14,844,4267,3676,591,3404,2961,443,792,102,53,2457
5/1/2018,VA,Virginia,Amelia,51007,3047,2338,709,2587,*,*,460,14,446,2814,2105,709,2238,1591,647,467,98,33,1640
5/1/2018,VA,Virginia,Amherst,51009,7763,6381,1382,6484,50,6434,1279,28,1251,7210,5828,1382,5821,4636,1185,1214,233,78,4296
5/1/2018,VA,Virginia,Appomattox,51011,3830,3179,651,3160,17,3143,670,21,649,3600,2949,651,2900,2337,563,676,104,38,2082
5/1/2018,VA,Virginia,Arlington,51013,23999,20829,3170,22422,96,22326,1577,86,1491,18851,15681,3170,11455,8625,2830,2978,351,102,8024
5/1/2018,VA,Virginia,Augusta,51015,18104,15633,2471,15701,58,15643,2403,46,2357,16975,14504,2471,13007,11048,1959,1831,416,137,10623
5/1/2018,VA,Virginia,Bath,51017,1264,1164,100,1116,*,*,148,*,*,1195,1095,100,936,852,84,164,37,22,713
5/1/2018,VA,Virginia,Bedford,51019,19668,16187,3481,16891,91,16800,2777,57,2720,18315,14836,3479,14245,11811,2434,1973,503,150,11619
5/1/2018,VA,Virginia,Bland,51021,1780,1362,418,1400,*,*,380,*,*,1679,1261,418,1273,1041,232,237,53,16,967
5/1/2018,VA,Virginia,Botetourt,51023,8592,6613,1979,7503,49,7454,1089,17,1072,7958,5979,1979,6243,4620,1623,779,192,51,5221
5/1/2018,VA,Virginia,Bristol City,51520,4533,2573,1960,3525,13,3512,1008,18,990,4258,2298,1960,3592,1715,1877,1067,152,51,2322
5/1/2018,VA,Virginia,Brunswick,51025,3969,3302,667,3294,29,3265,675,22,653,3691,3024,667,2914,2354,560,1079,112,35,1688
5/1/2018,VA,Virginia,Buchanan,51027,7286,4220,3066,4639,19,4620,2647,16,2631,7016,3950,3066,5869,3681,2188,1638,402,108,3721
5/1/2018,VA,Virginia,Buckingham,51029,3502,2962,540,2873,21,2852,629,22,607,3263,2723,540,2512,2209,303,733,156,46,1577
5/1/2018,VA,Virginia,Buena Vista City,51530,1447,1202,245,1178,*,*,269,*,*,1354,1109,245,1067,871,196,315,55,21,676
5/1/2018,VA,Virginia,Campbell,51031,12616,10426,2190,10512,76,10436,2104,65,2039,11810,9620,2190,9568,7693,1875,2032,371,160,7005
5/1/2018,VA,Virginia,Caroline,51033,5783,4768,1015,4842,38,4804,941,37,904,5203,4188,1015,3555,2684,871,810,219,49,2477
5/1/2018,VA,Virginia,Carroll,51035,8070,6778,1292,6622,21,6601,1448,*,*,7599,6307,1292,5963,4967,996,1551,269,104,4039
5/1/2018,VA,Virginia,Charles City,51036,1901,1490,411,1617,20,1597,284,15,269,1742,1331,411,1342,998,344,266,82,17,977
5/1/2018,VA,Virginia,Charlotte,51037,3326,2768,558,2711,16,2695,615,18,597,3139,2581,558,2464,1984,480,769,123,49,1523
5/1/2018,VA,Virginia,Charlottesville City,51540,6224,5580,644,5176,30,5146,1048,37,1011,5548,4905,643,4428,3837,591,1208,151,48,3021
5/1/2018,VA,Virginia,Chesapeake City,51550,37441,29764,7677,32261,296,31965,5180,221,4959,33803,26126,7677,20864,14145,6719,4171,928,232,15533
5/1/2018,VA,Virginia,Chesterfield,51041,58899,44827,14072,51524,239,51285,7375,266,7109,53026,38957,14069,40971,28562,12409,5467,1040,250,34214
5/1/2018,VA,Virginia,Clarke,51043,3263,2858,405,3013,12,3001,250,*,*,2937,2532,405,2009,1701,308,269,73,26,1641
5/1/2018,VA,Virginia,Colonial Heights City,51570,4155,3500,655,3552,*,*,603,15,588,3812,3157,655,2491,1933,558,498,112,23,1858
5/1/2018,VA,Virginia,Covington City,51580,1650,1452,198,1274,12,1262,376,*,*,1528,1331,197,1233,1057,176,349,59,16,809
5/1/2018,VA,Virginia,Craig,51045,1336,1043,293,1039,*,*,297,0,297,1227,934,293,976,711,265,203,45,12,716
5/1/2018,VA,Virginia,Culpeper,51047,9324,7916,1408,8104,41,8063,1220,46,1174,8430,7024,1406,5918,4847,1071,1218,235,77,4388
5/1/2018,VA,Virginia,Cumberland,51049,2266,1775,491,1892,*,*,374,*,*,2101,1610,491,1653,1227,426,418,92,30,1113
5/1/2018,VA,Virginia,Danville City,51590,11140,8659,2481,8813,90,8723,2327,119,2208,10469,7988,2481,8756,7035,1721,3245,411,157,4943
5/1/2018,VA,Virginia,Dickenson,51051,4746,2766,1980,3027,*,*,1719,*,*,4545,2565,1980,3741,1985,1756,1123,199,75,2344
5/1/2018,VA,Virginia,Dinwiddie,51053,5840,4641,1199,4720,36,4684,1120,30,1090,5357,4158,1199,3988,2878,1110,905,197,51,2835
5/1/2018,VA,Virginia,Emporia City,51595,1146,872,274,880,16,864,266,*,*,1061,787,274,874,652,222,416,*,*,381
5/1/2018,VA,Virginia,Essex,51057,2907,2361,546,2499,14,2485,408,12,396,2702,2156,546,2029,1625,404,433,84,25,1487
5/1/2018,VA,Virginia,Fairfax,51059,147863,122906,24957,139751,582,139169,8112,461,7651,118968,94037,24931,70168,49189,20979,13697,2648,503,53320
5/1/2018,VA,Virginia,Fairfax City,51600,3776,3073,703,3518,14,3504,258,14,244,3144,2441,703,1945,1399,546,365,67,12,1501
5/1/2018,VA,Virginia,Falls Church City,51610,1989,1676,313,1904,*,*,85,0,85,1543,1230,313,959,689,270,126,*,*,815
5/1/2018,VA,Virginia,Fauquier,51061,12398,11048,1350,11324,64,11260,1074,39,1035,10989,9639,1350,7060,6114,946,976,186,60,5838
5/1/2018,VA,Virginia,Floyd,51063,4011,3241,770,3469,17,3452,542,*,*,3752,2982,770,2975,2269,706,571,97,41,2266
5/1/2018,VA,Virginia,Fluvanna,51065,5807,5078,729,5229,19,5210,578,20,558,5310,4581,729,3887,3300,587,532,113,26,3216
5/1/2018,VA,Virginia,Franklin,51067,14533,10655,3878,12214,47,12167,2319,32,2287,13666,9788,3878,11094,7640,3454,1987,478,154,8475
5/1/2018,VA,Virginia,Franklin City,51620,1977,1654,323,1546,20,1526,431,23,408,1844,1521,323,1503,1211,292,569,63,13,858
5/1/2018,VA,Virginia,Frederick,51069,16307,14280,2027,14506,56,14450,1801,64,1737,14827,12803,2024,10226,8703,1523,1485,354,126,8261
5/1/2018,VA,Virginia,Fredericksburg City,51630,3988,3499,489,3287,24,3263,701,23,678,3558,3069,489,2485,2063,422,780,95,41,1569
5/1/2018,VA,Virginia,Galax City,51640,1855,1698,157,1480,*,*,375,11,364,1741,1584,157,1394,1280,114,597,54,22,721
5/1/2018,VA,Virginia,Giles,51071,4602,3590,1012,3673,24,3649,929,16,913,4328,3317,1011,3564,2988,576,802,125,40,2597
5/1/2018,VA,Virginia,Gloucester,51073,8435,7024,1411,7260,39,7221,1175,24,1151,7772,6361,1411,5005,3819,1186,991,171,42,3801
5/1/2018,VA,Virginia,Goochland,51075,5697,4483,1214,5208,29,5179,489,18,471,5166,3953,1213,4244,3273,971,399,99,32,3714
5/1/2018,VA,Virginia,Grayson,51077,4682,3898,784,3881,*,*,801,11,790,4447,3663,784,3402,2744,658,988,179,89,2146
5/1/2018,VA,Virginia,Greene,51079,3759,3295,464,3293,16,3277,466,*,*,3426,2962,464,2476,2073,403,452,87,27,1910
5/1/2018,VA,Virginia,Greensville,51081,2442,1829,613,1972,23,1949,470,16,454,2283,1670,613,1845,1376,469,500,125,29,1191
5/1/2018,VA,Virginia,Halifax,51083,9622,8119,1503,7895,74,7821,1727,53,1674,9040,7537,1503,7303,5994,1309,2110,442,149,4602
5/1/2018,VA,Virginia,Hampton City,51650,24758,18594,6164,20412,205,20207,4346,201,4145,22569,16405,6164,13869,8144,5725,3705,784,170,9210
5/1/2018,VA,Virginia,Hanover,51085,20575,15618,4957,18716,90,18626,1859,52,1807,18745,13789,4956,15127,11115,4012,1418,339,96,13274
5/1/2018,VA,Virginia,Harrisonburg City,51660,5354,4739,615,4542,17,4525,812,20,792,4843,4228,615,3852,3421,431,986,141,27,2698
5/1/2018,VA,Virginia,Henrico,51087,55630,41053,14577,48772,344,48428,6858,289,6569,50255,35679,14576,40813,28286,12527,6367,1392,392,32662
5/1/2018,VA,Virginia,Henry,51089,15014,10987,4027,11969,72,11897,3045,58,2987,14272,10245,4027,12072,8423,3649,3027,715,246,8084
5/1/2018,VA,Virginia,Highland,51091,781,708,73,713,*,*,68,*,*,727,654,73,544,483,61,52,*,*,461
5/1/2018,VA,Virginia,Hopewell City,51670,4506,3542,964,3491,31,3460,1015,32,983,4188,3224,964,2911,1994,917,992,161,30,1728
5/1/2018,VA,Virginia,Isle of Wight,51093,8142,6444,1698,7174,51,7123,968,38,930,7535,5837,1698,5355,3828,1527,944,205,67,4139
5/1/2018,VA,Virginia,James City,51095,20282,17599,2683,19089,63,19026,1193,55,1138,18746,16066,2680,12000,9987,2013,833,219,59,10889
5/1/2018,VA,Virginia,King and Queen,51097,1754,1463,291,1479,15,1464,275,*,*,1631,1340,291,1211,962,249,265,67,11,868
5/1/2018,VA,Virginia,King George,51099,3817,3440,377,3306,15,3291,511,25,486,3305,2928,377,1658,1355,303,449,71,15,1123
5/1/2018,VA,Virginia,King William,51101,3353,2836,517,2873,26,2847,480,19,461,3072,2555,517,2472,2044,428,386,112,21,1953
5/1/2018,VA,Virginia,Lancaster,51103,4319,3743,576,3978,20,3958,341,16,325,4094,3518,576,2991,2634,357,500,98,15,2378
5/1/2018,VA,Virginia,Lee,51105,6435,3762,2673,4459,20,4439,1976,13,1963,6117,3446,2671,4992,2514,2478,1934,252,83,2723
5/1/2018,VA,Virginia,Lexington City,51678,1649,1493,156,1520,13,1507,129,*,*,1526,1370,156,1167,1049,118,213,*,*,912
5/1/2018,VA,Virginia,Loudoun,51107,36581,30527,6054,34199,156,34043,2382,108,2274,30258,24208,6050,20056,14981,5075,3064,638,139,16215
5/1/2018,VA,Virginia,Louisa,51109,7989,6519,1470,6741,41,6700,1248,36,1212,7302,5832,1470,5401,4150,1251,1063,248,64,4026
5/1/2018,VA,Virginia,Lunenburg,51111,3024,2631,393,2476,21,2455,548,17,531,2800,2407,393,2129,1791,338,705,115,43,1266
5/1/2018,VA,Virginia,Lynchburg City,51680,14597,12152,2445,11986,92,11894,2611,107,2504,13536,11091,2445,10946,8825,2121,2950,444,130,7422
5/1/2018,VA,Virginia,Madison,51113,2969,2545,424,2644,12,2632,325,13,312,2763,2339,424,2055,1730,325,390,86,21,1558
5/1/2018,VA,Virginia,Manassas City,51683,4441,3610,831,3916,25,3891,525,43,482,3721,2890,831,2573,1867,706,495,88,41,1949
5/1/2018,VA,Virginia,Manassas Park City,51685,1302,1000,302,1132,15,1117,170,12,158,1095,794,301,775,509,266,191,*,*,530
5/1/2018,VA,Virginia,Martinsville City,51690,3959,3018,941,2945,36,2909,1014,42,972,3729,2788,941,3222,2332,890,1324,165,61,1672
5/1/2018,VA,Virginia,Mathews,51115,2840,2381,459,2619,*,*,221,*,*,2692,2233,459,1891,1525,366,270,39,19,1563
5/1/2018,VA,Virginia,Mecklenburg,51117,9098,7407,1691,7575,70,7505,1523,61,1462,8537,6846,1691,6719,5357,1362,1841,367,105,4406
5/1/2018,VA,Virginia,Middlesex,51119,3567,3033,534,3205,17,3188,362,*,*,3365,2831,534,2561,2179,382,445,84,30,2002
5/1/2018,VA,Virginia,Montgomery,51121,13834,11371,2463,11559,43,11516,2275,29,2246,12475,10012,2463,10276,8080,2196,1865,354,118,7939
5/1/2018,VA,Virginia,Nelson,51125,4588,3957,631,4080,18,4062,508,*,*,4206,3576,630,3081,2552,529,575,101,43,2362
5/1/2018,VA,Virginia,New Kent,51127,4439,3632,807,3985,20,3965,454,*,*,4033,3226,807,2842,2231,611,286,74,14,2468
5/1/2018,VA,Virginia,Newport News City,51700,27836,20780,7056,22900,217,22683,4936,244,4692,25419,18365,7054,16661,10048,6613,4695,910,226,10830
5/1/2018,VA,Virginia,Norfolk City,51710,32556,24462,8094,26105,280,25825,6451,336,6115,29231,21137,8094,19826,12232,7594,7167,1331,295,11033
5/1/2018,VA,Virginia,Northampton,51131,3629,3022,607,3118,22,3096,511,25,486,3386,2779,607,2721,2225,496,933,91,27,1670
5/1/2018,VA,Virginia,Northumberland,51133,4605,3968,637,4276,19,4257,329,13,316,4287,3650,637,2868,2512,356,426,85,28,2329
5/1/2018,VA,Virginia,Norton City,51720,1190,797,393,813,*,*,377,*,*,1101,708,393,895,548,347,359,50,15,471
5/1/2018,VA,Virginia,Nottoway,51135,3651,3079,572,3000,30,2970,651,16,635,3388,2816,572,2649,2268,381,890,131,42,1586
5/1/2018,VA,Virginia,Orange,51137,8738,7588,1150,7712,47,7665,1026,33,993,8008,6858,1150,5321,4565,756,968,212,65,4076
5/1/2018,VA,Virginia,Page,51139,6169,5329,840,5084,24,5060,1085,23,1062,5784,4944,840,4243,3551,692,1116,247,76,2804
5/1/2018,VA,Virginia,Patrick,51141,5137,3923,1214,4293,*,*,844,*,*,4870,3658,1212,3982,2988,994,1013,188,67,2714
5/1/2018,VA,Virginia,Petersburg City,51730,7157,5453,1704,5349,99,5250,1808,88,1720,6528,4824,1704,4752,3113,1639,2035,346,66,2305
5/1/2018,VA,Virginia,Pittsylvania,51143,16153,12300,3853,13282,89,13193,2871,79,2792,15189,11336,3853,12460,9685,2775,3032,546,205,8677
5/1/2018,VA,Virginia,Poquoson City,51735,2504,2199,305,2329,*,*,175,*,*,2303,1998,305,1171,908,263,98,20,13,1040
5/1/2018,VA,Virginia,Portsmouth City,51740,18032,13613,4419,14082,186,13896,3950,214,3736,16103,11686,4417,10715,6562,4153,3805,720,141,6049
5/1/2018,VA,Virginia,Powhatan,51145,5864,4661,1203,5263,20,5243,601,18,583,5368,4165,1203,4306,3295,1011,394,115,27,3770
5/1/2018,VA,Virginia,Prince Edward,51147,4660,3913,747,3753,37,3716,907,36,871,4313,3566,747,3339,2804,535,1095,172,50,2022
5/1/2018,VA,Virginia,Prince George,51149,5861,5067,794,4974,27,4947,887,36,851,5427,4633,794,3303,2614,689,553,124,29,2597
5/1/2018,VA,Virginia,Prince William,51153,47477,38851,8626,42449,297,42152,5028,304,4724,40375,31753,8622,23520,15968,7552,5109,1056,212,17143
5/1/2018,VA,Virginia,Pulaski,51155,9075,7260,1815,7265,32,7233,1810,31,1779,8453,6638,1815,6915,5355,1560,1608,307,116,4884
5/1/2018,VA,Virginia,Radford City,51750,2044,1683,361,1662,11,1651,382,*,*,1861,1500,361,1564,1241,323,324,45,23,1172
5/1/2018,VA,Virginia,Rappahannock,51157,2006,1812,194,1869,*,*,137,*,*,1813,1620,193,1234,1102,132,147,*,*,1047
5/1/2018,VA,Virginia,Richmond,51159,2026,1634,392,1768,*,*,258,13,245,1882,1490,392,1407,1160,247,300,75,17,1015
5/1/2018,VA,Virginia,Richmond City,51760,33743,23079,10664,26716,287,26429,7027,356,6671,30313,19649,10664,25572,15530,10042,8716,1429,292,15135
5/1/2018,VA,Virginia,Roanoke,51161,23478,18165,5313,20907,104,20803,2571,61,2510,21725,16414,5311,17441,13050,4391,1994,447,132,14868
5/1/2018,VA,Virginia,Roanoke City,51770,20454,14952,5502,15467,134,15333,4987,155,4832,18597,13099,5498,15118,10126,4992,4754,875,215,9274
5/1/2018,VA,Virginia,Rockbridge,51163,5973,5106,867,5095,19,5076,878,*,*,5542,4675,867,4150,3446,704,806,181,61,3102
5/1/2018,VA,Virginia,Rockingham,51165,17321,14851,2470,15204,46,15158,2117,41,2076,16004,13535,2469,12453,10748,1705,1798,498,143,10014
5/1/2018,VA,Virginia,Russell,51167,7838,4883,2955,5455,13,5442,2383,16,2367,7501,4546,2955,6407,4049,2358,1645,323,129,4310
5/1/2018,VA,Virginia,Salem City,51775,6134,4893,1241,5195,27,5168,939,17,922,5637,4396,1241,4483,3410,1073,840,147,37,3459
5/1/2018,VA,Virginia,Scott,51169,6630,3235,3395,5014,11,5003,1616,16,1600,6359,2964,3395,5520,2223,3297,1513,245,105,3657
5/1/2018,VA,Virginia,Shenandoah,51171,10450,9127,1323,9271,30,9241,1179,26,1153,9743,8420,1323,6875,5878,997,1256,265,91,5263
5/1/2018,VA,Virginia,Smyth,51173,8807,6526,2281,6615,31,6584,2192,28,2164,8322,6041,2281,6823,4781,2042,2144,410,126,4143
5/1/2018,VA,Virginia,Southampton,51175,4067,3446,621,3425,34,3391,642,17,625,3773,3152,621,2968,2446,522,695,121,33,2119
5/1/2018,VA,Virginia,Spotsylvania,51177,20600,18031,2569,17934,119,17815,2666,101,2565,18289,15721,2568,11040,9053,1987,1951,524,134,8431
5/1/2018,VA,Virginia,Stafford,51179,17072,15280,1792,15026,100,14926,2046,76,1970,14930,13140,1790,7595,6198,1397,1352,374,86,5783
5/1/2018,VA,Virginia,Staunton City,51790,6197,5435,762,5159,25,5134,1038,14,1024,5825,5063,762,4571,3970,601,1074,151,60,3286
5/1/2018,VA,Virginia,Suffolk City,51800,15942,12725,3217,13135,105,13030,2807,102,2705,14535,11318,3217,10000,7133,2867,2660,465,118,6757
5/1/2018,VA,Virginia,Surry,51181,1576,1241,335,1339,11,1328,237,*,*,1457,1122,335,1057,752,305,204,64,13,776
5/1/2018,VA,Virginia,Sussex,51183,2377,1861,516,1955,31,1924,422,*,*,2203,1687,516,1682,1203,479,460,138,22,1062
5/1/2018,VA,Virginia,Tazewell,51185,12001,8145,3856,8898,42,8856,3103,39,3064,11341,7486,3855,9047,6479,2568,2261,454,183,6149
5/1/2018,VA,Virginia,Unknown,51999,*,*,*,*,*,*,*,*,*,*,*,*,*,*,*,*,*,*,*
5/1/2018,VA,Virginia,Virginia Beach City,51810,70615,58095,12520,62390,390,62000,8225,339,7886,64537,52024,12513,37132,26015,11117,6772,1511,375,28474
5/1/2018,VA,Virginia,Warren,51187,7490,6643,847,6439,25,6414,1051,32,1019,6818,5971,847,4622,3977,645,890,236,70,3426
5/1/2018,VA,Virginia,Washington,51191,14961,9638,5323,12109,43,12066,2852,29,2823,14099,8777,5322,11569,6768,4801,2427,536,180,8426
5/1/2018,VA,Virginia,Waynesboro City,51820,4747,4135,612,3908,22,3886,839,24,815,4432,3820,612,3498,2992,506,874,112,38,2474
5/1/2018,VA,Virginia,Westmoreland,51193,4933,4331,602,4342,26,4316,591,12,579,4487,3885,602,2858,2389,469,735,136,45,1942
5/1/2018,VA,Virginia,Williamsburg City,51830,2580,2199,381,2366,*,*,214,11,203,2376,1995,381,1675,1363,312,224,*,*,1418
5/1/2018,VA,Virginia,Winchester City,51840,5161,4540,621,4407,22,4385,754,17,737,4669,4048,621,3373,2904,469,822,134,48,2369
5/1/2018,VA,Virginia,Wise,51195,10676,6534,4142,7238,29,7209,3438,24,3414,10076,5934,4142,8005,4238,3767,2428,460,167,4950
5/1/2018,VA,Virginia,Wythe,51197,7641,5825,1816,5963,30,5933,1678,24,1654,7218,5403,1815,5823,4272,1551,1550,270,99,3904
5/1/2018,VA,Virginia,York,51199,11769,10189,1580,10795,39,10756,974,30,944,10777,9197,1580,5790,4474,1316,672,172,40,4906
11/1/2018,VA,Virginia,Accomack,51001,8810,7352,1458,7602,37,7565,1208,44,1164,8175,6717,1458,5965,4829,1136,1492,365,88,4020
11/1/2018,VA,Virginia,Albemarle,51003,20811,18555,2256,19214,52,19162,1597,48,1549,18683,16429,2254,14292,12389,1903,1559,312,101,12320
11/1/2018,VA,Virginia,Alexandria City,51510,18067,15295,2772,16626,69,16557,1441,87,1354,14547,11777,2770,8830,6367,2463,2188,305,64,6273
11/1/2018,VA,Virginia,Alleghany,51005,4515,3911,604,3644,19,3625,871,12,859,4301,3697,604,3440,2979,461,789,100,54,2497
11/1/2018,VA,Virginia,Amelia,51007,3058,2338,720,2594,*,*,464,13,451,2828,2108,720,2250,1591,659,472,100,33,1645
11/1/2018,VA,Virginia,Amherst,51009,7882,6483,1399,6570,47,6523,1312,29,1283,7324,5925,1399,5888,4690,1198,1257,223,79,4329
11/1/2018,VA,Virginia,Appomattox,51011,3868,3231,637,3175,14,3161,693,20,673,3640,3003,637,2919,2365,554,691,101,37,2090
11/1/2018,VA,Virginia,Arlington,51013,24539,21171,3368,22917,89,22828,1622,85,1537,19301,15933,3368,11688,8676,3012,3048,356,113,8171
11/1/2018,VA,Virginia,Augusta,51015,18330,15832,2498,15880,49,15831,2450,49,2401,17190,14692,2498,13183,11191,1992,1906,407,135,10735
11/1/2018,VA,Virginia,Bath,51017,1264,1163,101,1109,*,*,155,*,*,1197,1096,101,928,844,84,162,37,23,706
11/1/2018,VA,Virginia,Bedford,51019,19870,16344,3526,17033,76,16957,2837,57,2780,18510,14986,3524,14413,11938,2475,2053,495,152,11713
11/1/2018,VA,Virginia,Bland,51021,1798,1370,428,1409,*,*,389,*,*,1696,1268,428,1295,1047,248,244,55,19,977
11/1/2018,VA,Virginia,Botetourt,51023,8636,6635,2001,7525,44,7481,1111,19,1092,8030,6029,2001,6284,4630,1654,794,182,52,5256
11/1/2018,VA,Virginia,Bristol City,51520,4540,2541,1999,3517,*,*,1023,18,1005,4269,2270,1999,3614,1698,1916,1100,154,56,2304
11/1/2018,VA,Virginia,Brunswick,51025,3994,3275,719,3320,27,3293,674,22,652,3719,3000,719,2921,2311,610,1079,113,41,1688
11/1/2018,VA,Virginia,Buchanan,51027,7309,4204,3105,4606,16,4590,2703,16,2687,7066,3961,3105,5922,3685,2237,1688,395,111,3728
11/1/2018,VA,Virginia,Buckingham,51029,3506,2951,555,2865,20,2845,641,21,620,3269,2714,555,2512,2184,328,750,143,47,1572
11/1/2018,VA,Virginia,Buena Vista City,51530,1456,1206,250,1184,*,*,272,*,*,1366,1116,250,1067,867,200,328,50,19,670
11/1/2018,VA,Virginia,Campbell,51031,12704,10491,2213,10542,66,10476,2162,67,2095,11887,9674,2213,9604,7704,1900,2101,361,149,6993
11/1/2018,VA,Virginia,Caroline,51033,5882,4828,1054,4926,33,4893,956,35,921,5303,4249,1054,3612,2707,905,846,210,46,2510
11/1/2018,VA,Virginia,Carroll,51035,8156,6826,1330,6669,19,6650,1487,*,*,7724,6394,1330,6054,5024,1030,1589,264,96,4105
11/1/2018,VA,Virginia,Charles City,51036,1935,1511,424,1648,18,1630,287,16,271,1775,1351,424,1355,996,359,277,81,14,983
11/1/2018,VA,Virginia,Charlotte,51037,3345,2779,566,2720,15,2705,625,18,607,3159,2593,566,2483,1992,491,776,123,49,1535
11/1/2018,VA,Virginia,Charlottesville City,51540,6315,5621,694,5236,26,5210,1079,42,1037,5651,4958,693,4526,3890,636,1258,145,47,3076
11/1/2018,VA,Virginia,Chesapeake City,51550,38164,30216,7948,32846,277,32569,5318,226,5092,34553,26606,7947,21241,14246,6995,4286,901,234,15820
11/1/2018,VA,Virginia,Chesterfield,51041,60050,45616,14434,52502,218,52284,7548,264,7284,54145,39715,14430,41867,29098,12769,5638,1007,262,34960
11/1/2018,VA,Virginia,Clarke,51043,3303,2913,390,3042,11,3031,261,*,*,2974,2584,390,2027,1731,296,274,76,30,1647
11/1/2018,VA,Virginia,Colonial Heights City,51570,4177,3487,690,3560,*,*,617,14,603,3827,3137,690,2507,1911,596,517,106,22,1862
11/1/2018,VA,Virginia,Covington City,51580,1653,1441,212,1273,11,1262,380,*,*,1535,1324,211,1233,1043,190,357,58,16,802
11/1/2018,VA,Virginia,Craig,51045,1343,1044,299,1046,*,*,297,0,297,1238,939,299,981,709,272,212,45,12,712
11/1/2018,VA,Virginia,Culpeper,51047,9442,7972,1470,8174,39,8135,1268,48,1220,8567,7099,1468,6001,4877,1124,1258,238,79,4426
11/1/2018,VA,Virginia,Cumberland,51049,2270,1760,510,1896,*,*,374,*,*,2118,1608,510,1653,1208,445,418,90,33,1112
11/1/2018,VA,Virginia,Danville City,51590,11209,8593,2616,8805,78,8727,2404,118,2286,10527,7911,2616,8793,6940,1853,3303,404,159,4927
11/1/2018,VA,Virginia,Dickenson,51051,4763,2684,2079,3007,*,*,1756,*,*,4571,2492,2079,3775,1928,1847,1150,204,78,2343
11/1/2018,VA,Virginia,Dinwiddie,51053,5916,4682,1234,4772,33,4739,1144,29,1115,5441,4207,1234,4030,2882,1148,933,187,53,2857
11/1/2018,VA,Virginia,Emporia City,51595,1169,882,287,887,16,871,282,*,*,1095,808,287,893,660,233,431,*,*,388
11/1/2018,VA,Virginia,Essex,51057,2955,2391,564,2538,13,2525,417,14,403,2748,2184,564,2062,1640,422,450,86,25,1501
11/1/2018,VA,Virginia,Fairfax,51059,151691,125682,26009,143271,545,142726,8420,468,7952,122352,96366,25986,72200,50359,21841,14125,2654,551,54870
11/1/2018,VA,Virginia,Fairfax City,51600,3846,3121,725,3588,11,3577,258,16,242,3218,2493,725,1988,1421,567,368,68,13,1539
11/1/2018,VA,Virginia,Falls Church City,51610,2049,1729,320,1960,*,*,89,0,89,1591,1271,320,985,707,278,127,*,*,839
11/1/2018,VA,Virginia,Fauquier,51061,12666,11311,1355,11559,62,11497,1107,42,1065,11263,9908,1355,7197,6248,949,999,184,59,5955
11/1/2018,VA,Virginia,Floyd,51063,4072,3288,784,3520,17,3503,552,*,*,3805,3021,784,3012,2290,722,589,93,42,2288
11/1/2018,VA,Virginia,Fluvanna,51065,5902,5157,745,5310,16,5294,592,18,574,5417,4672,745,3956,3358,598,559,111,24,3262
11/1/2018,VA,Virginia,Franklin,51067,14648,10713,3935,12296,44,12252,2352,32,2320,13775,9840,3935,11175,7664,3511,2033,472,155,8515
11/1/2018,VA,Virginia,Franklin City,51620,1996,1649,347,1556,20,1536,440,23,417,1862,1515,347,1520,1204,316,589,61,14,856
11/1/2018,VA,Virginia,Frederick,51069,16517,14506,2011,14687,48,14639,1830,59,1771,15038,13030,2008,10375,8860,1515,1504,363,125,8383
11/1/2018,VA,Virginia,Fredericksburg City,51630,4067,3557,510,3345,23,3322,722,25,697,3635,3125,510,2527,2088,439,814,98,36,1579
11/1/2018,VA,Virginia,Galax City,51640,1844,1668,176,1473,*,*,371,11,360,1745,1569,176,1393,1262,131,591,54,23,725
11/1/2018,VA,Virginia,Giles,51071,4612,3600,1012,3679,20,3659,933,15,918,4360,3348,1012,3593,3006,587,830,116,40,2607
11/1/2018,VA,Virginia,Gloucester,51073,8555,7115,1440,7363,35,7328,1192,21,1171,7904,6464,1440,5095,3872,1223,1003,177,44,3871
11/1/2018,VA,Virginia,Goochland,51075,5839,4610,1229,5343,27,5316,496,17,479,5300,4072,1228,4355,3370,985,401,98,31,3825
11/1/2018,VA,Virginia,Grayson,51077,4717,3884,833,3899,*,*,818,*,*,4489,3656,833,3428,2718,710,997,184,87,2160
11/1/2018,VA,Virginia,Greene,51079,3830,3357,473,3347,14,3333,483,*,*,3487,3014,473,2524,2113,411,471,87,23,1943
11/1/2018,VA,Virginia,Greensville,51081,2478,1847,631,1994,22,1972,484,17,467,2318,1687,631,1863,1378,485,519,117,32,1195
11/1/2018,VA,Virginia,Halifax,51083,9697,8153,1544,7956,68,7888,1741,49,1692,9115,7571,1544,7331,5983,1348,2143,433,148,4607
11/1/2018,VA,Virginia,Hampton City,51650,25104,18701,6403,20646,185,20461,4458,203,4255,22925,16522,6403,14068,8101,5967,3843,774,173,9278
11/1/2018,VA,Virginia,Hanover,51085,20931,15888,5043,19044,81,18963,1887,49,1838,19073,14031,5042,15367,11258,4109,1459,330,94,13484
11/1/2018,VA,Virginia,Harrisonburg City,51660,5410,4790,620,4571,15,4556,839,21,818,4904,4284,620,3915,3480,435,1022,144,26,2723
11/1/2018,VA,Virginia,Henrico,51087,56560,41606,14954,49550,309,49241,7010,281,6729,51074,36121,14953,41451,28532,12919,6586,1378,397,33090
11/1/2018,VA,Virginia,Henry,51089,15079,10997,4082,11980,68,11912,3099,57,3042,14340,10258,4082,12145,8430,3715,3121,709,251,8064
11/1/2018,VA,Virginia,Highland,51091,784,715,69,715,*,*,69,*,*,737,668,69,548,492,56,53,*,*,464
11/1/2018,VA,Virginia,Hopewell City,51670,4546,3538,1008,3511,28,3483,1035,32,1003,4222,3214,1008,2937,1977,960,1034,150,30,1723
11/1/2018,VA,Virginia,Isle of Wight,51093,8310,6573,1737,7313,45,7268,997,35,962,7664,5927,1737,5433,3867,1566,979,195,68,4191
11/1/2018,VA,Virginia,James City,51095,20517,17810,2707,19303,60,19243,1214,56,1158,18986,16282,2704,12171,10150,2021,866,215,58,11032
11/1/2018,VA,Virginia,King and Queen,51097,1779,1480,299,1502,13,1489,277,*,*,1650,1351,299,1225,969,256,271,69,12,873
11/1/2018,VA,Virginia,King George,51099,3906,3528,378,3374,13,3361,532,25,507,3391,3013,378,1698,1392,306,464,74,18,1142
11/1/2018,VA,Virginia,King William,51101,3427,2890,537,2928,23,2905,499,19,480,3132,2595,537,2520,2074,446,413,115,22,1970
11/1/2018,VA,Virginia,Lancaster,51103,4330,3733,597,3985,18,3967,345,17,328,4115,3518,597,2989,2622,367,502,94,14,2379
11/1/2018,VA,Virginia,Lee,51105,6455,3716,2739,4449,17,4432,2006,12,1994,6134,3397,2737,5004,2456,2548,1971,258,86,2689
11/1/2018,VA,Virginia,Lexington City,51678,1649,1491,158,1521,*,*,128,*,*,1522,1364,158,1165,1045,120,207,33,12,913
11/1/2018,VA,Virginia,Loudoun,51107,37536,31195,6341,35074,146,34928,2462,109,2353,31088,24750,6338,20636,15297,5339,3194,637,149,16656
11/1/2018,VA,Virginia,Louisa,51109,8112,6613,1499,6844,39,6805,1268,34,1234,7442,5943,1499,5496,4221,1275,1096,244,62,4094
11/1/2018,VA,Virginia,Lunenburg,51111,3048,2633,415,2484,19,2465,564,18,546,2812,2397,415,2140,1783,357,722,104,40,1274
11/1/2018,VA,Virginia,Lynchburg City,51680,14686,12190,2496,12039,81,11958,2647,101,2546,13633,11137,2496,11041,8868,2173,3017,439,131,7454
11/1/2018,VA,Virginia,Madison,51113,3001,2569,432,2669,11,2658,332,12,320,2794,2362,432,2067,1735,332,394,87,21,1565
11/1/2018,VA,Virginia,Manassas City,51683,4532,3670,862,3990,21,3969,542,43,499,3804,2942,862,2644,1904,740,537,90,37,1980
11/1/2018,VA,Virginia,Manassas Park City,51685,1340,1023,317,1165,13,1152,175,12,163,1128,811,317,786,502,284,207,*,*,521
11/1/2018,VA,Virginia,Martinsville City,51690,3965,3006,959,2938,35,2903,1027,41,986,3751,2792,959,3217,2308,909,1342,160,58,1657
11/1/2018,VA,Virginia,Mathews,51115,2860,2397,463,2634,*,*,226,*,*,2712,2249,463,1900,1528,372,272,42,20,1566
11/1/2018,VA,Virginia,Mecklenburg,51117,9168,7391,1777,7609,60,7549,1559,61,1498,8635,6858,1777,6774,5320,1454,1874,350,99,4451
11/1/2018,VA,Virginia,Middlesex,51119,3628,3072,556,3255,14,3241,373,*,*,3420,2864,556,2604,2199,405,467,78,29,2030
11/1/2018,VA,Virginia,Montgomery,51121,14007,11497,2510,11685,41,11644,2322,30,2292,12674,10164,2510,10452,8199,2253,1923,351,122,8056
11/1/2018,VA,Virginia,Nelson,51125,4663,4018,645,4141,14,4127,522,*,*,4288,3644,644,3125,2582,543,588,101,43,2393
11/1/2018,VA,Virginia,New Kent,51127,4544,3726,818,4080,17,4063,464,*,*,4136,3318,818,2903,2285,618,297,72,13,2521
11/1/2018,VA,Virginia,Newport News City,51700,28268,20923,7345,23207,193,23014,5061,247,4814,25876,18532,7344,16921,10013,6908,4895,881,224,10921
11/1/2018,VA,Virginia,Norfolk City,51710,33060,24593,8467,26457,255,26202,6603,335,6268,29771,21304,8467,20119,12138,7981,7380,1316,297,11126
11/1/2018,VA,Virginia,Northampton,51131,3649,3000,649,3129,19,3110,520,22,498,3410,2761,649,2738,2198,540,933,91,29,1685
11/1/2018,VA,Virginia,Northumberland,51133,4634,3989,645,4301,16,4285,333,14,319,4338,3693,645,2896,2535,361,436,88,30,2342
11/1/2018,VA,Virginia,Norton City,51720,1187,767,420,800,*,*,387,*,*,1094,674,420,899,524,375,360,52,15,472
11/1/2018,VA,Virginia,Nottoway,51135,3662,3054,608,2994,22,2972,668,15,653,3401,2793,608,2657,2235,422,889,131,39,1598
11/1/2018,VA,Virginia,Orange,51137,8856,7694,1162,7805,44,7761,1051,35,1016,8130,6968,1162,5406,4639,767,1006,208,62,4130
11/1/2018,VA,Virginia,Page,51139,6213,5346,867,5110,23,5087,1103,23,1080,5822,4955,867,4264,3547,717,1133,242,81,2808
11/1/2018,VA,Virginia,Patrick,51141,5172,3942,1230,4306,*,*,866,11,855,4907,3679,1228,4007,3002,1005,1031,184,70,2722
11/1/2018,VA,Virginia,Petersburg City,51730,7197,5367,1830,5351,90,5261,1846,87,1759,6574,4744,1830,4796,3032,1764,2100,339,66,2291
11/1/2018,VA,Virginia,Pittsylvania,51143,16338,12362,3976,13378,75,13303,2960,81,2879,15364,11388,3976,12617,9743,2874,3108,527,211,8771
11/1/2018,VA,Virginia,Poquoson City,51735,2536,2228,308,2355,*,*,181,*,*,2334,2026,308,1190,926,264,102,21,12,1055
11/1/2018,VA,Virginia,Portsmouth City,51740,18261,13617,4644,14206,163,14043,4055,216,3839,16352,11710,4642,10859,6480,4379,3974,685,143,6057
11/1/2018,VA,Virginia,Powhatan,51145,5961,4745,1216,5354,19,5335,607,18,589,5461,4245,1216,4386,3359,1027,406,112,29,3839
11/1/2018,VA,Virginia,Prince Edward,51147,4698,3928,770,3770,33,3737,928,34,894,4363,3593,770,3361,2801,560,1106,167,49,2039
11/1/2018,VA,Virginia,Prince George,51149,5981,5169,812,5059,27,5032,922,37,885,5534,4722,812,3355,2654,701,573,121,32,2629
11/1/2018,VA,Virginia,Prince William,51153,48742,39762,8980,43540,268,43272,5202,303,4899,41575,32599,8976,24057,16167,7890,5335,1057,223,17442
11/1/2018,VA,Virginia,Pulaski,51155,9124,7283,1841,7276,28,7248,1848,28,1820,8522,6681,1841,6960,5378,1582,1641,301,109,4909
11/1/2018,VA,Virginia,Radford City,51750,2054,1685,369,1665,*,*,389,*,*,1879,1510,369,1578,1247,331,343,42,26,1167
11/1/2018,VA,Virginia,Rappahannock,51157,2045,1849,196,1900,*,*,145,*,*,1851,1656,195,1254,1121,133,151,*,*,1060
11/1/2018,VA,Virginia,Richmond,51159,2041,1645,396,1779,*,*,262,13,249,1894,1498,396,1413,1161,252,313,67,15,1018
11/1/2018,VA,Virginia,Richmond City,51760,34155,23009,11146,27014,262,26752,7141,355,6786,30725,19579,11146,25925,15391,10534,9034,1395,295,15201
11/1/2018,VA,Virginia,Roanoke,51161,23699,18307,5392,21051,87,20964,2648,61,2587,21919,16529,5390,17601,13115,4486,2057,448,136,14960
11/1/2018,VA,Virginia,Roanoke City,51770,20703,14935,5768,15626,120,15506,5077,156,4921,18834,13070,5764,15311,10042,5269,4903,859,218,9331
11/1/2018,VA,Virginia,Rockbridge,51163,6035,5151,884,5131,15,5116,904,11,893,5603,4719,884,4202,3483,719,829,183,62,3128
11/1/2018,VA,Virginia,Rockingham,51165,17509,15033,2476,15348,40,15308,2161,41,2120,16197,13722,2475,12617,10900,1717,1832,489,140,10156
11/1/2018,VA,Virginia,Russell,51167,7902,4881,3021,5461,*,*,2441,16,2425,7567,4547,3020,6419,3991,2428,1663,333,139,4284
11/1/2018,VA,Virginia,Salem City,51775,6147,4886,1261,5191,27,5164,956,15,941,5671,4410,1261,4528,3431,1097,849,149,42,3488
11/1/2018,VA,Virginia,Scott,51169,6654,3190,3464,5003,11,4992,1651,16,1635,6393,2929,3464,5555,2191,3364,1539,246,105,3665
11/1/2018,VA,Virginia,Shenandoah,51171,10561,9229,1332,9362,28,9334,1199,28,1171,9872,8540,1332,6962,5951,1011,1262,268,87,5345
11/1/2018,VA,Virginia,Smyth,51173,8803,6431,2372,6585,28,6557,2218,25,2193,8317,5945,2372,6818,4680,2138,2152,410,129,4127
11/1/2018,VA,Virginia,Southampton,51175,4141,3488,653,3479,28,3451,662,21,641,3848,3195,653,3006,2450,556,705,120,33,2148
11/1/2018,VA,Virginia,Spotsylvania,51177,20964,18338,2626,18243,101,18142,2721,101,2620,18618,15993,2625,11219,9187,2032,2062,513,130,8514
11/1/2018,VA,Virginia,Stafford,51179,17512,15695,1817,15412,91,15321,2100,80,2020,15324,13509,1815,7754,6329,1425,1421,376,88,5869
11/1/2018,VA,Virginia,Staunton City,51790,6293,5502,791,5230,23,5207,1063,13,1050,5914,5123,791,4645,4016,629,1105,150,59,3331
11/1/2018,VA,Virginia,Suffolk City,51800,16204,12777,3427,13317,100,13217,2887,101,2786,14815,11388,3427,10170,7092,3078,2764,451,119,6836
11/1/2018,VA,Virginia,Surry,51181,1621,1281,340,1375,11,1364,246,*,*,1487,1147,340,1070,757,313,210,62,13,785
11/1/2018,VA,Virginia,Sussex,51183,2413,1865,548,1972,28,1944,441,*,*,2239,1691,548,1702,1191,511,476,132,23,1071
11/1/2018,VA,Virginia,Tazewell,51185,12062,8124,3938,8884,37,8847,3178,41,3137,11418,7481,3937,9121,6441,2680,2307,460,188,6166
11/1/2018,VA,Virginia,Unknown,51999,*,*,*,*,*,*,*,*,*,*,*,*,*,*,*,*,*,*,*
11/1/2018,VA,Virginia,Virginia Beach City,51810,71908,58991,12917,63432,363,63069,8476,339,8137,65837,52927,12910,37845,26320,11525,6955,1486,396,29008
11/1/2018,VA,Virginia,Warren,51187,7598,6745,853,6521,20,6501,1077,30,1047,6939,6086,853,4693,4049,644,930,229,69,3465
11/1/2018,VA,Virginia,Washington,51191,15087,9643,5444,12174,37,12137,2913,28,2885,14237,8794,5443,11700,6767,4933,2490,542,190,8478
11/1/2018,VA,Virginia,Waynesboro City,51820,4787,4128,659,3924,20,3904,863,28,835,4454,3795,659,3517,2967,550,894,108,37,2478
11/1/2018,VA,Virginia,Westmoreland,51193,5017,4406,611,4399,19,4380,618,13,605,4585,3974,611,2912,2431,481,769,134,47,1962
11/1/2018,VA,Virginia,Williamsburg City,51830,2606,2216,390,2385,*,*,221,12,209,2398,2008,390,1690,1369,321,231,*,*,1426
11/1/2018,VA,Virginia,Winchester City,51840,5208,4589,619,4438,21,4417,770,17,753,4714,4095,619,3399,2930,469,849,135,47,2368
11/1/2018,VA,Virginia,Wise,51195,10748,6440,4308,7207,24,7183,3541,26,3515,10175,5867,4308,8113,4171,3942,2483,464,178,4988
11/1/2018,VA,Virginia,Wythe,51197,7697,5831,1866,5993,27,5966,1704,18,1686,7293,5428,1865,5876,4270,1606,1590,273,110,3903
11/1/2018,VA,Virginia,York,51199,11952,10356,1596,10950,36,10914,1002,29,973,10930,9334,1596,5844,4507,1337,702,170,40,4932
10/1/2018,VA,Virginia,Accomack,51001,8810,7345,1465,7609,38,7571,1201,44,1157,8175,6710,1465,5966,4823,1143,1495,362,88,4021
10/1/2018,VA,Virginia,Albemarle,51003,20757,18504,2253,19167,52,19115,1590,48,1542,18636,16385,2251,14275,12377,1898,1550,307,102,12316
10/1/2018,VA,Virginia,Alexandria City,51510,17999,15242,2757,16566,71,16495,1433,85,1348,14505,11750,2755,8808,6364,2444,2183,308,65,6252
10/1/2018,VA,Virginia,Alleghany,51005,4512,3913,599,3645,20,3625,867,12,855,4297,3698,599,3438,2982,456,788,100,53,2497
10/1/2018,VA,Virginia,Amelia,51007,3055,2337,718,2590,*,*,465,14,451,2823,2105,718,2251,1595,656,472,97,33,1649
10/1/2018,VA,Virginia,Amherst,51009,7859,6460,1399,6547,47,6500,1312,30,1282,7307,5908,1399,5886,4689,1197,1260,223,79,4324
10/1/2018,VA,Virginia,Appomattox,51011,3866,3226,640,3181,14,3167,685,20,665,3639,2999,640,2922,2367,555,686,101,37,2098
10/1/2018,VA,Virginia,Arlington,51013,24460,21138,3322,22845,92,22753,1615,85,1530,19258,15936,3322,11665,8700,2965,3042,355,110,8158
10/1/2018,VA,Virginia,Augusta,51015,18287,15807,2480,15846,53,15793,2441,49,2392,17155,14675,2480,13136,11166,1970,1889,414,137,10696
10/1/2018,VA,Virginia,Bath,51017,1262,1161,101,1110,*,*,152,*,*,1193,1092,101,927,844,83,162,36,21,708
10/1/2018,VA,Virginia,Bedford,51019,19867,16347,3520,17043,79,16964,2824,57,2767,18515,14997,3518,14424,11957,2467,2039,499,148,11738
10/1/2018,VA,Virginia,Bland,51021,1795,1366,429,1407,*,*,388,*,*,1694,1265,429,1292,1044,248,244,55,18,975
10/1/2018,VA,Virginia,Botetourt,51023,8640,6642,1998,7535,45,7490,1105,19,1086,8032,6034,1998,6293,4643,1650,792,187,51,5263
10/1/2018,VA,Virginia,Bristol City,51520,4545,2563,1982,3522,*,*,1023,19,1004,4272,2290,1982,3610,1710,1900,1101,151,55,2303
10/1/2018,VA,Virginia,Brunswick,51025,3993,3277,716,3318,27,3291,675,23,652,3720,3004,716,2918,2310,608,1078,116,39,1685
10/1/2018,VA,Virginia,Buchanan,51027,7312,4207,3105,4619,16,4603,2693,16,2677,7067,3962,3105,5921,3684,2237,1684,397,109,3731
10/1/2018,VA,Virginia,Buckingham,51029,3504,2952,552,2865,20,2845,639,21,618,3266,2714,552,2507,2183,324,743,147,47,1570
10/1/2018,VA,Virginia,Buena Vista City,51530,1461,1208,253,1187,*,*,274,*,*,1369,1116,253,1073,869,204,328,49,21,675
10/1/2018,VA,Virginia,Campbell,51031,12709,10491,2218,10558,68,10490,2151,67,2084,11901,9683,2218,9610,7704,1906,2094,364,152,7000
10/1/2018,VA,Virginia,Caroline,51033,5870,4823,1047,4918,34,4884,952,35,917,5293,4246,1047,3612,2709,903,840,213,45,2514
10/1/2018,VA,Virginia,Carroll,51035,8133,6804,1329,6653,19,6634,1480,*,*,7693,6364,1329,6034,5007,1027,1584,265,96,4089
10/1/2018,VA,Virginia,Charles City,51036,1927,1505,422,1639,18,1621,288,16,272,1767,1345,422,1349,992,357,275,81,14,979
10/1/2018,VA,Virginia,Charlotte,51037,3343,2775,568,2724,15,2709,619,18,601,3156,2588,568,2485,1993,492,773,123,49,1540
10/1/2018,VA,Virginia,Charlottesville City,51540,6306,5625,681,5229,26,5203,1077,41,1036,5651,4971,680,4521,3898,623,1253,146,47,3075
10/1/2018,VA,Virginia,Chesapeake City,51550,38075,30172,7903,32770,282,32488,5305,227,5078,34481,26579,7902,21207,14259,6948,4272,917,236,15782
10/1/2018,VA,Virginia,Chesterfield,51041,59908,45496,14412,52387,220,52167,7521,266,7255,54037,39629,14408,41789,29043,12746,5619,1022,260,34888
10/1/2018,VA,Virginia,Clarke,51043,3310,2919,391,3050,12,3038,260,*,*,2983,2592,391,2027,1731,296,271,76,30,1650
10/1/2018,VA,Virginia,Colonial Heights City,51570,4173,3490,683,3559,*,*,614,14,600,3825,3142,683,2507,1918,589,512,110,22,1863
10/1/2018,VA,Virginia,Covington City,51580,1655,1441,214,1274,11,1263,381,*,*,1540,1327,213,1239,1047,192,360,58,15,806
10/1/2018,VA,Virginia,Craig,51045,1341,1041,300,1044,*,*,297,0,297,1235,935,300,976,703,273,211,45,11,709
10/1/2018,VA,Virginia,Culpeper,51047,9449,7986,1463,8187,39,8148,1262,49,1213,8567,7106,1461,5998,4882,1116,1251,239,80,4428
10/1/2018,VA,Virginia,Cumberland,51049,2272,1761,511,1898,*,*,374,*,*,2121,1610,511,1651,1205,446,415,90,32,1114
10/1/2018,VA,Virginia,Danville City,51590,11204,8601,2603,8816,81,8735,2388,119,2269,10521,7918,2603,8787,6945,1842,3288,408,161,4930
10/1/2018,VA,Virginia,Dickenson,51051,4765,2704,2061,3015,*,*,1750,*,*,4571,2510,2061,3774,1944,1830,1145,210,78,2341
10/1/2018,VA,Virginia,Dinwiddie,51053,5916,4687,1229,4771,33,4738,1145,29,1116,5437,4208,1229,4032,2889,1143,934,191,51,2856
10/1/2018,VA,Virginia,Emporia City,51595,1166,876,290,886,16,870,280,*,*,1091,801,290,894,659,235,426,*,*,391
10/1/2018,VA,Virginia,Essex,51057,2945,2386,559,2531,13,2518,414,13,401,2740,2181,559,2054,1637,417,448,86,25,1495
10/1/2018,VA,Virginia,Fairfax,51059,151199,125259,25940,142814,552,142262,8385,470,7915,122017,96103,25914,71992,50212,21780,14044,2670,542,54736
10/1/2018,VA,Virginia,Fairfax City,51600,3837,3116,721,3580,11,3569,257,15,242,3206,2485,721,1982,1420,562,366,68,13,1535
10/1/2018,VA,Virginia,Falls Church City,51610,2040,1726,314,1951,*,*,89,0,89,1586,1272,314,976,704,272,128,*,*,831
10/1/2018,VA,Virginia,Fauquier,51061,12626,11267,1359,11522,62,11460,1104,40,1064,11231,9872,1359,7195,6242,953,996,189,60,5950
10/1/2018,VA,Virginia,Floyd,51063,4065,3286,779,3513,16,3497,552,*,*,3800,3021,779,3006,2289,717,587,99,42,2278
10/1/2018,VA,Virginia,Fluvanna,51065,5887,5142,745,5298,16,5282,589,18,571,5409,4664,745,3951,3352,599,557,112,25,3257
10/1/2018,VA,Virginia,Franklin,51067,14630,10705,3925,12287,45,12242,2343,32,2311,13761,9836,3925,11177,7677,3500,2023,471,157,8526
10/1/2018,VA,Virginia,Franklin City,51620,1994,1652,342,1557,20,1537,437,23,414,1862,1520,342,1515,1204,311,584,62,14,855
10/1/2018,VA,Virginia,Frederick,51069,16497,14481,2016,14667,48,14619,1830,59,1771,15026,13013,2013,10367,8847,1520,1500,359,127,8381
10/1/2018,VA,Virginia,Fredericksburg City,51630,4060,3549,511,3340,23,3317,720,25,695,3629,3118,511,2518,2078,440,809,97,37,1575
10/1/2018,VA,Virginia,Galax City,51640,1844,1673,171,1472,*,*,372,11,361,1745,1574,171,1393,1265,128,592,53,21,727
10/1/2018,VA,Virginia,Giles,51071,4611,3607,1004,3677,20,3657,934,16,918,4358,3354,1004,3580,2999,581,831,117,40,2592
10/1/2018,VA,Virginia,Gloucester,51073,8554,7119,1435,7362,35,7327,1192,23,1169,7903,6468,1435,5096,3880,1216,1004,175,45,3872
10/1/2018,VA,Virginia,Goochland,51075,5822,4598,1224,5328,27,5301,494,16,478,5293,4070,1223,4335,3355,980,397,98,31,3809
10/1/2018,VA,Virginia,Grayson,51077,4704,3875,829,3888,*,*,816,11,805,4478,3649,829,3427,2721,706,1003,182,88,2154
10/1/2018,VA,Virginia,Greene,51079,3827,3353,474,3349,14,3335,478,*,*,3484,3010,474,2519,2107,412,466,87,24,1942
10/1/2018,VA,Virginia,Greensville,51081,2476,1849,627,1990,22,1968,486,17,469,2318,1691,627,1860,1379,481,516,119,32,1193
10/1/2018,VA,Virginia,Halifax,51083,9691,8149,1542,7951,69,7882,1740,48,1692,9113,7571,1542,7332,5986,1346,2138,434,143,4617
10/1/2018,VA,Virginia,Hampton City,51650,25057,18699,6358,20619,189,20430,4438,203,4235,22892,16534,6358,14020,8099,5921,3810,771,171,9268
10/1/2018,VA,Virginia,Hanover,51085,20883,15847,5036,19004,84,18920,1879,50,1829,19035,14000,5035,15354,11256,4098,1455,334,95,13470
10/1/2018,VA,Virginia,Harrisonburg City,51660,5405,4786,619,4565,15,4550,840,22,818,4900,4281,619,3915,3479,436,1023,139,26,2727
10/1/2018,VA,Virginia,Henrico,51087,56438,41559,14879,49448,318,49130,6990,283,6707,50989,36111,14878,41386,28548,12838,6556,1384,399,33047
10/1/2018,VA,Virginia,Henry,51089,15075,10996,4079,11988,68,11920,3087,57,3030,14346,10267,4079,12153,8443,3710,3106,713,248,8086
10/1/2018,VA,Virginia,Highland,51091,787,718,69,717,*,*,70,*,*,739,670,69,550,494,56,52,*,*,468
10/1/2018,VA,Virginia,Hopewell City,51670,4529,3525,1004,3503,28,3475,1026,32,994,4217,3213,1004,2930,1974,956,1024,150,29,1727
10/1/2018,VA,Virginia,Isle of Wight,51093,8290,6561,1729,7295,46,7249,995,36,959,7652,5923,1729,5421,3863,1558,973,196,67,4185
10/1/2018,VA,Virginia,James City,51095,20471,17764,2707,19255,61,19194,1216,58,1158,18968,16264,2704,12156,10137,2019,862,211,58,11025
10/1/2018,VA,Virginia,King and Queen,51097,1776,1478,298,1498,14,1484,278,*,*,1646,1348,298,1224,969,255,269,69,12,874
10/1/2018,VA,Virginia,King George,51099,3889,3511,378,3358,13,3345,531,25,506,3379,3001,378,1690,1384,306,464,73,17,1136
10/1/2018,VA,Virginia,King William,51101,3421,2886,535,2925,25,2900,496,19,477,3126,2591,535,2512,2068,444,406,114,21,1971
10/1/2018,VA,Virginia,Lancaster,51103,4326,3727,599,3982,18,3964,344,16,328,4110,3511,599,2990,2622,368,500,99,16,2375
10/1/2018,VA,Virginia,Lee,51105,6440,3710,2730,4443,18,4425,1997,13,1984,6128,3400,2728,4997,2459,2538,1963,258,87,2689
10/1/2018,VA,Virginia,Lexington City,51678,1653,1496,157,1524,11,1513,129,*,*,1524,1367,157,1169,1049,120,208,33,12,916
10/1/2018,VA,Virginia,Loudoun,51107,37411,31117,6294,34960,147,34813,2451,109,2342,31002,24711,6291,20595,15301,5294,3186,638,148,16623
10/1/2018,VA,Virginia,Louisa,51109,8097,6596,1501,6834,40,6794,1263,34,1229,7430,5929,1501,5483,4207,1276,1084,245,62,4092
10/1/2018,VA,Virginia,Lunenburg,51111,3049,2635,414,2487,19,2468,562,18,544,2818,2404,414,2146,1790,356,722,106,40,1278
10/1/2018,VA,Virginia,Lynchburg City,51680,14684,12194,2490,12045,83,11962,2639,104,2535,13633,11143,2490,11040,8877,2163,3008,443,130,7459
10/1/2018,VA,Virginia,Madison,51113,2993,2564,429,2663,11,2652,330,12,318,2792,2363,429,2069,1739,330,393,85,21,1570
10/1/2018,VA,Virginia,Manassas City,51683,4517,3658,859,3981,22,3959,536,43,493,3795,2936,859,2639,1902,737,526,90,39,1984
10/1/2018,VA,Virginia,Manassas Park City,51685,1335,1022,313,1159,13,1146,176,12,164,1125,813,312,782,502,280,204,*,*,520
10/1/2018,VA,Virginia,Martinsville City,51690,3973,3014,959,2946,35,2911,1027,41,986,3759,2800,959,3226,2318,908,1344,161,60,1661
10/1/2018,VA,Virginia,Mathews,51115,2852,2392,460,2628,*,*,224,*,*,2706,2246,460,1896,1525,371,272,42,20,1562
10/1/2018,VA,Virginia,Mecklenburg,51117,9172,7409,1763,7616,62,7554,1556,60,1496,8640,6877,1763,6787,5348,1439,1873,356,100,4458
10/1/2018,VA,Virginia,Middlesex,51119,3621,3068,553,3249,14,3235,372,*,*,3415,2862,553,2598,2196,402,465,78,29,2026
10/1/2018,VA,Virginia,Montgomery,51121,13995,11484,2511,11681,41,11640,2314,30,2284,12672,10161,2511,10453,8200,2253,1912,354,119,8068
10/1/2018,VA,Virginia,Nelson,51125,4656,4014,642,4138,15,4123,518,*,*,4280,3639,641,3130,2589,541,588,103,43,2396
10/1/2018,VA,Virginia,New Kent,51127,4518,3702,816,4056,18,4038,462,*,*,4120,3304,816,2893,2275,618,299,71,13,2510
10/1/2018,VA,Virginia,Newport News City,51700,28248,20944,7304,23202,199,23003,5046,249,4797,25844,18542,7302,16904,10040,6864,4857,897,221,10929
10/1/2018,VA,Virginia,Norfolk City,51710,32966,24560,8406,26379,256,26123,6587,335,6252,29703,21297,8406,20081,12167,7914,7340,1324,299,11118
10/1/2018,VA,Virginia,Northampton,51131,3653,3012,641,3136,19,3117,517,22,495,3416,2775,641,2738,2207,531,932,88,28,1690
10/1/2018,VA,Virginia,Northumberland,51133,4633,3988,645,4302,16,4286,331,14,317,4334,3689,645,2892,2528,364,435,88,30,2339
10/1/2018,VA,Virginia,Norton City,51720,1186,771,415,804,*,*,382,*,*,1095,680,415,897,528,369,358,52,15,472
10/1/2018,VA,Virginia,Nottoway,51135,3663,3057,606,2998,23,2975,665,15,650,3403,2797,606,2662,2245,417,893,131,39,1599
10/1/2018,VA,Virginia,Orange,51137,8840,7684,1156,7791,44,7747,1049,36,1013,8121,6965,1156,5387,4626,761,992,209,63,4123
10/1/2018,VA,Virginia,Page,51139,6213,5347,866,5110,23,5087,1103,23,1080,5823,4957,866,4265,3549,716,1134,240,81,2810
10/1/2018,VA,Virginia,Patrick,51141,5162,3933,1229,4303,*,*,859,11,848,4899,3672,1227,3997,2991,1006,1028,184,69,2716
10/1/2018,VA,Virginia,Petersburg City,51730,7193,5380,1813,5356,92,5264,1837,87,1750,6570,4757,1813,4788,3041,1747,2094,338,66,2290
10/1/2018,VA,Virginia,Pittsylvania,51143,16311,12362,3949,13361,76,13285,2950,81,2869,15332,11383,3949,12587,9733,2854,3086,529,205,8767
10/1/2018,VA,Virginia,Poquoson City,51735,2539,2230,309,2359,*,*,180,*,*,2336,2027,309,1189,923,266,101,20,12,1056
10/1/2018,VA,Virginia,Portsmouth City,51740,18239,13629,4610,14202,170,14032,4037,217,3820,16328,11720,4608,10848,6503,4345,3942,689,144,6073
10/1/2018,VA,Virginia,Powhatan,51145,5945,4729,1216,5341,19,5322,604,17,587,5448,4232,1216,4370,3344,1026,395,115,30,3830
10/1/2018,VA,Virginia,Prince Edward,51147,4689,3925,764,3763,33,3730,926,33,893,4355,3591,764,3357,2803,554,1100,170,49,2038
10/1/2018,VA,Virginia,Prince George,51149,5959,5153,806,5042,27,5015,917,37,880,5519,4713,806,3345,2648,697,570,120,31,2624
10/1/2018,VA,Virginia,Prince William,51153,48585,39633,8952,43411,273,43138,5174,306,4868,41476,32528,8948,24005,16149,7856,5297,1057,219,17432
10/1/2018,VA,Virginia,Pulaski,51155,9122,7286,1836,7283,31,7252,1839,28,1811,8519,6683,1836,6959,5382,1577,1635,302,111,4911
10/1/2018,VA,Virginia,Radford City,51750,2053,1687,366,1666,*,*,387,*,*,1877,1511,366,1575,1247,328,341,42,25,1167
10/1/2018,VA,Virginia,Rappahannock,51157,2044,1848,196,1901,*,*,143,*,*,1850,1655,195,1254,1122,132,149,*,*,1062
10/1/2018,VA,Virginia,Richmond,51159,2046,1649,397,1784,*,*,262,13,249,1896,1499,397,1413,1160,253,310,69,15,1019
10/1/2018,VA,Virginia,Richmond City,51760,34125,23061,11064,26992,271,26721,7133,355,6778,30729,19665,11064,25917,15467,10450,9001,1403,293,15220
10/1/2018,VA,Virginia,Roanoke,51161,23668,18292,5376,21037,90,20947,2631,61,2570,21910,16536,5374,17569,13101,4468,2039,444,133,14953
10/1/2018,VA,Virginia,Roanoke City,51770,20673,14933,5740,15605,121,15484,5068,158,4910,18821,13085,5736,15308,10071,5237,4894,863,219,9332
10/1/2018,VA,Virginia,Rockbridge,51163,6033,5150,883,5131,17,5114,902,11,891,5607,4724,883,4206,3491,715,828,185,61,3132
10/1/2018,VA,Virginia,Rockingham,51165,17478,15009,2469,15326,41,15285,2152,41,2111,16165,13697,2468,12591,10879,1712,1830,494,141,10126
10/1/2018,VA,Virginia,Russell,51167,7895,4886,3009,5463,11,5452,2432,16,2416,7560,4552,3008,6415,4001,2414,1659,333,138,4285
10/1/2018,VA,Virginia,Salem City,51775,6157,4894,1263,5205,27,5178,952,16,936,5681,4418,1263,4536,3439,1097,853,146,42,3495
10/1/2018,VA,Virginia,Scott,51169,6637,3194,3443,4990,11,4979,1647,16,1631,6375,2932,3443,5537,2195,3342,1531,241,107,3658
10/1/2018,VA,Virginia,Shenandoah,51171,10556,9224,1332,9359,28,9331,1197,29,1168,9867,8535,1332,6961,5951,1010,1259,265,86,5351
10/1/2018,VA,Virginia,Smyth,51173,8814,6456,2358,6604,29,6575,2210,25,2185,8326,5968,2358,6828,4706,2122,2151,416,129,4132
10/1/2018,VA,Virginia,Southampton,51175,4133,3481,652,3474,30,3444,659,21,638,3847,3195,652,3003,2449,554,702,122,32,2147
10/1/2018,VA,Virginia,Spotsylvania,51177,20907,18294,2613,18205,104,18101,2702,100,2602,18588,15976,2612,11184,9169,2015,2039,518,130,8497
10/1/2018,VA,Virginia,Stafford,51179,17444,15632,1812,15353,94,15259,2091,78,2013,15283,13473,1810,7742,6323,1419,1411,377,87,5867
10/1/2018,VA,Virginia,Staunton City,51790,6292,5511,781,5232,23,5209,1060,14,1046,5918,5137,781,4642,4023,619,1095,149,59,3339
10/1/2018,VA,Virginia,Suffolk City,51800,16181,12784,3397,13304,102,13202,2877,101,2776,14802,11405,3397,10167,7119,3048,2746,456,118,6847
10/1/2018,VA,Virginia,Surry,51181,1613,1273,340,1369,11,1358,244,*,*,1481,1141,340,1071,758,313,210,63,13,785
10/1/2018,VA,Virginia,Sussex,51183,2411,1869,542,1974,29,1945,437,*,*,2238,1696,542,1699,1194,505,474,134,23,1068
10/1/2018,VA,Virginia,Tazewell,51185,12052,8115,3937,8894,38,8856,3158,42,3116,11411,7475,3936,9115,6443,2672,2290,463,184,6178
10/1/2018,VA,Virginia,Unknown,51999,*,*,*,*,*,*,*,*,*,*,*,*,*,*,*,*,*,*,*
10/1/2018,VA,Virginia,Virginia Beach City,51810,71725,58895,12830,63271,368,62903,8454,343,8111,65699,52876,12823,37740,26306,11434,6926,1487,390,28937
10/1/2018,VA,Virginia,Warren,51187,7587,6737,850,6517,21,6496,1070,31,1039,6925,6075,850,4693,4052,641,926,230,70,3467
10/1/2018,VA,Virginia,Washington,51191,15080,9652,5428,12170,39,12131,2910,28,2882,14236,8809,5427,11691,6776,4915,2484,537,190,8480
10/1/2018,VA,Virginia,Waynesboro City,51820,4782,4134,648,3922,20,3902,860,28,832,4459,3811,648,3519,2980,539,893,108,38,2480
10/1/2018,VA,Virginia,Westmoreland,51193,5013,4394,619,4400,21,4379,613,12,601,4583,3964,619,2913,2427,486,766,132,47,1968
10/1/2018,VA,Virginia,Williamsburg City,51830,2600,2211,389,2382,*,*,218,12,206,2394,2005,389,1688,1368,320,229,*,*,1425
10/1/2018,VA,Virginia,Winchester City,51840,5219,4596,623,4450,21,4429,769,17,752,4730,4107,623,3411,2940,471,853,136,47,2375
10/1/2018,VA,Virginia,Wise,51195,10728,6458,4270,7204,24,7180,3524,26,3498,10151,5881,4270,8094,4191,3903,2470,469,174,4981
10/1/2018,VA,Virginia,Wythe,51197,7690,5830,1860,5992,27,5965,1698,19,1679,7281,5422,1859,5861,4258,1603,1584,272,110,3895
10/1/2018,VA,Virginia,York,51199,11933,10338,1595,10938,38,10900,995,29,966,10911,9316,1595,5832,4496,1336,692,170,40,4930
9/1/2018,VA,Virginia,Accomack,51001,8799,7340,1459,7605,38,7567,1194,44,1150,8163,6704,1459,5954,4815,1139,1489,365,87,4013
9/1/2018,VA,Virginia,Albemarle,51003,20721,18476,2245,19131,53,19078,1590,50,1540,18610,16367,2243,14239,12352,1887,1555,307,97,12280
9/1/2018,VA,Virginia,Alexandria City,51510,17934,15192,2742,16508,73,16435,1426,84,1342,14463,11723,2740,8773,6343,2430,2170,306,64,6233
9/1/2018,VA,Virginia,Alleghany,51005,4507,3908,599,3643,20,3623,864,14,850,4284,3685,599,3430,2974,456,788,102,53,2487
9/1/2018,VA,Virginia,Amelia,51007,3056,2339,717,2591,*,*,465,14,451,2824,2107,717,2251,1595,656,473,96,33,1649
9/1/2018,VA,Virginia,Amherst,51009,7850,6455,1395,6544,47,6497,1306,29,1277,7297,5902,1395,5875,4678,1197,1248,225,78,4324
9/1/2018,VA,Virginia,Appomattox,51011,3857,3209,648,3174,14,3160,683,20,663,3629,2981,648,2919,2358,561,684,103,37,2095
9/1/2018,VA,Virginia,Arlington,51013,24375,21077,3298,22765,93,22672,1610,84,1526,19229,15931,3298,11624,8684,2940,3026,353,108,8137
9/1/2018,VA,Virginia,Augusta,51015,18260,15778,2482,15824,54,15770,2436,49,2387,17131,14649,2482,13118,11146,1972,1879,414,137,10688
9/1/2018,VA,Virginia,Bath,51017,1262,1161,101,1112,*,*,150,*,*,1195,1094,101,931,848,83,162,37,22,710
9/1/2018,VA,Virginia,Bedford,51019,19853,16328,3525,17034,83,16951,2819,57,2762,18497,14974,3523,14401,11931,2470,2025,498,149,11729
9/1/2018,VA,Virginia,Bland,51021,1794,1367,427,1406,*,*,388,*,*,1690,1263,427,1285,1040,245,243,55,18,969
9/1/2018,VA,Virginia,Botetourt,51023,8632,6639,1993,7528,46,7482,1104,19,1085,8022,6029,1993,6288,4644,1644,795,188,53,5252
9/1/2018,VA,Virginia,Bristol City,51520,4534,2552,1982,3514,*,*,1020,19,1001,4265,2283,1982,3604,1705,1899,1094,152,53,2305
9/1/2018,VA,Virginia,Brunswick,51025,3988,3273,715,3317,27,3290,671,22,649,3714,2999,715,2920,2313,607,1077,117,39,1687
9/1/2018,VA,Virginia,Buchanan,51027,7304,4208,3096,4620,16,4604,2684,16,2668,7056,3960,3096,5900,3674,2226,1670,399,107,3724
9/1/2018,VA,Virginia,Buckingham,51029,3504,2950,554,2864,21,2843,640,22,618,3268,2714,554,2506,2183,323,739,150,47,1570
9/1/2018,VA,Virginia,Buena Vista City,51530,1457,1206,251,1183,*,*,274,*,*,1366,1115,251,1067,865,202,324,50,21,672
9/1/2018,VA,Virginia,Campbell,51031,12713,10492,2221,10567,70,10497,2146,67,2079,11912,9691,2221,9612,7704,1908,2086,363,155,7008
9/1/2018,VA,Virginia,Caroline,51033,5849,4799,1050,4900,35,4865,949,36,913,5276,4226,1050,3597,2693,904,830,216,46,2505
9/1/2018,VA,Virginia,Carroll,51035,8129,6802,1327,6646,19,6627,1483,*,*,7692,6365,1327,6034,5007,1027,1580,268,96,4090
9/1/2018,VA,Virginia,Charles City,51036,1919,1499,420,1632,19,1613,287,16,271,1757,1337,420,1348,992,356,270,82,15,981
9/1/2018,VA,Virginia,Charlotte,51037,3343,2777,566,2724,15,2709,619,18,601,3157,2591,566,2485,1995,490,771,124,49,1541
9/1/2018,VA,Virginia,Charlottesville City,51540,6289,5611,678,5223,26,5197,1066,40,1026,5640,4963,677,4515,3895,620,1244,149,48,3074
9/1/2018,VA,Virginia,Chesapeake City,51550,37978,30086,7892,32692,283,32409,5286,227,5059,34396,26505,7891,21168,14234,6934,4259,921,235,15753
9/1/2018,VA,Virginia,Chesterfield,51041,59740,45343,14397,52242,228,52014,7498,265,7233,53903,39510,14393,41670,28942,12728,5585,1025,257,34803
9/1/2018,VA,Virginia,Clarke,51043,3307,2915,392,3047,12,3035,260,*,*,2981,2589,392,2024,1727,297,272,75,29,1648
9/1/2018,VA,Virginia,Colonial Heights City,51570,4168,3491,677,3554,*,*,614,14,600,3824,3147,677,2507,1926,581,513,112,22,1860
9/1/2018,VA,Virginia,Covington City,51580,1655,1440,215,1278,11,1267,377,*,*,1543,1329,214,1242,1050,192,357,59,15,811
9/1/2018,VA,Virginia,Craig,51045,1339,1040,299,1042,*,*,297,0,297,1232,933,299,974,702,272,208,46,11,709
9/1/2018,VA,Virginia,Culpeper,51047,9438,7974,1464,8182,39,8143,1256,49,1207,8556,7094,1462,5985,4867,1118,1241,237,80,4427
9/1/2018,VA,Virginia,Cumberland,51049,2272,1763,509,1899,*,*,373,*,*,2118,1609,509,1652,1208,444,415,90,31,1116
9/1/2018,VA,Virginia,Danville City,51590,11201,8608,2593,8820,84,8736,2381,119,2262,10522,7929,2593,8787,6958,1829,3286,407,161,4933
9/1/2018,VA,Virginia,Dickenson,51051,4763,2709,2054,3019,*,*,1744,*,*,4569,2515,2054,3759,1935,1824,1138,210,80,2331
9/1/2018,VA,Virginia,Dinwiddie,51053,5910,4687,1223,4763,33,4730,1147,30,1117,5439,4216,1223,4031,2896,1135,930,194,51,2856
9/1/2018,VA,Virginia,Emporia City,51595,1161,872,289,883,16,867,278,*,*,1086,797,289,888,652,236,422,*,*,388
9/1/2018,VA,Virginia,Essex,51057,2939,2378,561,2527,13,2514,412,12,400,2735,2174,561,2052,1633,419,448,86,24,1494
9/1/2018,VA,Virginia,Fairfax,51059,150564,124734,25830,142230,560,141670,8334,465,7869,121592,95789,25803,71706,50023,21683,13995,2664,529,54518
9/1/2018,VA,Virginia,Fairfax City,51600,3827,3104,723,3568,12,3556,259,15,244,3198,2475,723,1973,1408,565,366,66,13,1528
9/1/2018,VA,Virginia,Falls Church City,51610,2026,1707,319,1940,*,*,86,0,86,1578,1259,319,973,697,276,128,*,*,828
9/1/2018,VA,Virginia,Fauquier,51061,12588,11229,1359,11490,62,11428,1098,39,1059,11187,9828,1359,7155,6203,952,986,188,61,5920
9/1/2018,VA,Virginia,Floyd,51063,4057,3277,780,3509,16,3493,548,*,*,3797,3017,780,3004,2286,718,581,99,43,2281
9/1/2018,VA,Virginia,Fluvanna,51065,5867,5122,745,5280,17,5263,587,18,569,5393,4648,745,3944,3344,600,555,111,25,3253
9/1/2018,VA,Virginia,Franklin,51067,14613,10690,3923,12276,45,12231,2337,30,2307,13746,9823,3923,11178,7682,3496,2017,469,158,8534
9/1/2018,VA,Virginia,Franklin City,51620,1988,1648,340,1552,20,1532,436,24,412,1861,1521,340,1515,1206,309,585,62,14,854
9/1/2018,VA,Virginia,Frederick,51069,16454,14437,2017,14630,49,14581,1824,62,1762,14993,12979,2014,10344,8823,1521,1497,358,127,8362
9/1/2018,VA,Virginia,Fredericksburg City,51630,4044,3539,505,3328,23,3305,716,25,691,3614,3109,505,2504,2068,436,800,98,38,1568
9/1/2018,VA,Virginia,Galax City,51640,1840,1670,170,1470,*,*,370,11,359,1741,1571,170,1390,1263,127,590,54,19,727
9/1/2018,VA,Virginia,Giles,51071,4607,3603,1004,3671,20,3651,936,17,919,4354,3350,1004,3576,2997,579,824,121,40,2591
9/1/2018,VA,Virginia,Gloucester,51073,8540,7111,1429,7352,37,7315,1188,23,1165,7888,6459,1429,5084,3877,1207,1003,175,41,3865
9/1/2018,VA,Virginia,Goochland,51075,5810,4591,1219,5314,27,5287,496,18,478,5272,4054,1218,4325,3351,974,402,97,32,3794
9/1/2018,VA,Virginia,Grayson,51077,4696,3878,818,3885,*,*,811,11,800,4470,3652,818,3418,2723,695,997,181,89,2151
9/1/2018,VA,Virginia,Greene,51079,3806,3332,474,3331,14,3317,475,*,*,3467,2993,474,2504,2093,411,461,86,24,1933
9/1/2018,VA,Virginia,Greensville,51081,2473,1845,628,1992,23,1969,481,17,464,2313,1685,628,1858,1378,480,511,119,32,1196
9/1/2018,VA,Virginia,Halifax,51083,9685,8144,1541,7944,69,7875,1741,49,1692,9110,7569,1541,7325,5982,1343,2139,435,145,4606
9/1/2018,VA,Virginia,Hampton City,51650,24998,18653,6345,20574,195,20379,4424,203,4221,22852,16507,6345,14002,8099,5903,3809,778,171,9244
9/1/2018,VA,Virginia,Hanover,51085,20811,15778,5033,18932,85,18847,1879,51,1828,19000,13968,5032,15315,11223,4092,1449,338,93,13435
9/1/2018,VA,Virginia,Harrisonburg City,51660,5380,4757,623,4551,15,4536,829,21,808,4879,4256,623,3896,3456,440,1017,139,25,2715
9/1/2018,VA,Virginia,Henrico,51087,56283,41417,14866,49322,320,49002,6961,282,6679,50894,36029,14865,41307,28489,12818,6515,1391,399,33002
9/1/2018,VA,Virginia,Henry,51089,15038,10963,4075,11960,69,11891,3078,57,3021,14309,10234,4075,12117,8410,3707,3090,710,243,8074
9/1/2018,VA,Virginia,Highland,51091,786,716,70,718,*,*,68,*,*,735,665,70,549,492,57,51,*,*,467
9/1/2018,VA,Virginia,Hopewell City,51670,4526,3528,998,3500,29,3471,1026,32,994,4217,3219,998,2926,1976,950,1021,154,29,1722
9/1/2018,VA,Virginia,Isle of Wight,51093,8257,6527,1730,7267,48,7219,990,36,954,7633,5903,1730,5403,3845,1558,964,200,67,4172
9/1/2018,VA,Virginia,James City,51095,20465,17748,2717,19249,62,19187,1216,58,1158,18964,16250,2714,12151,10124,2027,856,218,57,11020
9/1/2018,VA,Virginia,King and Queen,51097,1779,1481,298,1502,13,1489,277,*,*,1647,1349,298,1226,972,254,271,68,12,875
9/1/2018,VA,Virginia,King George,51099,3880,3502,378,3354,13,3341,526,25,501,3369,2991,378,1688,1382,306,460,73,17,1138
9/1/2018,VA,Virginia,King William,51101,3411,2877,534,2916,26,2890,495,19,476,3120,2586,534,2509,2065,444,404,114,21,1970
9/1/2018,VA,Virginia,Lancaster,51103,4320,3720,600,3979,18,3961,341,16,325,4108,3508,600,2991,2621,370,499,100,15,2377
9/1/2018,VA,Virginia,Lee,51105,6449,3720,2729,4458,18,4440,1991,13,1978,6136,3409,2727,5009,2471,2538,1954,262,88,2705
9/1/2018,VA,Virginia,Lexington City,51678,1651,1495,156,1522,11,1511,129,*,*,1525,1369,156,1171,1052,119,209,33,12,917
9/1/2018,VA,Virginia,Loudoun,51107,37234,30999,6235,34796,151,34645,2438,113,2325,30906,24674,6232,20509,15267,5242,3168,631,144,16566
9/1/2018,VA,Virginia,Louisa,51109,8085,6587,1498,6823,40,6783,1262,34,1228,7411,5913,1498,5474,4201,1273,1087,241,65,4081
9/1/2018,VA,Virginia,Lunenburg,51111,3046,2633,413,2486,21,2465,560,18,542,2809,2396,413,2134,1778,356,719,106,41,1268
9/1/2018,VA,Virginia,Lynchburg City,51680,14680,12178,2502,12042,85,11957,2638,104,2534,13633,11131,2502,11042,8871,2171,2998,446,131,7467
9/1/2018,VA,Virginia,Madison,51113,2991,2562,429,2664,11,2653,327,12,315,2790,2361,429,2068,1738,330,394,84,21,1569
9/1/2018,VA,Virginia,Manassas City,51683,4495,3646,849,3966,22,3944,529,42,487,3782,2933,849,2619,1894,725,514,90,41,1974
9/1/2018,VA,Virginia,Manassas Park City,51685,1329,1017,312,1154,13,1141,175,12,163,1123,812,311,781,502,279,203,*,*,522
9/1/2018,VA,Virginia,Martinsville City,51690,3965,3008,957,2938,35,2903,1027,41,986,3753,2796,957,3221,2315,906,1339,160,60,1662
9/1/2018,VA,Virginia,Mathews,51115,2852,2393,459,2629,*,*,223,*,*,2707,2248,459,1896,1526,370,272,41,18,1565
9/1/2018,VA,Virginia,Mecklenburg,51117,9163,7412,1751,7614,64,7550,1549,60,1489,8629,6878,1751,6779,5354,1425,1868,359,100,4452
9/1/2018,VA,Virginia,Middlesex,51119,3611,3061,550,3240,14,3226,371,*,*,3406,2856,550,2590,2191,399,462,78,29,2021
9/1/2018,VA,Virginia,Montgomery,51121,13952,11444,2508,11646,42,11604,2306,30,2276,12639,10131,2508,10427,8180,2247,1907,355,118,8047
9/1/2018,VA,Virginia,Nelson,51125,4649,4007,642,4135,16,4119,514,*,*,4271,3630,641,3123,2584,539,584,103,43,2393
9/1/2018,VA,Virginia,New Kent,51127,4505,3689,816,4044,18,4026,461,*,*,4106,3290,816,2891,2273,618,299,72,13,2507
9/1/2018,VA,Virginia,Newport News City,51700,28165,20887,7278,23144,204,22940,5021,248,4773,25772,18496,7276,16851,10018,6833,4827,896,224,10904
9/1/2018,VA,Virginia,Norfolk City,51710,32918,24563,8355,26346,261,26085,6572,334,6238,29661,21307,8354,20061,12197,7864,7314,1330,300,11117
9/1/2018,VA,Virginia,Northampton,51131,3645,3006,639,3129,19,3110,516,22,494,3406,2767,639,2730,2201,529,929,91,28,1682
9/1/2018,VA,Virginia,Northumberland,51133,4628,3990,638,4301,16,4285,327,13,314,4324,3686,638,2874,2519,355,431,82,30,2331
9/1/2018,VA,Virginia,Norton City,51720,1189,775,414,808,*,*,381,*,*,1099,685,414,899,532,367,359,53,15,472
9/1/2018,VA,Virginia,Nottoway,51135,3671,3071,600,3007,26,2981,664,16,648,3413,2813,600,2662,2252,410,894,132,40,1596
9/1/2018,VA,Virginia,Orange,51137,8820,7661,1159,7773,45,7728,1047,35,1012,8106,6947,1159,5376,4613,763,992,211,64,4109
9/1/2018,VA,Virginia,Page,51139,6201,5338,863,5099,23,5076,1102,24,1078,5820,4957,863,4263,3549,714,1126,243,80,2814
9/1/2018,VA,Virginia,Patrick,51141,5162,3932,1230,4305,*,*,857,11,846,4902,3674,1228,3995,2989,1006,1019,185,69,2722
9/1/2018,VA,Virginia,Petersburg City,51730,7189,5396,1793,5356,94,5262,1833,88,1745,6573,4780,1793,4782,3055,1727,2083,338,66,2295
9/1/2018,VA,Virginia,Pittsylvania,51143,16288,12341,3947,13356,79,13277,2932,80,2852,15314,11367,3947,12557,9705,2852,3067,532,204,8754
9/1/2018,VA,Virginia,Poquoson City,51735,2529,2223,306,2350,*,*,179,*,*,2328,2022,306,1180,917,263,99,20,13,1048
9/1/2018,VA,Virginia,Portsmouth City,51740,18184,13597,4587,14166,176,13990,4018,219,3799,16272,11687,4585,10820,6500,4320,3906,698,144,6072
9/1/2018,VA,Virginia,Powhatan,51145,5928,4711,1217,5322,20,5302,606,18,588,5435,4218,1217,4363,3335,1028,398,114,30,3821
9/1/2018,VA,Virginia,Prince Edward,51147,4693,3923,770,3770,33,3737,923,34,889,4361,3591,770,3359,2800,559,1100,171,49,2039
9/1/2018,VA,Virginia,Prince George,51149,5938,5130,808,5024,27,4997,914,37,877,5499,4691,808,3329,2630,699,561,123,32,2613
9/1/2018,VA,Virginia,Prince William,51153,48362,39449,8913,43220,277,42943,5142,305,4837,41298,32389,8909,23898,16080,7818,5253,1055,218,17372
9/1/2018,VA,Virginia,Pulaski,51155,9124,7282,1842,7295,32,7263,1829,28,1801,8527,6685,1842,6966,5381,1585,1632,303,113,4918
9/1/2018,VA,Virginia,Radford City,51750,2052,1688,364,1664,*,*,388,*,*,1881,1517,364,1573,1247,326,340,43,25,1165
9/1/2018,VA,Virginia,Rappahannock,51157,2036,1841,195,1894,*,*,142,*,*,1842,1648,194,1246,1115,131,149,*,*,1056
9/1/2018,VA,Virginia,Richmond,51159,2041,1650,391,1778,*,*,263,13,250,1894,1503,391,1409,1161,248,310,70,15,1014
9/1/2018,VA,Virginia,Richmond City,51760,34044,23020,11024,26927,273,26654,7117,356,6761,30679,19655,11024,25861,15454,10407,8945,1408,293,15215
9/1/2018,VA,Virginia,Roanoke,51161,23653,18278,5375,21031,95,20936,2622,61,2561,21906,16533,5373,17568,13108,4460,2034,441,133,14960
9/1/2018,VA,Virginia,Roanoke City,51770,20644,14930,5714,15592,123,15469,5052,159,4893,18798,13088,5710,15274,10063,5211,4862,865,220,9327
9/1/2018,VA,Virginia,Rockbridge,51163,6026,5148,878,5129,17,5112,897,11,886,5605,4727,878,4201,3491,710,825,185,60,3131
9/1/2018,VA,Virginia,Rockingham,51165,17462,14984,2478,15321,43,15278,2141,41,2100,16135,13658,2477,12559,10844,1715,1829,491,141,10098
9/1/2018,VA,Virginia,Russell,51167,7889,4887,3002,5471,11,5460,2418,16,2402,7546,4545,3001,6410,4003,2407,1647,328,139,4296
9/1/2018,VA,Virginia,Salem City,51775,6153,4889,1264,5205,27,5178,948,16,932,5678,4414,1264,4530,3432,1098,851,148,41,3490
9/1/2018,VA,Virginia,Scott,51169,6635,3199,3436,4993,11,4982,1642,17,1625,6372,2936,3436,5532,2197,3335,1527,242,106,3657
9/1/2018,VA,Virginia,Shenandoah,51171,10536,9202,1334,9343,28,9315,1193,28,1165,9848,8514,1334,6940,5928,1012,1257,266,84,5333
9/1/2018,VA,Virginia,Smyth,51173,8809,6461,2348,6606,29,6577,2203,26,2177,8324,5976,2348,6815,4704,2111,2144,421,124,4126
9/1/2018,VA,Virginia,Southampton,51175,4123,3471,652,3468,31,3437,655,21,634,3838,3186,652,2996,2443,553,703,119,33,2141
9/1/2018,VA,Virginia,Spotsylvania,51177,20861,18243,2618,18165,107,18058,2696,99,2597,18551,15934,2617,11179,9159,2020,2029,522,132,8496
9/1/2018,VA,Virginia,Stafford,51179,17382,15574,1808,15298,95,15203,2084,78,2006,15229,13423,1806,7718,6306,1412,1402,376,87,5853
9/1/2018,VA,Virginia,Staunton City,51790,6267,5489,778,5214,23,5191,1053,14,1039,5892,5114,778,4625,4009,616,1088,150,59,3328
9/1/2018,VA,Virginia,Suffolk City,51800,16134,12762,3372,13261,103,13158,2873,102,2771,14768,11396,3372,10132,7110,3022,2725,457,119,6831
9/1/2018,VA,Virginia,Surry,51181,1606,1266,340,1361,11,1350,245,*,*,1477,1137,340,1070,758,312,210,64,13,783
9/1/2018,VA,Virginia,Sussex,51183,2401,1861,540,1967,29,1938,434,*,*,2231,1691,540,1695,1192,503,472,134,23,1066
9/1/2018,VA,Virginia,Tazewell,51185,12042,8120,3922,8897,38,8859,3145,40,3105,11387,7466,3921,9072,6418,2654,2280,459,184,6149
9/1/2018,VA,Virginia,Unknown,51999,*,*,*,*,*,*,*,*,*,*,*,*,*,*,*,*,*,*,*
9/1/2018,VA,Virginia,Virginia Beach City,51810,71510,58720,12790,63085,373,62712,8425,343,8082,65518,52735,12783,37622,26231,11391,6883,1495,386,28858
9/1/2018,VA,Virginia,Warren,51187,7560,6705,855,6499,21,6478,1061,31,1030,6898,6043,855,4672,4027,645,919,229,69,3455
9/1/2018,VA,Virginia,Washington,51191,15066,9654,5412,12169,40,12129,2897,28,2869,14226,8815,5411,11669,6770,4899,2468,539,188,8474
9/1/2018,VA,Virginia,Waynesboro City,51820,4774,4126,648,3917,21,3896,857,26,831,4457,3809,648,3510,2971,539,887,109,40,2474
9/1/2018,VA,Virginia,Westmoreland,51193,5002,4383,619,4394,22,4372,608,12,596,4572,3953,619,2910,2424,486,761,134,47,1968
9/1/2018,VA,Virginia,Williamsburg City,51830,2595,2205,390,2376,*,*,219,12,207,2395,2005,390,1685,1364,321,230,*,*,1421
9/1/2018,VA,Virginia,Winchester City,51840,5205,4580,625,4440,21,4419,765,16,749,4723,4098,625,3407,2934,473,845,136,46,2380
9/1/2018,VA,Virginia,Wise,51195,10724,6473,4251,7212,24,7188,3512,26,3486,10151,5900,4251,8080,4196,3884,2460,465,172,4983
9/1/2018,VA,Virginia,Wythe,51197,7682,5829,1853,5994,28,5966,1688,19,1669,7274,5422,1852,5854,4260,1594,1576,271,111,3896
9/1/2018,VA,Virginia,York,51199,11890,10296,1594,10904,38,10866,986,30,956,10882,9288,1594,5815,4480,1335,686,170,40,4919
4/1/2019,VA,Virginia,Accomack,51001,8928,7371,1557,7767,55,7712,1161,44,1117,8268,6711,1557,6137,4917,1220,1490,364,89,4194
4/1/2019,VA,Virginia,Albemarle,51003,21205,18659,2546,19678,70,19608,1527,43,1484,19033,16491,2542,14717,12608,2109,1539,301,89,12788
4/1/2019,VA,Virginia,Alexandria City,51510,17958,14954,3004,16616,78,16538,1342,83,1259,14444,11442,3002,8924,6267,2657,2103,287,65,6469
4/1/2019,VA,Virginia,Alleghany,51005,4558,3811,747,3725,20,3705,833,13,820,4335,3588,747,3502,2903,599,805,105,50,2542
4/1/2019,VA,Virginia,Amelia,51007,3090,2298,792,2643,*,*,447,16,431,2850,2058,792,2293,1562,731,463,95,36,1699
4/1/2019,VA,Virginia,Amherst,51009,7845,6256,1589,6579,52,6527,1266,29,1237,7298,5709,1589,5943,4539,1404,1217,217,71,4438
4/1/2019,VA,Virginia,Appomattox,51011,3943,3195,748,3259,20,3239,684,23,661,3705,2957,748,3019,2357,662,689,100,40,2190
4/1/2019,VA,Virginia,Arlington,51013,24565,20942,3623,23004,106,22898,1561,89,1472,19254,15635,3619,11830,8592,3238,2929,362,109,8430
4/1/2019,VA,Virginia,Augusta,51015,18415,15577,2838,16051,59,15992,2364,51,2313,17250,14413,2837,13428,11075,2353,1835,384,141,11068
4/1/2019,VA,Virginia,Bath,51017,1267,1151,116,1117,*,*,150,*,*,1202,1086,116,939,841,98,149,35,20,735
4/1/2019,VA,Virginia,Bedford,51019,19784,16004,3780,17106,94,17012,2678,49,2629,18411,14633,3778,14526,11805,2721,2005,472,150,11899
4/1/2019,VA,Virginia,Bland,51021,1784,1338,446,1424,*,*,360,*,*,1683,1237,446,1319,1005,314,234,53,18,1014
4/1/2019,VA,Virginia,Botetourt,51023,8720,6554,2166,7685,51,7634,1035,22,1013,8102,5936,2166,6450,4625,1825,708,158,54,5530
4/1/2019,VA,Virginia,Bristol City,51520,4640,2514,2126,3682,13,3669,958,17,941,4356,2231,2125,3707,1670,2037,1093,142,61,2411
4/1/2019,VA,Virginia,Brunswick,51025,4029,3177,852,3381,34,3347,648,20,628,3751,2900,851,3002,2272,730,1039,129,43,1791
4/1/2019,VA,Virginia,Buchanan,51027,7271,4012,3259,4699,21,4678,2572,22,2550,7008,3750,3258,5925,3511,2414,1633,390,110,3792
4/1/2019,VA,Virginia,Buckingham,51029,3642,3026,616,3009,19,2990,633,19,614,3402,2786,616,2617,2229,388,776,138,41,1662
4/1/2019,VA,Virginia,Buena Vista City,51530,1498,1195,303,1234,*,*,264,*,*,1407,1104,303,1108,857,251,304,51,18,735
4/1/2019,VA,Virginia,Campbell,51031,13074,10490,2584,10983,85,10898,2091,63,2028,12235,9651,2584,10013,7754,2259,2089,358,138,7428
4/1/2019,VA,Virginia,Caroline,51033,5985,4803,1182,5039,37,5002,946,34,912,5384,4202,1182,3714,2688,1026,851,206,50,2607
4/1/2019,VA,Virginia,Carroll,51035,8465,7016,1449,7033,27,7006,1432,14,1418,7995,6546,1449,6286,5150,1136,1593,259,103,4331
4/1/2019,VA,Virginia,Charles City,51036,1945,1472,473,1684,20,1664,261,14,247,1785,1312,473,1377,971,406,254,76,16,1031
4/1/2019,VA,Virginia,Charlotte,51037,3263,2666,597,2684,17,2667,579,17,562,3072,2475,597,2441,1924,517,743,125,40,1533
4/1/2019,VA,Virginia,Charlottesville City,51540,6258,5473,785,5250,28,5222,1008,41,967,5596,4812,784,4528,3822,706,1232,143,40,3113
4/1/2019,VA,Virginia,Chesapeake City,51550,38785,30002,8783,33663,319,33344,5122,222,4900,35032,26257,8775,21868,14094,7774,4227,917,208,16516
4/1/2019,VA,Virginia,Chesterfield,51041,61212,45707,15505,53931,275,53656,7281,248,7033,55150,39653,15497,43123,29344,13779,5567,1017,273,36266
4/1/2019,VA,Virginia,Clarke,51043,3328,2875,453,3077,13,3064,251,*,*,2997,2544,453,2090,1743,347,272,70,24,1724
4/1/2019,VA,Virginia,Colonial Heights City,51570,4155,3397,758,3568,12,3556,587,12,575,3801,3043,758,2515,1847,668,497,106,20,1892
4/1/2019,VA,Virginia,Covington City,51580,1589,1339,250,1228,16,1212,361,*,*,1485,1235,250,1213,986,227,328,49,15,821
4/1/2019,VA,Virginia,Craig,51045,1371,1006,365,1087,*,*,284,*,*,1263,898,365,1023,689,334,212,42,13,756
4/1/2019,VA,Virginia,Culpeper,51047,9501,8020,1481,8324,43,8281,1177,47,1130,8585,7106,1479,6054,4933,1121,1251,220,70,4513
4/1/2019,VA,Virginia,Cumberland,51049,2358,1805,553,1974,13,1961,384,*,*,2189,1636,553,1723,1242,481,433,92,32,1166
4/1/2019,VA,Virginia,Danville City,51590,11026,7891,3135,8754,90,8664,2272,118,2154,10365,7230,3135,8895,6634,2261,3211,386,155,5143
4/1/2019,VA,Virginia,Dickenson,51051,4893,2621,2272,3206,*,*,1687,*,*,4681,2410,2271,3936,1906,2030,1152,194,81,2509
4/1/2019,VA,Virginia,Dinwiddie,51053,6059,4692,1367,4950,41,4909,1109,30,1079,5579,4212,1367,4175,2897,1278,953,181,50,2991
4/1/2019,VA,Virginia,Emporia City,51595,1324,958,366,1041,22,1019,283,12,271,1242,876,366,1013,714,299,457,*,*,482
4/1/2019,VA,Virginia,Essex,51057,2986,2358,628,2571,18,2553,415,15,400,2757,2129,628,2101,1620,481,453,88,35,1525
4/1/2019,VA,Virginia,Fairfax,51059,151951,124153,27798,143886,645,143241,8065,462,7603,122419,94661,27758,73811,50274,23537,14061,2584,560,56606
4/1/2019,VA,Virginia,Fairfax City,51600,3870,3127,743,3614,15,3599,256,14,242,3240,2498,742,2025,1433,592,379,68,18,1560
4/1/2019,VA,Virginia,Falls Church City,51610,2061,1721,340,1980,*,*,81,0,81,1594,1256,338,1012,723,289,125,*,*,871
4/1/2019,VA,Virginia,Fauquier,51061,12725,11223,1502,11654,71,11583,1071,41,1030,11292,9790,1502,7395,6309,1086,1002,184,53,6156
4/1/2019,VA,Virginia,Floyd,51063,4141,3255,886,3597,18,3579,544,*,*,3861,2975,886,3120,2305,815,594,106,49,2371
4/1/2019,VA,Virginia,Fluvanna,51065,6065,5211,854,5450,24,5426,615,20,595,5515,4661,854,4092,3422,670,577,107,24,3384
4/1/2019,VA,Virginia,Franklin,51067,15016,10700,4316,12694,60,12634,2322,34,2288,14093,9779,4314,11593,7751,3842,2040,466,151,8936
4/1/2019,VA,Virginia,Franklin City,51620,2154,1783,371,1746,19,1727,408,20,388,2001,1630,371,1639,1303,336,535,62,17,1025
4/1/2019,VA,Virginia,Frederick,51069,16804,14286,2518,15056,67,14989,1748,50,1698,15274,12760,2514,10652,8692,1960,1415,353,119,8765
4/1/2019,VA,Virginia,Fredericksburg City,51630,4145,3550,595,3435,27,3408,710,24,686,3696,3101,595,2596,2078,518,826,89,39,1642
4/1/2019,VA,Virginia,Galax City,51640,1768,1564,204,1430,*,*,338,*,*,1670,1466,204,1375,1214,161,586,49,24,716
4/1/2019,VA,Virginia,Giles,51071,4632,3554,1078,3711,23,3688,921,14,907,4362,3284,1078,3640,2996,644,830,121,33,2656
4/1/2019,VA,Virginia,Gloucester,51073,8671,7137,1534,7533,41,7492,1138,23,1115,7982,6450,1532,5229,3921,1308,1007,171,47,4004
4/1/2019,VA,Virginia,Goochland,51075,5894,4608,1286,5425,27,5398,469,15,454,5384,4099,1285,4463,3417,1046,395,96,29,3943
4/1/2019,VA,Virginia,Grayson,51077,4555,3642,913,3776,15,3761,779,12,767,4341,3428,913,3356,2556,800,939,172,82,2163
4/1/2019,VA,Virginia,Greene,51079,3997,3438,559,3517,15,3502,480,*,*,3619,3060,559,2679,2196,483,471,86,27,2095
4/1/2019,VA,Virginia,Greensville,51081,2112,1519,593,1715,21,1694,397,14,383,1965,1372,593,1599,1148,451,449,103,23,1024
4/1/2019,VA,Virginia,Halifax,51083,9825,8121,1704,8154,72,8082,1671,48,1623,9211,7507,1704,7454,5970,1484,2142,416,146,4750
4/1/2019,VA,Virginia,Hampton City,51650,25256,18315,6941,20945,223,20722,4311,209,4102,22993,16052,6941,14413,7933,6480,3848,751,175,9639
4/1/2019,VA,Virginia,Hanover,51085,21408,16041,5367,19563,104,19459,1845,53,1792,19484,14118,5366,15873,11473,4400,1497,321,93,13962
4/1/2019,VA,Virginia,Harrisonburg City,51660,5510,4816,694,4694,24,4670,816,24,792,5000,4306,694,4028,3522,506,1009,121,39,2859
4/1/2019,VA,Virginia,Henrico,51087,57201,41246,15955,50453,352,50101,6748,292,6456,51639,35700,15939,42387,28508,13879,6529,1354,375,34129
4/1/2019,VA,Virginia,Henry,51089,14827,10369,4458,11900,79,11821,2927,66,2861,14092,9635,4457,12095,7971,4124,2987,707,235,8166
4/1/2019,VA,Virginia,Highland,51091,798,716,82,727,*,*,71,*,*,748,666,82,563,497,66,56,*,*,480
4/1/2019,VA,Virginia,Hopewell City,51670,4546,3463,1083,3549,38,3511,997,35,962,4204,3121,1083,2968,1938,1030,1013,143,34,1778
4/1/2019,VA,Virginia,Isle of Wight,51093,8384,6541,1843,7437,56,7381,947,38,909,7733,5890,1843,5505,3837,1668,989,189,68,4259
4/1/2019,VA,Virginia,James City,51095,20976,17827,3149,19774,62,19712,1202,51,1151,19354,16208,3146,12532,10217,2315,904,224,57,11347
4/1/2019,VA,Virginia,King and Queen,51097,1794,1459,335,1525,13,1512,269,*,*,1665,1330,335,1261,972,289,277,*,*,908
4/1/2019,VA,Virginia,King George,51099,3982,3567,415,3462,15,3447,520,28,492,3457,3042,415,1757,1415,342,468,64,17,1208
4/1/2019,VA,Virginia,King William,51101,3461,2843,618,2973,24,2949,488,23,465,3171,2553,618,2570,2043,527,405,107,23,2035
4/1/2019,VA,Virginia,Lancaster,51103,4362,3723,639,4034,21,4013,328,18,310,4133,3495,638,3040,2633,407,500,97,14,2429
4/1/2019,VA,Virginia,Lee,51105,6428,3500,2928,4524,16,4508,1904,15,1889,6108,3182,2926,5016,2281,2735,1944,238,82,2752
4/1/2019,VA,Virginia,Lexington City,51678,1398,1240,158,1283,11,1272,115,*,*,1280,1123,157,991,865,126,190,32,13,756
4/1/2019,VA,Virginia,Loudoun,51107,38762,31651,7111,36378,185,36193,2384,119,2265,32149,25047,7102,21703,15701,6002,3291,618,138,17656
4/1/2019,VA,Virginia,Louisa,51109,8322,6667,1655,7072,47,7025,1250,36,1214,7606,5951,1655,5704,4288,1416,1091,245,66,4302
4/1/2019,VA,Virginia,Lunenburg,51111,3101,2611,490,2572,19,2553,529,15,514,2856,2366,490,2196,1765,431,723,110,37,1326
4/1/2019,VA,Virginia,Lynchburg City,51680,14567,11710,2857,12023,95,11928,2544,103,2441,13483,10628,2855,11048,8534,2514,2935,454,131,7528
4/1/2019,VA,Virginia,Madison,51113,3258,2758,500,2910,15,2895,348,13,335,3022,2522,500,2248,1867,381,422,89,23,1714
4/1/2019,VA,Virginia,Manassas City,51683,4593,3662,931,4088,24,4064,505,42,463,3837,2906,931,2698,1901,797,536,86,31,2045
4/1/2019,VA,Virginia,Manassas Park City,51685,1311,992,319,1140,16,1124,171,12,159,1096,777,319,787,498,289,196,*,*,533
4/1/2019,VA,Virginia,Martinsville City,51690,3858,2784,1074,2917,41,2876,941,38,903,3652,2579,1073,3150,2126,1024,1293,164,55,1638
4/1/2019,VA,Virginia,Mathews,51115,2867,2375,492,2634,11,2623,233,*,*,2701,2209,492,1919,1519,400,274,35,20,1590
4/1/2019,VA,Virginia,Mecklenburg,51117,9218,7290,1928,7742,60,7682,1476,65,1411,8643,6715,1928,6868,5275,1593,1806,359,94,4609
4/1/2019,VA,Virginia,Middlesex,51119,3593,2989,604,3241,15,3226,352,*,*,3392,2788,604,2609,2157,452,456,75,30,2048
4/1/2019,VA,Virginia,Montgomery,51121,14107,11325,2782,11845,55,11790,2262,30,2232,12730,9949,2781,10645,8177,2468,1927,351,124,8243
4/1/2019,VA,Virginia,Nelson,51125,4648,3931,717,4168,17,4151,480,11,469,4272,3556,716,3171,2569,602,560,106,43,2462
4/1/2019,VA,Virginia,New Kent,51127,4632,3739,893,4180,22,4158,452,*,*,4214,3322,892,2998,2314,684,300,74,20,2604
4/1/2019,VA,Virginia,Newport News City,51700,28499,20477,8022,23631,224,23407,4868,237,4631,26062,18044,8018,17356,9797,7559,4872,892,204,11388
4/1/2019,VA,Virginia,Norfolk City,51710,33230,24080,9150,26923,302,26621,6307,332,5975,29856,20710,9146,20490,11833,8657,7239,1291,282,11678
4/1/2019,VA,Virginia,Northampton,51131,3727,2986,741,3245,26,3219,482,19,463,3472,2732,740,2797,2174,623,907,86,28,1776
4/1/2019,VA,Virginia,Northumberland,51133,4632,3927,705,4306,15,4291,326,15,311,4336,3631,705,2932,2525,407,425,76,27,2404
4/1/2019,VA,Virginia,Norton City,51720,1151,702,449,797,*,*,354,*,*,1068,619,449,888,476,412,344,43,13,488
4/1/2019,VA,Virginia,Nottoway,51135,3633,2975,658,3005,28,2977,628,15,613,3360,2703,657,2629,2145,484,861,122,43,1603
4/1/2019,VA,Virginia,Orange,51137,8741,7490,1251,7742,56,7686,999,32,967,7967,6717,1250,5381,4542,839,959,189,62,4171
4/1/2019,VA,Virginia,Page,51139,6206,5269,937,5157,26,5131,1049,25,1024,5798,4861,937,4294,3512,782,1082,235,82,2895
4/1/2019,VA,Virginia,Patrick,51141,5466,4123,1343,4574,*,*,892,12,880,5178,3837,1341,4256,3152,1104,1083,188,72,2913
4/1/2019,VA,Virginia,Petersburg City,51730,7153,5085,2068,5369,87,5282,1784,77,1707,6543,4477,2066,4891,2898,1993,2085,340,66,2400
4/1/2019,VA,Virginia,Pittsylvania,51143,16443,11839,4604,13614,95,13519,2829,76,2753,15464,10860,4604,12938,9537,3401,3049,534,184,9171
4/1/2019,VA,Virginia,Poquoson City,51735,2595,2264,331,2416,*,*,179,*,*,2381,2052,329,1237,954,283,116,25,11,1085
4/1/2019,VA,Virginia,Portsmouth City,51740,18308,13281,5027,14411,199,14212,3897,207,3690,16339,11316,5023,11082,6328,4754,3946,686,143,6307
4/1/2019,VA,Virginia,Powhatan,51145,6164,4806,1358,5573,23,5550,591,19,572,5664,4306,1358,4575,3423,1152,419,108,27,4021
4/1/2019,VA,Virginia,Prince Edward,51147,4670,3847,823,3807,47,3760,863,32,831,4331,3508,823,3383,2777,606,1058,152,55,2118
4/1/2019,VA,Virginia,Prince George,51149,6131,5240,891,5212,33,5179,919,33,886,5655,4765,890,3482,2702,780,570,118,28,2766
4/1/2019,VA,Virginia,Prince William,51153,49367,39471,9896,44386,313,44073,4981,290,4691,41954,32069,9885,24788,16075,8713,5206,1047,214,18321
4/1/2019,VA,Virginia,Pulaski,51155,9194,7237,1957,7428,34,7394,1766,31,1735,8546,6590,1956,7082,5389,1693,1594,291,103,5094
4/1/2019,VA,Virginia,Radford City,51750,2049,1627,422,1675,*,*,374,*,*,1865,1443,422,1590,1213,377,344,41,22,1183
4/1/2019,VA,Virginia,Rappahannock,51157,1939,1749,190,1814,*,*,125,*,*,1740,1551,189,1200,1068,132,136,*,*,1021
4/1/2019,VA,Virginia,Richmond,51159,1953,1562,391,1713,*,*,240,15,225,1807,1417,390,1356,1109,247,304,62,14,976
4/1/2019,VA,Virginia,Richmond City,51760,34535,22671,11864,27780,299,27481,6755,323,6432,30994,19141,11853,26454,15241,11213,8756,1354,278,16066
4/1/2019,VA,Virginia,Roanoke,51161,23623,17752,5871,21065,105,20960,2558,64,2494,21792,15924,5868,17776,12812,4964,2111,442,132,15091
4/1/2019,VA,Virginia,Roanoke City,51770,21158,14762,6396,16277,159,16118,4881,147,4734,19219,12829,6390,15847,9996,5851,4847,850,208,9942
4/1/2019,VA,Virginia,Rockbridge,51163,6327,5284,1043,5453,13,5440,874,*,*,5863,4820,1043,4430,3571,859,844,179,54,3353
4/1/2019,VA,Virginia,Rockingham,51165,17853,15241,2612,15760,45,15715,2093,43,2050,16488,13877,2611,12957,11124,1833,1830,483,131,10513
4/1/2019,VA,Virginia,Russell,51167,7987,4759,3228,5644,14,5630,2343,22,2321,7643,4418,3225,6564,3941,2623,1669,327,143,4425
4/1/2019,VA,Virginia,Salem City,51775,6059,4707,1352,5147,33,5114,912,17,895,5602,4250,1352,4552,3355,1197,842,130,37,3543
4/1/2019,VA,Virginia,Scott,51169,6776,3140,3636,5196,14,5182,1580,17,1563,6506,2873,3633,5704,2172,3532,1540,240,106,3818
4/1/2019,VA,Virginia,Shenandoah,51171,10608,8987,1621,9462,41,9421,1146,25,1121,9898,8277,1621,7131,5846,1285,1243,270,89,5529
4/1/2019,VA,Virginia,Smyth,51173,8651,6115,2536,6573,36,6537,2078,27,2051,8199,5663,2536,6794,4482,2312,2076,385,126,4207
4/1/2019,VA,Virginia,Southampton,51175,3963,3257,706,3337,37,3300,626,26,600,3669,2963,706,2916,2300,616,710,113,34,2059
4/1/2019,VA,Virginia,Spotsylvania,51177,21457,18461,2996,18821,122,18699,2636,107,2529,19046,16051,2995,11661,9288,2373,2024,525,136,8976
4/1/2019,VA,Virginia,Stafford,51179,17909,15791,2118,15886,111,15775,2023,88,1935,15658,13544,2114,8081,6392,1689,1456,359,87,6179
4/1/2019,VA,Virginia,Staunton City,51790,6276,5335,941,5277,24,5253,999,17,982,5887,4946,941,4689,3920,769,1093,151,51,3394
4/1/2019,VA,Virginia,Suffolk City,51800,16686,12853,3833,13817,125,13692,2869,112,2757,15237,11407,3830,10559,7090,3469,2775,461,113,7210
4/1/2019,VA,Virginia,Surry,51181,1712,1324,388,1480,*,*,232,*,*,1569,1181,388,1153,798,355,205,62,13,873
4/1/2019,VA,Virginia,Sussex,51183,2530,1923,607,2091,37,2054,439,*,*,2357,1750,607,1825,1256,569,535,142,21,1127
4/1/2019,VA,Virginia,Tazewell,51185,11967,7828,4139,8943,38,8905,3024,39,2985,11338,7200,4138,9133,6207,2926,2266,466,171,6230
4/1/2019,VA,Virginia,Unknown,51999,*,*,*,*,*,*,*,*,*,*,*,*,*,*,*,*,*,*,*
4/1/2019,VA,Virginia,Virginia Beach City,51810,72973,58766,14207,64769,425,64344,8204,351,7853,66675,52484,14191,39103,26363,12740,6950,1477,392,30284
4/1/2019,VA,Virginia,Warren,51187,7771,6738,1033,6732,28,6704,1039,33,1006,7057,6025,1032,4861,4048,813,928,216,73,3644
4/1/2019,VA,Virginia,Washington,51191,14965,9295,5670,12250,47,12203,2715,33,2682,14090,8422,5668,11733,6577,5156,2387,537,197,8612
4/1/2019,VA,Virginia,Waynesboro City,51820,4958,4178,780,4110,18,4092,848,24,824,4628,3848,780,3671,2988,683,907,116,44,2604
4/1/2019,VA,Virginia,Westmoreland,51193,5057,4380,677,4457,25,4432,600,15,585,4595,3918,677,2995,2445,550,755,135,47,2058
4/1/2019,VA,Virginia,Williamsburg City,51830,2750,2278,472,2531,*,*,219,12,207,2529,2057,472,1809,1426,383,244,*,*,1528
4/1/2019,VA,Virginia,Winchester City,51840,5489,4708,781,4744,30,4714,745,20,725,4989,4208,781,3645,3015,630,856,143,42,2604
4/1/2019,VA,Virginia,Wise,51195,10676,6072,4604,7333,26,7307,3343,27,3316,10087,5484,4603,8185,3957,4228,2451,459,183,5092
4/1/2019,VA,Virginia,Wythe,51197,7934,5859,2075,6268,36,6232,1666,20,1646,7497,5423,2074,6109,4309,1800,1641,287,105,4076
4/1/2019,VA,Virginia,York,51199,12113,10345,1768,11145,41,11104,968,34,934,11080,9313,1767,6044,4542,1502,690,153,36,5165
8/1/2019,VA,Virginia,Accomack,51001,9004,7418,1586,7824,51,7773,1180,41,1139,8339,6754,1585,6180,4935,1245,1536,357,91,4196
8/1/2019,VA,Virginia,Albemarle,51003,21413,18808,2605,19871,70,19801,1542,42,1500,19267,16666,2601,14903,12734,2169,1587,293,99,12924
8/1/2019,VA,Virginia,Alexandria City,51510,18221,15130,3091,16861,72,16789,1360,83,1277,14687,11599,3088,9043,6296,2747,2164,283,63,6533
8/1/2019,VA,Virginia,Alleghany,51005,4558,3780,778,3718,19,3699,840,13,827,4338,3560,778,3514,2885,629,820,103,50,2541
8/1/2019,VA,Virginia,Amelia,51007,3100,2280,820,2645,*,*,455,18,437,2863,2043,820,2300,1543,757,475,93,37,1695
8/1/2019,VA,Virginia,Amherst,51009,7903,6252,1651,6615,49,6566,1288,29,1259,7357,5706,1651,5999,4535,1464,1257,209,74,4459
8/1/2019,VA,Virginia,Appomattox,51011,3956,3178,778,3268,18,3250,688,21,667,3721,2943,778,3018,2323,695,693,90,43,2192
8/1/2019,VA,Virginia,Arlington,51013,24909,21140,3769,23337,96,23241,1572,85,1487,19588,15823,3765,11954,8571,3383,2981,358,108,8507
8/1/2019,VA,Virginia,Augusta,51015,18511,15634,2877,16103,55,16048,2408,49,2359,17362,14486,2876,13505,11099,2406,1898,389,139,11079
8/1/2019,VA,Virginia,Bath,51017,1270,1153,117,1116,*,*,154,*,*,1206,1089,117,940,844,96,153,33,17,737
8/1/2019,VA,Virginia,Bedford,51019,19925,16066,3859,17225,87,17138,2700,48,2652,18559,14703,3856,14656,11848,2808,2043,463,153,11997
8/1/2019,VA,Virginia,Bland,51021,1799,1340,459,1433,*,*,366,*,*,1699,1240,459,1324,1002,322,233,53,17,1021
8/1/2019,VA,Virginia,Botetourt,51023,8783,6588,2195,7719,46,7673,1064,23,1041,8174,5979,2195,6502,4646,1856,731,159,51,5561
8/1/2019,VA,Virginia,Bristol City,51520,4637,2501,2136,3665,12,3653,972,16,956,4360,2225,2135,3701,1655,2046,1122,144,57,2378
8/1/2019,VA,Virginia,Brunswick,51025,4049,3152,897,3391,34,3357,658,19,639,3769,2872,897,3010,2238,772,1068,128,43,1771
8/1/2019,VA,Virginia,Buchanan,51027,7270,3986,3284,4672,19,4653,2598,22,2576,7013,3730,3283,5953,3499,2454,1680,388,112,3773
8/1/2019,VA,Virginia,Buckingham,51029,3672,3029,643,3032,19,3013,640,18,622,3439,2796,643,2638,2223,415,796,136,40,1666
8/1/2019,VA,Virginia,Buena Vista City,51530,1497,1183,314,1230,*,*,267,*,*,1400,1086,314,1101,838,263,306,51,17,727
8/1/2019,VA,Virginia,Campbell,51031,13147,10487,2660,11015,79,10936,2132,62,2070,12316,9656,2660,10049,7712,2337,2125,355,138,7431
8/1/2019,VA,Virginia,Caroline,51033,6048,4844,1204,5095,35,5060,953,35,918,5450,4246,1204,3742,2695,1047,875,203,48,2616
8/1/2019,VA,Virginia,Carroll,51035,8480,7025,1455,7045,25,7020,1435,14,1421,8037,6582,1455,6317,5172,1145,1613,251,109,4344
8/1/2019,VA,Virginia,Charles City,51036,1951,1478,473,1684,18,1666,267,15,252,1789,1316,473,1369,961,408,261,74,17,1017
8/1/2019,VA,Virginia,Charlotte,51037,3275,2656,619,2695,16,2679,580,16,564,3079,2460,619,2440,1902,538,745,124,40,1531
8/1/2019,VA,Virginia,Charlottesville City,51540,6340,5515,825,5315,28,5287,1025,40,985,5691,4867,824,4587,3844,743,1252,145,39,3151
8/1/2019,VA,Virginia,Chesapeake City,51550,39190,30212,8978,33974,295,33679,5216,230,4986,35461,26491,8970,22032,14049,7983,4350,915,208,16559
8/1/2019,VA,Virginia,Chesterfield,51041,61915,46146,15769,54530,259,54271,7385,246,7139,55900,40140,15760,43656,29611,14045,5739,1005,279,36633
8/1/2019,VA,Virginia,Clarke,51043,3359,2906,453,3101,13,3088,258,*,*,3036,2583,453,2109,1763,346,286,64,25,1734
8/1/2019,VA,Virginia,Colonial Heights City,51570,4170,3392,778,3584,11,3573,586,13,573,3816,3038,778,2523,1836,687,500,102,20,1901
8/1/2019,VA,Virginia,Covington City,51580,1601,1337,264,1230,15,1215,371,*,*,1498,1234,264,1206,968,238,332,48,15,811
8/1/2019,VA,Virginia,Craig,51045,1375,1002,373,1086,*,*,289,*,*,1275,902,373,1026,684,342,219,43,14,750
8/1/2019,VA,Virginia,Culpeper,51047,9602,8078,1524,8397,38,8359,1205,45,1160,8698,7176,1522,6113,4950,1163,1289,214,66,4544
8/1/2019,VA,Virginia,Cumberland,51049,2369,1800,569,1978,13,1965,391,*,*,2205,1636,569,1740,1244,496,451,89,35,1165
8/1/2019,VA,Virginia,Danville City,51590,11029,7770,3259,8737,82,8655,2292,120,2172,10371,7112,3259,8893,6504,2389,3250,376,156,5111
8/1/2019,VA,Virginia,Dickenson,51051,4899,2595,2304,3193,*,*,1706,*,*,4692,2389,2303,3945,1880,2065,1173,196,78,2498
8/1/2019,VA,Virginia,Dinwiddie,51053,6087,4698,1389,4964,37,4927,1123,31,1092,5620,4231,1389,4207,2907,1300,968,181,50,3008
8/1/2019,VA,Virginia,Emporia City,51595,1333,950,383,1048,22,1026,285,11,274,1251,868,383,1018,700,318,462,*,*,480
8/1/2019,VA,Virginia,Essex,51057,3005,2357,648,2580,16,2564,425,15,410,2764,2116,648,2113,1608,505,461,88,34,1530
8/1/2019,VA,Virginia,Fairfax,51059,154406,125828,28578,146189,614,145575,8217,470,7747,124665,96127,28538,74912,50627,24285,14450,2601,569,57292
8/1/2019,VA,Virginia,Fairfax City,51600,3898,3149,749,3639,14,3625,259,14,245,3270,2522,748,2042,1440,602,390,71,18,1563
8/1/2019,VA,Virginia,Falls Church City,51610,2082,1730,352,2001,*,*,81,0,81,1615,1265,350,1026,726,300,124,*,*,887
8/1/2019,VA,Virginia,Fauquier,51061,12861,11334,1527,11761,67,11694,1100,41,1059,11408,9881,1527,7427,6317,1110,1013,181,55,6178
8/1/2019,VA,Virginia,Floyd,51063,4176,3278,898,3627,15,3612,549,*,*,3908,3010,898,3150,2322,828,615,104,46,2385
8/1/2019,VA,Virginia,Fluvanna,51065,6127,5246,881,5499,23,5476,628,20,608,5574,4693,881,4130,3434,696,586,103,25,3416
8/1/2019,VA,Virginia,Franklin,51067,15132,10748,4384,12788,56,12732,2344,34,2310,14217,9835,4382,11658,7752,3906,2084,452,159,8963
8/1/2019,VA,Virginia,Franklin City,51620,2166,1778,388,1752,19,1733,414,19,395,2018,1630,388,1644,1291,353,544,59,19,1022
8/1/2019,VA,Virginia,Frederick,51069,16977,14412,2565,15196,62,15134,1781,50,1731,15468,12907,2561,10754,8741,2013,1463,356,118,8817
8/1/2019,VA,Virginia,Fredericksburg City,51630,4179,3574,605,3457,27,3430,722,24,698,3723,3118,605,2609,2079,530,850,78,39,1642
8/1/2019,VA,Virginia,Galax City,51640,1769,1562,207,1428,*,*,341,*,*,1675,1468,207,1375,1210,165,588,50,24,713
8/1/2019,VA,Virginia,Giles,51071,4629,3552,1077,3698,22,3676,931,15,916,4368,3291,1077,3634,2984,650,842,117,33,2642
8/1/2019,VA,Virginia,Gloucester,51073,8749,7159,1590,7597,40,7557,1152,23,1129,8087,6499,1588,5274,3910,1364,1025,170,52,4027
8/1/2019,VA,Virginia,Goochland,51075,5971,4667,1304,5499,26,5473,472,15,457,5475,4172,1303,4522,3458,1064,403,94,27,3998
8/1/2019,VA,Virginia,Grayson,51077,4573,3628,945,3783,15,3768,790,11,779,4382,3437,945,3387,2552,835,953,171,82,2181
8/1/2019,VA,Virginia,Greene,51079,4027,3458,569,3536,15,3521,491,11,480,3640,3071,569,2683,2190,493,482,75,27,2099
8/1/2019,VA,Virginia,Greensville,51081,2120,1528,592,1717,21,1696,403,15,388,1968,1376,592,1593,1133,460,457,99,24,1013
8/1/2019,VA,Virginia,Halifax,51083,9844,8100,1744,8168,69,8099,1676,51,1625,9224,7480,1744,7438,5909,1529,2179,406,139,4714
8/1/2019,VA,Virginia,Hampton City,51650,25539,18382,7157,21168,214,20954,4371,212,4159,23253,16096,7157,14571,7873,6698,3998,737,174,9662
8/1/2019,VA,Virginia,Hanover,51085,21696,16284,5412,19825,96,19729,1871,54,1817,19717,14307,5410,16061,11604,4457,1548,317,95,14101
8/1/2019,VA,Virginia,Harrisonburg City,51660,5554,4852,702,4725,22,4703,829,25,804,5043,4341,702,4039,3518,521,1027,119,42,2851
8/1/2019,VA,Virginia,Henrico,51087,57765,41511,16254,50905,334,50571,6860,297,6563,52217,35979,16238,42786,28587,14199,6716,1316,379,34375
8/1/2019,VA,Virginia,Henry,51089,14862,10271,4591,11898,75,11823,2964,68,2896,14130,9541,4589,12116,7858,4258,3070,694,229,8123
8/1/2019,VA,Virginia,Highland,51091,804,721,83,732,*,*,72,*,*,759,676,83,568,502,66,61,*,*,481
8/1/2019,VA,Virginia,Hopewell City,51670,4562,3451,1111,3552,35,3517,1010,35,975,4223,3112,1111,2986,1927,1059,1037,136,38,1775
8/1/2019,VA,Virginia,Isle of Wight,51093,8463,6590,1873,7492,55,7437,971,40,931,7821,5948,1873,5547,3844,1703,1016,183,68,4280
8/1/2019,VA,Virginia,James City,51095,21146,17959,3187,19908,57,19851,1238,52,1186,19563,16380,3183,12679,10318,2361,945,222,61,11451
8/1/2019,VA,Virginia,King and Queen,51097,1803,1448,355,1529,11,1518,274,*,*,1677,1322,355,1276,967,309,289,*,*,911
8/1/2019,VA,Virginia,King George,51099,4032,3623,409,3509,14,3495,523,26,497,3507,3098,409,1753,1416,337,463,61,17,1212
8/1/2019,VA,Virginia,King William,51101,3505,2872,633,3006,23,2983,499,24,475,3224,2591,633,2602,2061,541,424,105,24,2049
8/1/2019,VA,Virginia,Lancaster,51103,4378,3722,656,4045,21,4024,333,18,315,4148,3493,655,3062,2637,425,512,94,14,2442
8/1/2019,VA,Virginia,Lee,51105,6439,3397,3042,4510,13,4497,1929,16,1913,6123,3083,3040,5047,2282,2765,1976,240,80,2751
8/1/2019,VA,Virginia,Lexington City,51678,1385,1217,168,1269,*,*,116,*,*,1266,1099,167,977,842,135,179,33,13,752
8/1/2019,VA,Virginia,Loudoun,51107,39363,32076,7287,36934,172,36762,2429,123,2306,32685,25405,7280,22010,15827,6183,3402,620,136,17852
8/1/2019,VA,Virginia,Louisa,51109,8406,6730,1676,7132,46,7086,1274,40,1234,7710,6034,1676,5771,4333,1438,1118,241,65,4347
8/1/2019,VA,Virginia,Lunenburg,51111,3119,2606,513,2582,16,2566,537,15,522,2877,2364,513,2208,1753,455,742,108,37,1321
8/1/2019,VA,Virginia,Lynchburg City,51680,14624,11649,2975,12038,91,11947,2586,107,2479,13569,10597,2972,11114,8474,2640,3018,441,138,7517
8/1/2019,VA,Virginia,Madison,51113,3303,2783,520,2949,14,2935,354,14,340,3074,2554,520,2282,1880,402,434,81,18,1749
8/1/2019,VA,Virginia,Manassas City,51683,4665,3705,960,4148,22,4126,517,42,475,3923,2963,960,2752,1927,825,561,82,30,2079
8/1/2019,VA,Virginia,Manassas Park City,51685,1323,994,329,1150,17,1133,173,14,159,1108,779,329,791,490,301,200,*,*,531
8/1/2019,VA,Virginia,Martinsville City,51690,3861,2733,1128,2910,37,2873,951,38,913,3656,2529,1127,3145,2066,1079,1305,161,54,1625
8/1/2019,VA,Virginia,Mathews,51115,2888,2400,488,2642,*,*,246,*,*,2727,2239,488,1930,1535,395,290,34,19,1587
8/1/2019,VA,Virginia,Mecklenburg,51117,9259,7273,1986,7751,57,7694,1508,66,1442,8684,6699,1985,6887,5230,1657,1835,342,93,4617
8/1/2019,VA,Virginia,Middlesex,51119,3630,3024,606,3268,14,3254,362,*,*,3414,2808,606,2622,2166,456,462,76,29,2055
8/1/2019,VA,Virginia,Montgomery,51121,14233,11373,2860,11950,50,11900,2283,33,2250,12824,9965,2859,10727,8185,2542,1971,333,121,8302
8/1/2019,VA,Virginia,Nelson,51125,4693,3948,745,4204,16,4188,489,12,477,4333,3589,744,3219,2591,628,584,99,43,2493
8/1/2019,VA,Virginia,New Kent,51127,4701,3803,898,4236,18,4218,465,11,454,4271,3374,897,3053,2366,687,316,69,20,2648
8/1/2019,VA,Virginia,Newport News City,51700,28730,20509,8221,23793,214,23579,4937,243,4694,26283,18066,8217,17490,9725,7765,5075,854,208,11353
8/1/2019,VA,Virginia,Norfolk City,51710,33528,24058,9470,27102,282,26820,6426,334,6092,30144,20679,9465,20645,11662,8983,7460,1266,282,11637
8/1/2019,VA,Virginia,Northampton,51131,3761,2997,764,3275,26,3249,486,20,466,3503,2740,763,2821,2176,645,931,84,26,1780
8/1/2019,VA,Virginia,Northumberland,51133,4652,3930,722,4317,14,4303,335,14,321,4356,3634,722,2934,2510,424,433,71,27,2403
8/1/2019,VA,Virginia,Norton City,51720,1157,687,470,796,*,*,361,*,*,1077,607,470,897,473,424,356,43,12,486
8/1/2019,VA,Virginia,Nottoway,51135,3642,2953,689,3002,27,2975,640,14,626,3377,2688,689,2632,2115,517,873,115,43,1601
8/1/2019,VA,Virginia,Orange,51137,8807,7540,1267,7799,54,7745,1008,31,977,8041,6775,1266,5425,4565,860,993,181,62,4189
8/1/2019,VA,Virginia,Page,51139,6227,5291,936,5166,24,5142,1061,23,1038,5819,4883,936,4314,3531,783,1095,231,80,2908
8/1/2019,VA,Virginia,Patrick,51141,5480,4130,1350,4570,*,*,910,13,897,5188,3840,1348,4248,3138,1110,1093,179,73,2903
8/1/2019,VA,Virginia,Petersburg City,51730,7203,5044,2159,5397,82,5315,1806,77,1729,6585,4427,2158,4919,2832,2087,2133,329,69,2388
8/1/2019,VA,Virginia,Pittsylvania,51143,16529,11817,4712,13654,91,13563,2875,76,2799,15554,10842,4712,13005,9488,3517,3105,525,185,9190
8/1/2019,VA,Virginia,Poquoson City,51735,2621,2283,338,2438,*,*,183,*,*,2410,2073,337,1252,961,291,119,25,12,1096
8/1/2019,VA,Virginia,Portsmouth City,51740,18477,13234,5243,14509,187,14322,3968,207,3761,16523,11285,5238,11176,6202,4974,4104,679,147,6246
8/1/2019,VA,Virginia,Powhatan,51145,6248,4884,1364,5646,20,5626,602,19,583,5728,4364,1364,4620,3459,1161,414,111,27,4068
8/1/2019,VA,Virginia,Prince Edward,51147,4696,3867,829,3822,43,3779,874,30,844,4354,3525,829,3386,2769,617,1083,143,51,2109
8/1/2019,VA,Virginia,Prince George,51149,6189,5279,910,5250,30,5220,939,34,905,5732,4823,909,3518,2714,804,593,121,27,2777
8/1/2019,VA,Virginia,Prince William,51153,50259,40050,10209,45152,305,44847,5107,293,4814,42854,32656,10198,25203,16183,9020,5383,1051,225,18544
8/1/2019,VA,Virginia,Pulaski,51155,9216,7222,1994,7428,31,7397,1788,33,1755,8584,6591,1993,7094,5365,1729,1625,281,108,5080
8/1/2019,VA,Virginia,Radford City,51750,2051,1618,433,1674,*,*,377,*,*,1866,1433,433,1591,1202,389,345,39,22,1185
8/1/2019,VA,Virginia,Rappahannock,51157,1954,1759,195,1825,*,*,129,*,*,1761,1567,194,1213,1077,136,147,*,*,1022
8/1/2019,VA,Virginia,Richmond,51159,1951,1561,390,1708,*,*,243,13,230,1815,1426,389,1356,1104,252,310,62,14,970
8/1/2019,VA,Virginia,Richmond City,51760,34805,22614,12191,27983,279,27704,6822,321,6501,31289,19110,12179,26667,15122,11545,9073,1292,285,16017
8/1/2019,VA,Virginia,Roanoke,51161,23788,17823,5965,21185,98,21087,2603,63,2540,21965,16003,5962,17897,12832,5065,2170,418,137,15172
8/1/2019,VA,Virginia,Roanoke City,51770,21319,14736,6583,16378,149,16229,4941,143,4798,19383,12806,6577,15938,9889,6049,4956,857,217,9908
8/1/2019,VA,Virginia,Rockbridge,51163,6363,5287,1076,5477,11,5466,886,*,*,5910,4834,1076,4470,3579,891,874,177,55,3364
8/1/2019,VA,Virginia,Rockingham,51165,18029,15376,2653,15897,45,15852,2132,40,2092,16647,13995,2652,13117,11236,1881,1894,489,139,10595
8/1/2019,VA,Virginia,Russell,51167,7985,4724,3261,5619,14,5605,2366,21,2345,7653,4395,3258,6571,3910,2661,1708,323,146,4394
8/1/2019,VA,Virginia,Salem City,51775,6085,4720,1365,5154,28,5126,931,17,914,5619,4254,1365,4552,3337,1215,856,128,37,3531
8/1/2019,VA,Virginia,Scott,51169,6786,3106,3680,5199,13,5186,1587,18,1569,6510,2833,3677,5694,2157,3537,1560,235,103,3796
8/1/2019,VA,Virginia,Shenandoah,51171,10692,9040,1652,9525,38,9487,1167,24,1143,10000,8348,1652,7200,5878,1322,1291,258,88,5563
8/1/2019,VA,Virginia,Smyth,51173,8649,6032,2617,6551,35,6516,2098,28,2070,8219,5602,2617,6810,4406,2404,2116,371,120,4203
8/1/2019,VA,Virginia,Southampton,51175,3996,3268,728,3360,32,3328,636,26,610,3706,2978,728,2940,2304,636,732,110,34,2064
8/1/2019,VA,Virginia,Spotsylvania,51177,21719,18661,3058,19032,115,18917,2687,102,2585,19308,16252,3056,11754,9329,2425,2086,510,135,9023
8/1/2019,VA,Virginia,Stafford,51179,18178,16026,2152,16112,105,16007,2066,86,1980,15942,13794,2148,8150,6424,1726,1500,359,85,6206
8/1/2019,VA,Virginia,Staunton City,51790,6297,5312,985,5286,23,5263,1011,15,996,5920,4935,985,4686,3870,816,1110,155,51,3370
8/1/2019,VA,Virginia,Suffolk City,51800,16853,12904,3949,13945,119,13826,2908,114,2794,15421,11474,3947,10628,7040,3588,2837,455,114,7222
8/1/2019,VA,Virginia,Surry,51181,1728,1331,397,1492,*,*,236,*,*,1585,1188,397,1168,802,366,222,59,13,874
8/1/2019,VA,Virginia,Sussex,51183,2525,1887,638,2085,34,2051,440,*,*,2358,1720,638,1830,1230,600,542,141,21,1126
8/1/2019,VA,Virginia,Tazewell,51185,11998,7806,4192,8952,35,8917,3046,39,3007,11401,7210,4191,9142,6148,2994,2301,465,162,6214
8/1/2019,VA,Virginia,Unknown,51999,*,*,*,*,*,*,*,*,*,*,*,*,*,*,*,*,*,*,*
8/1/2019,VA,Virginia,Virginia Beach City,51810,73860,59274,14586,65506,403,65103,8354,341,8013,67601,53031,14570,39526,26388,13138,7126,1485,397,30518
8/1/2019,VA,Virginia,Warren,51187,7845,6785,1060,6792,27,6765,1053,34,1019,7144,6085,1059,4903,4068,835,957,214,72,3660
8/1/2019,VA,Virginia,Washington,51191,15056,9308,5748,12295,44,12251,2761,34,2727,14207,8461,5746,11824,6579,5245,2448,520,196,8660
8/1/2019,VA,Virginia,Waynesboro City,51820,5007,4194,813,4152,18,4134,855,23,832,4663,3850,813,3706,2991,715,935,114,45,2612
8/1/2019,VA,Virginia,Westmoreland,51193,5095,4407,688,4490,23,4467,605,16,589,4628,3940,688,2994,2434,560,776,134,46,2038
8/1/2019,VA,Virginia,Williamsburg City,51830,2748,2262,486,2527,*,*,221,*,*,2538,2052,486,1817,1423,394,258,*,*,1522
8/1/2019,VA,Virginia,Winchester City,51840,5524,4714,810,4767,29,4738,757,21,736,5020,4210,810,3673,3013,660,891,135,45,2602
8/1/2019,VA,Virginia,Wise,51195,10672,5836,4836,7299,24,7275,3373,27,3346,10090,5255,4835,8189,3883,4306,2485,465,183,5056
8/1/2019,VA,Virginia,Wythe,51197,7956,5843,2113,6277,36,6241,1679,18,1661,7517,5405,2112,6154,4315,1839,1684,286,113,4071
8/1/2019,VA,Virginia,York,51199,12250,10461,1789,11264,41,11223,986,34,952,11206,9418,1788,6099,4576,1523,715,153,36,5195
12/1/2019,VA,Virginia,Accomack,51001,9055,7455,1600,7846,50,7796,1209,41,1168,8389,6790,1599,6196,4929,1267,1563,358,91,4184
12/1/2019,VA,Virginia,Albemarle,51003,21615,19013,2602,20035,65,19970,1580,42,1538,19414,16816,2598,14986,12814,2172,1605,288,104,12989
12/1/2019,VA,Virginia,Alexandria City,51510,18450,15293,3157,17071,67,17004,1379,86,1293,14831,11677,3154,9134,6329,2805,2202,285,62,6585
12/1/2019,VA,Virginia,Alleghany,51005,4581,3791,790,3732,17,3715,849,12,837,4349,3559,790,3527,2879,648,840,98,51,2538
12/1/2019,VA,Virginia,Amelia,51007,3129,2301,828,2660,*,*,469,20,449,2882,2054,828,2303,1536,767,482,91,37,1693
12/1/2019,VA,Virginia,Amherst,51009,7953,6261,1692,6645,46,6599,1308,29,1279,7399,5707,1692,6042,4534,1508,1288,205,73,4476
12/1/2019,VA,Virginia,Appomattox,51011,3983,3183,800,3275,18,3257,708,21,687,3741,2941,800,3039,2319,720,711,92,42,2194
12/1/2019,VA,Virginia,Arlington,51013,25191,21353,3838,23588,93,23495,1603,88,1515,19751,15919,3832,12081,8632,3449,3038,365,121,8557
12/1/2019,VA,Virginia,Augusta,51015,18619,15705,2914,16187,51,16136,2432,51,2381,17461,14548,2913,13601,11152,2449,1944,376,146,11135
12/1/2019,VA,Virginia,Bath,51017,1285,1165,120,1125,*,*,160,*,*,1215,1095,120,951,852,99,157,34,16,744
12/1/2019,VA,Virginia,Bedford,51019,20108,16209,3899,17357,80,17277,2751,47,2704,18691,14795,3896,14726,11862,2864,2090,447,149,12040
12/1/2019,VA,Virginia,Bland,51021,1808,1350,458,1435,*,*,373,*,*,1704,1246,458,1327,1003,324,237,54,17,1019
12/1/2019,VA,Virginia,Botetourt,51023,8852,6641,2211,7765,44,7721,1087,21,1066,8229,6018,2211,6540,4662,1878,742,160,50,5588
12/1/2019,VA,Virginia,Bristol City,51520,4650,2492,2158,3657,11,3646,993,15,978,4351,2194,2157,3708,1640,2068,1146,139,53,2370
12/1/2019,VA,Virginia,Brunswick,51025,4085,3174,911,3417,32,3385,668,20,648,3800,2889,911,3035,2251,784,1102,123,45,1765
12/1/2019,VA,Virginia,Buchanan,51027,7263,3972,3291,4645,17,4628,2618,21,2597,6999,3709,3290,5941,3479,2462,1704,386,111,3740
12/1/2019,VA,Virginia,Buckingham,51029,3695,3038,657,3041,19,3022,654,18,636,3467,2810,657,2657,2223,434,808,136,43,1670
12/1/2019,VA,Virginia,Buena Vista City,51530,1507,1199,308,1238,*,*,269,*,*,1399,1091,308,1098,840,258,309,54,17,718
12/1/2019,VA,Virginia,Campbell,51031,13275,10532,2743,11093,75,11018,2182,63,2119,12412,9669,2743,10142,7720,2422,2162,354,137,7489
12/1/2019,VA,Virginia,Caroline,51033,6083,4863,1220,5118,34,5084,965,36,929,5477,4257,1220,3763,2698,1065,891,202,46,2624
12/1/2019,VA,Virginia,Carroll,51035,8549,7059,1490,7075,23,7052,1474,15,1459,8096,6607,1489,6380,5202,1178,1661,246,109,4364
12/1/2019,VA,Virginia,Charles City,51036,1973,1489,484,1698,18,1680,275,15,260,1808,1324,484,1377,959,418,267,73,18,1019
12/1/2019,VA,Virginia,Charlotte,51037,3306,2680,626,2715,14,2701,591,17,574,3100,2475,625,2441,1895,546,748,126,40,1527
12/1/2019,VA,Virginia,Charlottesville City,51540,6422,5563,859,5374,26,5348,1048,42,1006,5767,4909,858,4652,3877,775,1294,147,37,3174
12/1/2019,VA,Virginia,Chesapeake City,51550,39658,30531,9127,34337,280,34057,5321,231,5090,35858,26739,9119,22214,14083,8131,4433,911,210,16660
12/1/2019,VA,Virginia,Chesterfield,51041,62559,46614,15945,55071,236,54835,7488,242,7246,56422,40485,15937,44057,29822,14235,5922,1010,285,36840
12/1/2019,VA,Virginia,Clarke,51043,3370,2926,444,3108,11,3097,262,*,*,3038,2594,444,2108,1773,335,284,65,25,1734
12/1/2019,VA,Virginia,Colonial Heights City,51570,4187,3398,789,3594,*,*,593,11,582,3827,3038,789,2545,1848,697,520,99,20,1906
12/1/2019,VA,Virginia,Covington City,51580,1596,1317,279,1223,14,1209,373,*,*,1493,1214,279,1206,950,256,337,45,15,809
12/1/2019,VA,Virginia,Craig,51045,1382,1002,380,1089,*,*,293,*,*,1286,906,380,1030,681,349,225,44,15,746
12/1/2019,VA,Virginia,Culpeper,51047,9661,8116,1545,8425,34,8391,1236,44,1192,8759,7216,1543,6170,4988,1182,1318,211,67,4574
12/1/2019,VA,Virginia,Cumberland,51049,2374,1795,579,1978,12,1966,396,*,*,2207,1628,579,1744,1236,508,456,88,31,1169
12/1/2019,VA,Virginia,Danville City,51590,11065,7731,3334,8758,77,8681,2307,115,2192,10389,7055,3334,8893,6431,2462,3296,369,159,5069
12/1/2019,VA,Virginia,Dickenson,51051,4902,2556,2346,3174,*,*,1728,*,*,4701,2356,2345,3968,1859,2109,1185,197,77,2509
12/1/2019,VA,Virginia,Dinwiddie,51053,6127,4725,1402,4994,35,4959,1133,33,1100,5646,4244,1402,4224,2910,1314,980,180,48,3016
12/1/2019,VA,Virginia,Emporia City,51595,1329,937,392,1044,22,1022,285,11,274,1247,855,392,1008,684,324,456,*,*,476
12/1/2019,VA,Virginia,Essex,51057,3023,2370,653,2595,14,2581,428,15,413,2783,2130,653,2119,1609,510,473,84,36,1526
12/1/2019,VA,Virginia,Fairfax,51059,156846,127554,29292,148421,571,147850,8425,469,7956,126206,96956,29250,75994,51123,24871,14787,2604,573,58030
12/1/2019,VA,Virginia,Fairfax City,51600,3943,3169,774,3678,13,3665,265,14,251,3313,2540,773,2085,1462,623,400,67,19,1599
12/1/2019,VA,Virginia,Falls Church City,51610,2117,1758,359,2031,*,*,86,0,86,1645,1288,357,1045,736,309,132,*,*,898
12/1/2019,VA,Virginia,Fauquier,51061,13033,11495,1538,11908,66,11842,1125,43,1082,11554,10016,1538,7523,6409,1114,1039,172,54,6258
12/1/2019,VA,Virginia,Floyd,51063,4224,3317,907,3669,14,3655,555,*,*,3947,3040,907,3182,2345,837,637,104,44,2397
12/1/2019,VA,Virginia,Fluvanna,51065,6182,5288,894,5543,21,5522,639,16,623,5626,4732,894,4180,3470,710,607,101,28,3444
12/1/2019,VA,Virginia,Franklin,51067,15229,10785,4444,12850,54,12796,2379,34,2345,14286,9844,4442,11717,7759,3958,2123,453,156,8985
12/1/2019,VA,Virginia,Franklin City,51620,2177,1772,405,1757,17,1740,420,19,401,2020,1615,405,1652,1281,371,551,61,19,1021
12/1/2019,VA,Virginia,Frederick,51069,17141,14561,2580,15334,58,15276,1807,48,1759,15583,13007,2576,10872,8839,2033,1504,348,123,8897
12/1/2019,VA,Virginia,Fredericksburg City,51630,4220,3603,617,3488,26,3462,732,23,709,3744,3127,617,2614,2076,538,872,75,41,1626
12/1/2019,VA,Virginia,Galax City,51640,1775,1560,215,1422,*,*,353,*,*,1676,1461,215,1379,1207,172,599,46,24,710
12/1/2019,VA,Virginia,Giles,51071,4621,3546,1075,3672,19,3653,949,15,934,4373,3298,1075,3634,2980,654,862,111,33,2628
12/1/2019,VA,Virginia,Gloucester,51073,8835,7225,1610,7664,38,7626,1171,22,1149,8157,6549,1608,5335,3952,1383,1052,168,52,4063
12/1/2019,VA,Virginia,Goochland,51075,6036,4721,1315,5554,25,5529,482,13,469,5544,4230,1314,4571,3496,1075,422,93,26,4030
12/1/2019,VA,Virginia,Grayson,51077,4594,3628,966,3790,14,3776,804,*,*,4401,3435,966,3414,2559,855,964,173,88,2189
12/1/2019,VA,Virginia,Greene,51079,4070,3494,576,3570,14,3556,500,11,489,3689,3113,576,2719,2219,500,497,72,28,2122
12/1/2019,VA,Virginia,Greensville,51081,2120,1521,599,1716,21,1695,404,14,390,1965,1366,599,1587,1121,466,454,100,25,1008
12/1/2019,VA,Virginia,Halifax,51083,9885,8127,1758,8193,65,8128,1692,51,1641,9247,7489,1758,7450,5904,1546,2213,393,138,4706
12/1/2019,VA,Virginia,Hampton City,51650,25854,18568,7286,21405,205,21200,4449,214,4235,23510,16225,7285,14722,7898,6824,4123,733,177,9689
12/1/2019,VA,Virginia,Hanover,51085,21917,16469,5448,20010,90,19920,1907,51,1856,19913,14467,5446,16189,11695,4494,1564,302,95,14228
12/1/2019,VA,Virginia,Harrisonburg City,51660,5606,4889,717,4752,22,4730,854,23,831,5086,4369,717,4071,3532,539,1058,118,43,2852
12/1/2019,VA,Virginia,Henrico,51087,58305,41848,16457,51305,315,50990,7000,294,6706,52654,36211,16443,43141,28726,14415,6883,1307,385,34566
12/1/2019,VA,Virginia,Henry,51089,14909,10270,4639,11911,70,11841,2998,71,2927,14161,9524,4637,12133,7821,4312,3145,673,221,8094
12/1/2019,VA,Virginia,Highland,51091,810,724,86,738,*,*,72,*,*,764,678,86,570,502,68,63,*,*,479
12/1/2019,VA,Virginia,Hopewell City,51670,4600,3469,1131,3565,31,3534,1035,35,1000,4264,3133,1131,3017,1938,1079,1068,131,39,1779
12/1/2019,VA,Virginia,Isle of Wight,51093,8557,6678,1879,7557,52,7505,1000,39,961,7900,6021,1879,5582,3872,1710,1034,179,68,4301
12/1/2019,VA,Virginia,James City,51095,21298,18089,3209,20030,53,19977,1268,49,1219,19701,16496,3205,12780,10385,2395,978,216,64,11522
12/1/2019,VA,Virginia,King and Queen,51097,1813,1460,353,1539,*,*,274,*,*,1684,1331,353,1278,972,306,295,*,*,915
12/1/2019,VA,Virginia,King George,51099,4071,3661,410,3535,14,3521,536,26,510,3533,3123,410,1762,1422,340,474,61,17,1210
12/1/2019,VA,Virginia,King William,51101,3539,2905,634,3031,23,3008,508,27,481,3262,2628,634,2635,2092,543,432,101,22,2080
12/1/2019,VA,Virginia,Lancaster,51103,4389,3740,649,4052,20,4032,337,17,320,4147,3499,648,3043,2625,418,523,88,14,2418
12/1/2019,VA,Virginia,Lee,51105,6447,3395,3052,4498,12,4486,1949,16,1933,6126,3076,3050,5062,2277,2785,2009,241,78,2734
12/1/2019,VA,Virginia,Lexington City,51678,1379,1209,170,1264,*,*,115,*,*,1251,1082,169,960,823,137,181,30,13,736
12/1/2019,VA,Virginia,Loudoun,51107,39954,32579,7375,37478,161,37317,2476,122,2354,33084,25716,7368,22271,16004,6267,3494,619,148,18010
12/1/2019,VA,Virginia,Louisa,51109,8491,6787,1704,7201,42,7159,1290,39,1251,7765,6061,1704,5815,4348,1467,1148,239,66,4362
12/1/2019,VA,Virginia,Lunenburg,51111,3139,2626,513,2597,13,2584,542,13,529,2904,2391,513,2227,1773,454,747,109,39,1332
12/1/2019,VA,Virginia,Lynchburg City,51680,14654,11621,3033,12038,81,11957,2616,102,2514,13588,10558,3030,11135,8430,2705,3066,430,136,7503
12/1/2019,VA,Virginia,Madison,51113,3338,2808,530,2980,13,2967,358,12,346,3097,2567,530,2303,1892,411,439,80,18,1766
12/1/2019,VA,Virginia,Manassas City,51683,4734,3748,986,4204,21,4183,530,43,487,3994,3008,986,2791,1942,849,580,79,32,2100
12/1/2019,VA,Virginia,Manassas Park City,51685,1352,1010,342,1174,17,1157,178,13,165,1128,786,342,806,493,313,209,53,11,533
12/1/2019,VA,Virginia,Martinsville City,51690,3853,2701,1152,2904,35,2869,949,39,910,3646,2495,1151,3140,2037,1103,1317,157,53,1613
12/1/2019,VA,Virginia,Mathews,51115,2906,2417,489,2654,*,*,252,*,*,2741,2252,489,1940,1543,397,298,32,18,1592
12/1/2019,VA,Virginia,Mecklenburg,51117,9307,7307,2000,7783,53,7730,1524,68,1456,8733,6734,1999,6916,5237,1679,1848,354,91,4623
12/1/2019,VA,Virginia,Middlesex,51119,3655,3053,602,3291,14,3277,364,*,*,3429,2828,601,2623,2170,453,470,76,29,2048
12/1/2019,VA,Virginia,Montgomery,51121,14343,11458,2885,12032,48,11984,2311,34,2277,12886,10003,2883,10767,8199,2568,2002,323,122,8320
12/1/2019,VA,Virginia,Nelson,51125,4713,3970,743,4221,15,4206,492,11,481,4351,3609,742,3239,2611,628,594,99,45,2501
12/1/2019,VA,Virginia,New Kent,51127,4775,3879,896,4301,17,4284,474,*,*,4331,3436,895,3094,2407,687,333,63,22,2676
12/1/2019,VA,Virginia,Newport News City,51700,28991,20649,8342,23945,199,23746,5046,247,4799,26454,18118,8336,17634,9741,7893,5217,835,202,11380
12/1/2019,VA,Virginia,Norfolk City,51710,33809,24152,9657,27259,271,26988,6550,324,6226,30342,20689,9653,20846,11672,9174,7675,1235,280,11656
12/1/2019,VA,Virginia,Northampton,51131,3787,3019,768,3292,24,3268,495,20,475,3521,2754,767,2832,2183,649,937,84,28,1783
12/1/2019,VA,Virginia,Northumberland,51133,4673,3950,723,4333,11,4322,340,14,326,4382,3659,723,2955,2528,427,452,67,27,2409
12/1/2019,VA,Virginia,Norton City,51720,1158,681,477,796,*,*,362,*,*,1073,596,477,899,466,433,356,44,12,487
12/1/2019,VA,Virginia,Nottoway,51135,3652,2966,686,3004,24,2980,648,15,633,3389,2703,686,2646,2123,523,887,118,44,1597
12/1/2019,VA,Virginia,Orange,51137,8886,7622,1264,7865,49,7816,1021,30,991,8095,6831,1264,5453,4592,861,1023,174,62,4194
12/1/2019,VA,Virginia,Page,51139,6243,5305,938,5179,22,5157,1064,23,1041,5818,4880,938,4294,3509,785,1102,238,77,2877
12/1/2019,VA,Virginia,Patrick,51141,5494,4153,1341,4565,*,*,929,11,918,5206,3866,1340,4250,3147,1103,1097,180,73,2900
12/1/2019,VA,Virginia,Petersburg City,51730,7243,5047,2196,5413,78,5335,1830,74,1756,6604,4410,2194,4954,2829,2125,2198,313,68,2375
12/1/2019,VA,Virginia,Pittsylvania,51143,16602,11805,4797,13704,86,13618,2898,75,2823,15599,10802,4797,13043,9443,3600,3149,515,183,9196
12/1/2019,VA,Virginia,Poquoson City,51735,2640,2300,340,2457,*,*,183,*,*,2422,2083,339,1263,970,293,125,23,12,1103
12/1/2019,VA,Virginia,Portsmouth City,51740,18621,13306,5315,14594,170,14424,4027,202,3825,16626,11314,5312,11259,6207,5052,4211,663,147,6238
12/1/2019,VA,Virginia,Powhatan,51145,6312,4939,1373,5702,16,5686,610,19,591,5789,4416,1373,4680,3509,1171,428,109,27,4116
12/1/2019,VA,Virginia,Prince Edward,51147,4712,3880,832,3833,37,3796,879,30,849,4358,3526,832,3401,2780,621,1092,145,53,2111
12/1/2019,VA,Virginia,Prince George,51149,6250,5345,905,5300,28,5272,950,33,917,5774,4870,904,3548,2752,796,609,119,28,2792
12/1/2019,VA,Virginia,Prince William,51153,51079,40712,10367,45847,291,45556,5232,304,4928,43417,33062,10355,25514,16336,9178,5527,1064,230,18693
12/1/2019,VA,Virginia,Pulaski,51155,9243,7238,2005,7440,26,7414,1803,33,1770,8600,6596,2004,7102,5360,1742,1637,280,100,5085
12/1/2019,VA,Virginia,Radford City,51750,2070,1632,438,1694,*,*,376,*,*,1877,1439,438,1594,1201,393,346,41,23,1184
12/1/2019,VA,Virginia,Rappahannock,51157,1979,1778,201,1845,*,*,134,*,*,1786,1586,200,1222,1080,142,154,*,*,1023
12/1/2019,VA,Virginia,Richmond,51159,1959,1573,386,1713,*,*,246,12,234,1816,1431,385,1358,1105,253,315,64,14,965
12/1/2019,VA,Virginia,Richmond City,51760,35010,22694,12316,28117,262,27855,6893,314,6579,31476,19172,12304,26867,15195,11672,9300,1263,291,16013
12/1/2019,VA,Virginia,Roanoke,51161,23973,17980,5993,21324,94,21230,2649,62,2587,22089,16099,5990,17966,12867,5099,2231,412,139,15184
12/1/2019,VA,Virginia,Roanoke City,51770,21396,14695,6701,16405,142,16263,4991,147,4844,19444,12749,6695,15982,9811,6171,5052,827,212,9891
12/1/2019,VA,Virginia,Rockbridge,51163,6415,5317,1098,5502,*,*,913,*,*,5948,4850,1098,4496,3583,913,894,176,56,3370
12/1/2019,VA,Virginia,Rockingham,51165,18203,15567,2636,16028,45,15983,2175,42,2133,16830,14195,2635,13221,11341,1880,1952,475,140,10654
12/1/2019,VA,Virginia,Russell,51167,8005,4724,3281,5611,13,5598,2394,22,2372,7664,4385,3279,6588,3903,2685,1748,326,146,4368
12/1/2019,VA,Virginia,Salem City,51775,6097,4715,1382,5162,26,5136,935,19,916,5627,4245,1382,4553,3320,1233,865,121,38,3529
12/1/2019,VA,Virginia,Scott,51169,6792,3106,3686,5184,11,5173,1608,17,1591,6515,2832,3683,5704,2156,3548,1570,237,107,3790
12/1/2019,VA,Virginia,Shenandoah,51171,10758,9086,1672,9575,36,9539,1183,24,1159,10053,8381,1672,7246,5903,1343,1338,256,80,5572
12/1/2019,VA,Virginia,Smyth,51173,8671,6024,2647,6542,35,6507,2129,28,2101,8224,5577,2647,6817,4379,2438,2132,355,124,4206
12/1/2019,VA,Virginia,Southampton,51175,4026,3304,722,3380,32,3348,646,26,620,3738,3016,722,2956,2322,634,749,109,34,2064
12/1/2019,VA,Virginia,Spotsylvania,51177,21982,18873,3109,19245,110,19135,2737,103,2634,19492,16386,3106,11837,9363,2474,2140,509,139,9049
12/1/2019,VA,Virginia,Stafford,51179,18419,16253,2166,16310,102,16208,2109,81,2028,16130,13968,2162,8208,6455,1753,1540,361,85,6222
12/1/2019,VA,Virginia,Staunton City,51790,6297,5301,996,5276,20,5256,1021,16,1005,5925,4929,996,4700,3869,831,1136,152,51,3361
12/1/2019,VA,Virginia,Suffolk City,51800,17016,13002,4014,14039,117,13922,2977,116,2861,15570,11558,4012,10709,7053,3656,2905,457,116,7231
12/1/2019,VA,Virginia,Surry,51181,1738,1337,401,1498,*,*,240,*,*,1600,1199,401,1177,807,370,227,56,12,882
12/1/2019,VA,Virginia,Sussex,51183,2542,1899,643,2095,31,2064,447,*,*,2368,1725,643,1832,1227,605,545,135,23,1129
12/1/2019,VA,Virginia,Tazewell,51185,12016,7804,4212,8943,31,8912,3073,37,3036,11417,7206,4211,9160,6140,3020,2350,453,161,6196
12/1/2019,VA,Virginia,Unknown,51999,*,*,*,*,*,*,*,*,*,*,*,*,*,*,*,*,*,*,*
12/1/2019,VA,Virginia,Virginia Beach City,51810,74668,59889,14779,66159,362,65797,8509,347,8162,68288,53525,14763,39843,26492,13351,7279,1465,400,30699
12/1/2019,VA,Virginia,Warren,51187,7905,6839,1066,6837,24,6813,1068,35,1033,7189,6124,1065,4926,4082,844,984,213,68,3661
12/1/2019,VA,Virginia,Washington,51191,15089,9284,5805,12306,43,12263,2783,34,2749,14236,8433,5803,11858,6547,5311,2481,514,200,8663
12/1/2019,VA,Virginia,Waynesboro City,51820,5015,4194,821,4146,18,4128,869,22,847,4667,3846,821,3716,2987,729,971,111,43,2591
12/1/2019,VA,Virginia,Westmoreland,51193,5129,4434,695,4507,21,4486,622,17,605,4670,3975,695,3028,2459,569,812,129,45,2042
12/1/2019,VA,Virginia,Williamsburg City,51830,2750,2262,488,2529,*,*,221,*,*,2541,2053,488,1821,1424,397,260,*,*,1524
12/1/2019,VA,Virginia,Winchester City,51840,5540,4712,828,4781,24,4757,759,20,739,5040,4212,828,3681,2999,682,901,132,43,2605
12/1/2019,VA,Virginia,Wise,51195,10709,5815,4894,7298,22,7276,3411,24,3387,10112,5218,4894,8230,3855,4375,2547,451,174,5058
12/1/2019,VA,Virginia,Wythe,51197,7999,5855,2144,6285,32,6253,1714,18,1696,7552,5409,2143,6179,4307,1872,1722,279,114,4064
12/1/2019,VA,Virginia,York,51199,12379,10576,1803,11371,37,11334,1008,35,973,11322,9520,1802,6124,4586,1538,733,151,34,5206
2/1/2019,VA,Virginia,Accomack,51001,8898,7339,1559,7752,57,7695,1146,44,1102,8253,6695,1558,6129,4912,1217,1466,383,90,4190
2/1/2019,VA,Virginia,Albemarle,51003,21137,18612,2525,19621,72,19549,1516,42,1474,18997,16476,2521,14687,12599,2088,1521,310,97,12759
2/1/2019,VA,Virginia,Alexandria City,51510,17850,14888,2962,16517,81,16436,1333,84,1249,14402,11442,2960,8894,6277,2617,2068,297,67,6462
2/1/2019,VA,Virginia,Alleghany,51005,4544,3802,742,3723,22,3701,821,13,808,4327,3585,742,3509,2921,588,799,103,52,2555
2/1/2019,VA,Virginia,Amelia,51007,3073,2282,791,2628,*,*,445,16,429,2835,2044,791,2291,1563,728,460,98,39,1694
2/1/2019,VA,Virginia,Amherst,51009,7842,6273,1569,6582,55,6527,1260,32,1228,7288,5719,1569,5932,4550,1382,1213,223,74,4422
2/1/2019,VA,Virginia,Appomattox,51011,3925,3189,736,3248,20,3228,677,23,654,3685,2949,736,3004,2354,650,674,108,44,2178
2/1/2019,VA,Virginia,Arlington,51013,24422,20834,3588,22873,109,22764,1549,85,1464,19186,15602,3584,11793,8592,3201,2898,371,117,8407
2/1/2019,VA,Virginia,Augusta,51015,18328,15522,2806,15980,61,15919,2348,52,2296,17180,14374,2806,13370,11057,2313,1809,397,147,11017
2/1/2019,VA,Virginia,Bath,51017,1266,1151,115,1116,*,*,150,*,*,1198,1083,115,941,844,97,143,35,20,743
2/1/2019,VA,Virginia,Bedford,51019,19721,15953,3768,17059,95,16964,2662,49,2613,18355,14589,3766,14500,11796,2704,1975,483,154,11888
2/1/2019,VA,Virginia,Bland,51021,1774,1336,438,1422,*,*,352,*,*,1674,1236,438,1310,1002,308,229,54,18,1009
2/1/2019,VA,Virginia,Botetourt,51023,8702,6539,2163,7680,54,7626,1022,20,1002,8088,5925,2163,6429,4614,1815,695,168,57,5509
2/1/2019,VA,Virginia,Bristol City,51520,4646,2527,2119,3693,13,3680,953,17,936,4361,2243,2118,3713,1684,2029,1083,146,61,2423
2/1/2019,VA,Virginia,Brunswick,51025,4032,3196,836,3391,33,3358,641,21,620,3754,2919,835,2995,2280,715,1036,124,45,1790
2/1/2019,VA,Virginia,Buchanan,51027,7265,4022,3243,4716,23,4693,2549,21,2528,7006,3763,3243,5926,3535,2391,1610,401,114,3801
2/1/2019,VA,Virginia,Buckingham,51029,3622,3018,604,2995,20,2975,627,19,608,3385,2781,604,2604,2229,375,762,148,50,1644
2/1/2019,VA,Virginia,Buena Vista City,51530,1501,1206,295,1238,*,*,263,*,*,1409,1114,295,1107,864,243,298,53,19,737
2/1/2019,VA,Virginia,Campbell,51031,13063,10510,2553,10988,86,10902,2075,64,2011,12240,9687,2553,10003,7774,2229,2072,369,137,7425
2/1/2019,VA,Virginia,Caroline,51033,5964,4793,1171,5030,38,4992,934,34,900,5365,4194,1171,3715,2702,1013,827,217,51,2620
2/1/2019,VA,Virginia,Carroll,51035,8461,7009,1452,7037,28,7009,1424,13,1411,7997,6545,1452,6281,5157,1124,1571,275,105,4330
2/1/2019,VA,Virginia,Charles City,51036,1941,1474,467,1681,21,1660,260,14,246,1784,1317,467,1383,984,399,248,80,16,1039
2/1/2019,VA,Virginia,Charlotte,51037,3259,2667,592,2684,17,2667,575,17,558,3070,2478,592,2446,1933,513,735,129,40,1542
2/1/2019,VA,Virginia,Charlottesville City,51540,6222,5445,777,5214,29,5185,1008,41,967,5571,4795,776,4510,3812,698,1219,148,44,3099
2/1/2019,VA,Virginia,Chesapeake City,51550,38544,29817,8727,33468,323,33145,5076,222,4854,34858,26139,8719,21801,14088,7713,4154,936,234,16477
2/1/2019,VA,Virginia,Chesterfield,51041,60868,45482,15386,53649,286,53363,7219,254,6965,54890,39512,15378,42898,29252,13646,5447,1049,289,36113
2/1/2019,VA,Virginia,Clarke,51043,3323,2875,448,3072,14,3058,251,*,*,2986,2538,448,2080,1737,343,268,71,24,1717
2/1/2019,VA,Virginia,Colonial Heights City,51570,4157,3400,757,3567,14,3553,590,12,578,3812,3055,757,2524,1861,663,496,108,22,1898
2/1/2019,VA,Virginia,Covington City,51580,1587,1342,245,1231,16,1215,356,*,*,1484,1239,245,1214,992,222,321,53,17,823
2/1/2019,VA,Virginia,Craig,51045,1369,1014,355,1088,*,*,281,*,*,1260,905,355,1024,700,324,211,42,13,758
2/1/2019,VA,Virginia,Culpeper,51047,9463,7996,1467,8291,44,8247,1172,48,1124,8545,7080,1465,6032,4925,1107,1227,234,71,4500
2/1/2019,VA,Virginia,Cumberland,51049,2355,1798,557,1972,13,1959,383,*,*,2188,1631,557,1726,1241,485,427,94,35,1170
2/1/2019,VA,Virginia,Danville City,51590,11018,7967,3051,8762,92,8670,2256,118,2138,10372,7321,3051,8900,6725,2175,3195,405,162,5138
2/1/2019,VA,Virginia,Dickenson,51051,4883,2623,2260,3205,*,*,1678,*,*,4675,2416,2259,3925,1906,2019,1137,203,82,2503
2/1/2019,VA,Virginia,Dinwiddie,51053,6034,4688,1346,4933,42,4891,1101,30,1071,5562,4216,1346,4144,2891,1253,943,192,52,2957
2/1/2019,VA,Virginia,Emporia City,51595,1317,957,360,1034,22,1012,283,12,271,1234,874,360,1013,721,292,447,*,*,488
2/1/2019,VA,Virginia,Essex,51057,2977,2355,622,2562,19,2543,415,16,399,2753,2131,622,2105,1629,476,447,91,33,1534
2/1/2019,VA,Virginia,Fairfax,51059,150940,123417,27523,142939,662,142277,8001,458,7543,121867,94384,27483,73476,50218,23258,13893,2694,577,56312
2/1/2019,VA,Virginia,Fairfax City,51600,3864,3122,742,3611,15,3596,253,13,240,3233,2492,741,2016,1429,587,375,68,18,1555
2/1/2019,VA,Virginia,Falls Church City,51610,2044,1706,338,1964,*,*,80,0,80,1584,1248,336,1007,719,288,126,*,*,865
2/1/2019,VA,Virginia,Fauquier,51061,12660,11174,1486,11600,73,11527,1060,41,1019,11253,9767,1486,7354,6281,1073,975,197,57,6125
2/1/2019,VA,Virginia,Floyd,51063,4122,3243,879,3581,18,3563,541,*,*,3851,2972,879,3103,2297,806,589,103,49,2362
2/1/2019,VA,Virginia,Fluvanna,51065,6033,5191,842,5421,24,5397,612,18,594,5491,4649,842,4083,3420,663,563,109,24,3387
2/1/2019,VA,Virginia,Franklin,51067,14956,10664,4292,12653,61,12592,2303,35,2268,14039,9749,4290,11557,7739,3818,2000,484,160,8913
2/1/2019,VA,Virginia,Franklin City,51620,2151,1790,361,1750,22,1728,401,20,381,2005,1644,361,1634,1309,325,535,61,17,1021
2/1/2019,VA,Virginia,Frederick,51069,16733,14250,2483,15009,69,14940,1724,49,1675,15223,12744,2479,10634,8714,1920,1399,365,121,8749
2/1/2019,VA,Virginia,Fredericksburg City,51630,4131,3539,592,3425,26,3399,706,24,682,3692,3100,592,2601,2088,513,814,93,41,1653
2/1/2019,VA,Virginia,Galax City,51640,1774,1569,205,1435,*,*,339,*,*,1680,1475,205,1377,1215,162,585,51,24,717
2/1/2019,VA,Virginia,Giles,51071,4618,3549,1069,3703,23,3680,915,14,901,4360,3291,1069,3639,3004,635,817,125,36,2661
2/1/2019,VA,Virginia,Gloucester,51073,8652,7116,1536,7524,42,7482,1128,23,1105,7971,6437,1534,5217,3911,1306,998,178,49,3992
2/1/2019,VA,Virginia,Goochland,51075,5862,4576,1286,5392,27,5365,470,16,454,5345,4060,1285,4428,3384,1044,386,102,28,3912
2/1/2019,VA,Virginia,Grayson,51077,4552,3652,900,3788,15,3773,764,12,752,4343,3443,900,3355,2571,784,933,176,85,2161
2/1/2019,VA,Virginia,Greene,51079,3974,3420,554,3498,16,3482,476,*,*,3608,3054,554,2670,2192,478,470,89,26,2085
2/1/2019,VA,Virginia,Greensville,51081,2103,1514,589,1709,21,1688,394,14,380,1957,1368,589,1594,1148,446,438,103,27,1026
2/1/2019,VA,Virginia,Halifax,51083,9814,8129,1685,8151,73,8078,1663,50,1613,9213,7528,1685,7468,6000,1468,2116,428,151,4773
2/1/2019,VA,Virginia,Hampton City,51650,25200,18332,6868,20919,229,20690,4281,210,4071,22960,16093,6867,14382,7977,6405,3785,786,180,9631
2/1/2019,VA,Virginia,Hanover,51085,21319,15971,5348,19490,105,19385,1829,53,1776,19431,14084,5347,15807,11426,4381,1463,337,96,13911
2/1/2019,VA,Virginia,Harrisonburg City,51660,5501,4805,696,4689,25,4664,812,24,788,4995,4299,696,4032,3527,505,1003,132,39,2858
2/1/2019,VA,Virginia,Henrico,51087,56997,41124,15873,50314,360,49954,6683,285,6398,51507,35650,15857,42282,28494,13788,6442,1415,395,34030
2/1/2019,VA,Virginia,Henry,51089,14851,10419,4432,11920,84,11836,2931,68,2863,14121,9690,4431,12122,8024,4098,2967,733,251,8171
2/1/2019,VA,Virginia,Highland,51091,794,711,83,723,*,*,71,*,*,745,662,83,560,493,67,54,*,*,475
2/1/2019,VA,Virginia,Hopewell City,51670,4548,3468,1080,3549,38,3511,999,35,964,4210,3130,1080,2977,1950,1027,1006,148,34,1789
2/1/2019,VA,Virginia,Isle of Wight,51093,8333,6490,1843,7394,58,7336,939,38,901,7701,5858,1843,5488,3822,1666,967,195,70,4256
2/1/2019,VA,Virginia,James City,51095,20879,17750,3129,19689,64,19625,1190,51,1139,19285,16159,3126,12486,10192,2294,886,233,64,11303
2/1/2019,VA,Virginia,King and Queen,51097,1786,1456,330,1523,13,1510,263,*,*,1655,1325,330,1250,967,283,274,*,*,901
2/1/2019,VA,Virginia,King George,51099,3958,3545,413,3442,15,3427,516,27,489,3442,3029,413,1754,1414,340,457,70,17,1210
2/1/2019,VA,Virginia,King William,51101,3464,2857,607,2978,27,2951,486,23,463,3170,2563,607,2574,2059,515,402,113,24,2035
2/1/2019,VA,Virginia,Lancaster,51103,4360,3723,637,4034,21,4013,326,18,308,4134,3498,636,3048,2646,402,489,105,16,2438
2/1/2019,VA,Virginia,Lee,51105,6437,3520,2917,4546,17,4529,1891,15,1876,6113,3198,2915,5032,2309,2723,1941,254,83,2754
2/1/2019,VA,Virginia,Lexington City,51678,1405,1251,154,1290,11,1279,115,*,*,1287,1134,153,995,873,122,193,31,13,758
2/1/2019,VA,Virginia,Loudoun,51107,38466,31423,7043,36122,186,35936,2344,114,2230,31992,24958,7034,21605,15674,5931,3231,647,152,17575
2/1/2019,VA,Virginia,Louisa,51109,8300,6646,1654,7061,47,7014,1239,35,1204,7597,5944,1653,5707,4296,1411,1076,252,74,4305
2/1/2019,VA,Virginia,Lunenburg,51111,3093,2609,484,2564,21,2543,529,15,514,2852,2368,484,2195,1771,424,718,112,41,1324
2/1/2019,VA,Virginia,Lynchburg City,51680,14543,11726,2817,12020,98,11922,2523,103,2420,13475,10660,2815,11045,8571,2474,2923,466,136,7520
2/1/2019,VA,Virginia,Madison,51113,3250,2754,496,2907,16,2891,343,12,331,3018,2522,496,2243,1867,376,417,91,26,1709
2/1/2019,VA,Virginia,Manassas City,51683,4564,3642,922,4059,24,4035,505,41,464,3819,2897,922,2692,1901,791,522,95,34,2041
2/1/2019,VA,Virginia,Manassas Park City,51685,1308,996,312,1141,16,1125,167,11,156,1100,788,312,784,501,283,196,*,*,531
2/1/2019,VA,Virginia,Martinsville City,51690,3863,2802,1061,2928,44,2884,935,37,898,3662,2602,1060,3172,2162,1010,1300,168,59,1645
2/1/2019,VA,Virginia,Mathews,51115,2851,2357,494,2625,12,2613,226,*,*,2692,2198,494,1918,1517,401,265,41,20,1592
2/1/2019,VA,Virginia,Mecklenburg,51117,9216,7288,1928,7740,62,7678,1476,65,1411,8646,6718,1928,6884,5298,1586,1791,373,101,4619
2/1/2019,VA,Virginia,Middlesex,51119,3590,2993,597,3238,16,3222,352,*,*,3390,2793,597,2596,2154,442,454,76,29,2037
2/1/2019,VA,Virginia,Montgomery,51121,14070,11311,2759,11824,57,11767,2246,30,2216,12704,9946,2758,10621,8178,2443,1900,359,126,8236
2/1/2019,VA,Virginia,Nelson,51125,4632,3912,720,4153,20,4133,479,11,468,4260,3541,719,3161,2559,602,550,108,44,2459
2/1/2019,VA,Virginia,New Kent,51127,4604,3706,898,4157,22,4135,447,*,*,4187,3290,897,2979,2291,688,297,79,18,2585
2/1/2019,VA,Virginia,Newport News City,51700,28368,20442,7926,23537,229,23308,4831,239,4592,25975,18052,7923,17301,9842,7459,4763,909,220,11409
2/1/2019,VA,Virginia,Norfolk City,51710,33115,24024,9091,26837,309,26528,6278,333,5945,29777,20690,9087,20475,11883,8592,7135,1364,295,11681
2/1/2019,VA,Virginia,Northampton,51131,3710,2978,732,3230,27,3203,480,19,461,3453,2722,731,2788,2176,612,896,94,32,1766
2/1/2019,VA,Virginia,Northumberland,51133,4624,3920,704,4299,17,4282,325,15,310,4331,3627,704,2921,2516,405,417,83,28,2393
2/1/2019,VA,Virginia,Norton City,51720,1143,702,441,791,*,*,352,*,*,1064,623,441,886,481,405,341,46,14,485
2/1/2019,VA,Virginia,Nottoway,51135,3640,2996,644,3012,28,2984,628,17,611,3368,2725,643,2643,2176,467,861,128,42,1612
2/1/2019,VA,Virginia,Orange,51137,8742,7484,1258,7747,56,7691,995,33,962,7982,6725,1257,5394,4549,845,952,191,67,4184
2/1/2019,VA,Virginia,Page,51139,6189,5259,930,5145,27,5118,1044,25,1019,5792,4862,930,4284,3508,776,1068,240,87,2889
2/1/2019,VA,Virginia,Patrick,51141,5459,4130,1329,4571,*,*,888,12,876,5174,3847,1327,4253,3163,1090,1069,198,74,2912
2/1/2019,VA,Virginia,Petersburg City,51730,7160,5129,2031,5382,94,5288,1778,78,1700,6540,4510,2030,4910,2955,1955,2066,357,69,2418
2/1/2019,VA,Virginia,Pittsylvania,51143,16416,11858,4558,13602,98,13504,2814,77,2737,15446,10888,4558,12944,9591,3353,3024,544,207,9169
2/1/2019,VA,Virginia,Poquoson City,51735,2571,2238,333,2389,*,*,182,*,*,2367,2036,331,1231,947,284,114,26,11,1080
2/1/2019,VA,Virginia,Portsmouth City,51740,18273,13311,4962,14394,205,14189,3879,209,3670,16333,11375,4958,11057,6371,4686,3877,733,155,6292
2/1/2019,VA,Virginia,Powhatan,51145,6121,4769,1352,5529,23,5506,592,19,573,5625,4273,1352,4537,3392,1145,413,114,28,3982
2/1/2019,VA,Virginia,Prince Edward,51147,4638,3815,823,3785,48,3737,853,33,820,4308,3485,823,3376,2771,605,1045,163,55,2113
2/1/2019,VA,Virginia,Prince George,51149,6119,5232,887,5204,34,5170,915,36,879,5644,4757,887,3465,2691,774,564,125,29,2747
2/1/2019,VA,Virginia,Prince William,51153,49030,39242,9788,44090,322,43768,4940,297,4643,41719,31942,9777,24712,16108,8604,5130,1092,223,18267
2/1/2019,VA,Virginia,Pulaski,51155,9188,7236,1952,7443,37,7406,1745,30,1715,8549,6598,1951,7072,5389,1683,1586,297,109,5080
2/1/2019,VA,Virginia,Radford City,51750,2046,1632,414,1676,*,*,370,*,*,1866,1452,414,1587,1217,370,334,41,24,1188
2/1/2019,VA,Virginia,Rappahannock,51157,1943,1748,195,1818,*,*,125,*,*,1746,1552,194,1210,1074,136,134,35,11,1030
2/1/2019,VA,Virginia,Richmond,51159,1946,1560,386,1706,*,*,240,15,225,1806,1421,385,1350,1109,241,299,67,14,970
2/1/2019,VA,Virginia,Richmond City,51760,34464,22719,11745,27727,306,27421,6737,323,6414,30982,19246,11736,26458,15370,11088,8642,1424,304,16088
2/1/2019,VA,Virginia,Roanoke,51161,23580,17729,5851,21045,108,20937,2535,64,2471,21770,15921,5849,17756,12812,4944,2073,450,136,15097
2/1/2019,VA,Virginia,Roanoke City,51770,21094,14774,6320,16248,164,16084,4846,144,4702,19168,12854,6314,15828,10056,5772,4769,880,212,9967
2/1/2019,VA,Virginia,Rockbridge,51163,6295,5264,1031,5422,14,5408,873,*,*,5841,4810,1031,4417,3571,846,830,188,56,3343
2/1/2019,VA,Virginia,Rockingham,51165,17796,15188,2608,15727,45,15682,2069,43,2026,16454,13847,2607,12941,11112,1829,1809,503,139,10490
2/1/2019,VA,Virginia,Russell,51167,7979,4776,3203,5649,15,5634,2330,21,2309,7631,4431,3200,6563,3961,2602,1658,336,150,4419
2/1/2019,VA,Virginia,Salem City,51775,6065,4714,1351,5161,39,5122,904,17,887,5610,4259,1351,4554,3358,1196,833,132,39,3550
2/1/2019,VA,Virginia,Scott,51169,6767,3144,3623,5198,14,5184,1569,16,1553,6498,2878,3620,5705,2188,3517,1526,246,110,3823
2/1/2019,VA,Virginia,Shenandoah,51171,10580,8993,1587,9449,42,9407,1131,25,1106,9881,8294,1587,7109,5863,1246,1227,277,89,5516
2/1/2019,VA,Virginia,Smyth,51173,8657,6134,2523,6579,38,6541,2078,28,2050,8190,5667,2523,6783,4490,2293,2058,403,134,4188
2/1/2019,VA,Virginia,Southampton,51175,3942,3239,703,3319,37,3282,623,26,597,3664,2961,703,2909,2296,613,694,120,35,2060
2/1/2019,VA,Virginia,Spotsylvania,51177,21357,18374,2983,18731,125,18606,2626,109,2517,18978,15996,2982,11621,9267,2354,1996,544,140,8941
2/1/2019,VA,Virginia,Stafford,51179,17788,15678,2110,15781,111,15670,2007,86,1921,15553,13447,2106,8056,6378,1678,1431,375,89,6161
2/1/2019,VA,Virginia,Staunton City,51790,6272,5353,919,5282,27,5255,990,17,973,5897,4978,919,4702,3957,745,1093,156,55,3398
2/1/2019,VA,Virginia,Suffolk City,51800,16611,12800,3811,13767,129,13638,2844,110,2734,15176,11368,3808,10544,7095,3449,2733,478,123,7210
2/1/2019,VA,Virginia,Surry,51181,1694,1302,392,1465,*,*,229,*,*,1556,1164,392,1146,787,359,199,65,13,869
2/1/2019,VA,Virginia,Sussex,51183,2524,1919,605,2092,40,2052,432,*,*,2354,1749,605,1822,1257,565,523,146,23,1130
2/1/2019,VA,Virginia,Tazewell,51185,11951,7841,4110,8956,39,8917,2995,39,2956,11318,7209,4109,9137,6247,2890,2236,478,182,6241
2/1/2019,VA,Virginia,Unknown,51999,*,*,*,*,*,*,*,*,*,*,*,*,*,*,*,*,*,*,*
2/1/2019,VA,Virginia,Virginia Beach City,51810,72596,58442,14154,64470,435,64035,8126,351,7775,66377,52239,14138,38983,26314,12669,6846,1522,417,30198
2/1/2019,VA,Virginia,Warren,51187,7736,6707,1029,6704,30,6674,1032,33,999,7035,6007,1028,4856,4048,808,917,227,78,3634
2/1/2019,VA,Virginia,Washington,51191,14936,9305,5631,12232,48,12184,2704,33,2671,14081,8452,5629,11709,6599,5110,2367,551,200,8591
2/1/2019,VA,Virginia,Waynesboro City,51820,4947,4171,776,4105,18,4087,842,24,818,4611,3835,776,3668,2989,679,889,124,43,2612
2/1/2019,VA,Virginia,Westmoreland,51193,5050,4376,674,4455,25,4430,595,16,579,4599,3925,674,2997,2450,547,750,144,49,2054
2/1/2019,VA,Virginia,Williamsburg City,51830,2738,2271,467,2520,*,*,218,12,206,2520,2053,467,1805,1428,377,239,*,*,1527
2/1/2019,VA,Virginia,Winchester City,51840,5487,4709,778,4747,33,4714,740,20,720,4990,4212,778,3649,3023,626,845,153,48,2603
2/1/2019,VA,Virginia,Wise,51195,10690,6107,4583,7354,27,7327,3336,26,3310,10103,5521,4582,8182,3976,4206,2426,473,193,5090
2/1/2019,VA,Virginia,Wythe,51197,7930,5865,2065,6276,41,6235,1654,18,1636,7500,5436,2064,6113,4325,1788,1627,290,103,4093
2/1/2019,VA,Virginia,York,51199,12080,10317,1763,11118,42,11076,962,33,929,11049,9287,1762,6020,4524,1496,678,156,38,5148
1/1/2019,VA,Virginia,Accomack,51001,8880,7328,1552,7740,57,7683,1140,44,1096,8238,6687,1551,6112,4900,1212,1461,384,90,4177
1/1/2019,VA,Virginia,Albemarle,51003,21114,18590,2524,19602,72,19530,1512,42,1470,18970,16450,2520,14645,12561,2084,1515,311,97,12722
1/1/2019,VA,Virginia,Alexandria City,51510,17787,14846,2941,16458,82,16376,1329,84,1245,14350,11411,2939,8874,6277,2597,2060,304,68,6442
1/1/2019,VA,Virginia,Alleghany,51005,4544,3800,744,3727,22,3705,817,13,804,4329,3585,744,3509,2920,589,797,104,52,2556
1/1/2019,VA,Virginia,Amelia,51007,3072,2289,783,2628,*,*,444,16,428,2836,2053,783,2291,1570,721,459,98,38,1696
1/1/2019,VA,Virginia,Amherst,51009,7820,6268,1552,6570,55,6515,1250,32,1218,7267,5715,1552,5917,4552,1365,1194,225,76,4422
1/1/2019,VA,Virginia,Appomattox,51011,3918,3189,729,3242,21,3221,676,23,653,3678,2949,729,2998,2355,643,672,109,44,2173
1/1/2019,VA,Virginia,Arlington,51013,24349,20780,3569,22800,109,22691,1549,86,1463,19152,15586,3566,11776,8591,3185,2880,377,117,8402
1/1/2019,VA,Virginia,Augusta,51015,18281,15481,2800,15949,63,15886,2332,53,2279,17147,14347,2800,13332,11024,2308,1794,401,147,10990
1/1/2019,VA,Virginia,Bath,51017,1269,1150,119,1122,*,*,147,*,*,1204,1085,119,944,845,99,144,36,22,742
1/1/2019,VA,Virginia,Bedford,51019,19685,15921,3764,17033,95,16938,2652,51,2601,18329,14568,3761,14455,11771,2684,1952,488,154,11861
1/1/2019,VA,Virginia,Bland,51021,1772,1334,438,1420,*,*,352,*,*,1675,1237,438,1306,1001,305,229,54,19,1004
1/1/2019,VA,Virginia,Botetourt,51023,8689,6531,2158,7669,53,7616,1020,21,999,8080,5922,2158,6422,4613,1809,691,174,54,5503
1/1/2019,VA,Virginia,Bristol City,51520,4649,2528,2121,3696,13,3683,953,17,936,4371,2251,2120,3726,1696,2030,1078,150,60,2438
1/1/2019,VA,Virginia,Brunswick,51025,4037,3213,824,3398,33,3365,639,20,619,3764,2941,823,2994,2291,703,1029,124,43,1798
1/1/2019,VA,Virginia,Buchanan,51027,7255,4019,3236,4719,25,4694,2536,20,2516,7000,3764,3236,5917,3535,2382,1596,406,113,3802
1/1/2019,VA,Virginia,Buckingham,51029,3626,3023,603,3005,21,2984,621,19,602,3389,2786,603,2615,2246,369,758,152,52,1653
1/1/2019,VA,Virginia,Buena Vista City,51530,1498,1203,295,1234,*,*,264,*,*,1403,1108,295,1104,861,243,298,54,19,733
1/1/2019,VA,Virginia,Campbell,51031,13059,10544,2515,10987,88,10899,2072,64,2008,12242,9727,2515,9993,7801,2192,2065,372,142,7414
1/1/2019,VA,Virginia,Caroline,51033,5956,4778,1178,5027,40,4987,929,35,894,5362,4184,1178,3709,2689,1020,821,219,51,2618
1/1/2019,VA,Virginia,Carroll,51035,8465,7017,1448,7046,28,7018,1419,13,1406,8000,6552,1448,6275,5152,1123,1566,278,103,4328
1/1/2019,VA,Virginia,Charles City,51036,1941,1478,463,1681,22,1659,260,13,247,1781,1318,463,1379,983,396,248,80,16,1035
1/1/2019,VA,Virginia,Charlotte,51037,3256,2669,587,2681,19,2662,575,17,558,3068,2481,587,2444,1936,508,735,131,41,1537
1/1/2019,VA,Virginia,Charlottesville City,51540,6221,5447,774,5215,29,5186,1006,42,964,5570,4797,773,4516,3822,694,1212,149,45,3110
1/1/2019,VA,Virginia,Chesapeake City,51550,38487,29793,8694,33435,328,33107,5052,223,4829,34820,26134,8686,21770,14091,7679,4118,943,235,16474
1/1/2019,VA,Virginia,Chesterfield,51041,60716,45388,15328,53521,291,53230,7195,253,6942,54767,39447,15320,42788,29197,13591,5418,1048,291,36031
1/1/2019,VA,Virginia,Clarke,51043,3312,2866,446,3063,14,3049,249,*,*,2974,2528,446,2073,1732,341,267,72,25,1709
1/1/2019,VA,Virginia,Colonial Heights City,51570,4159,3408,751,3570,14,3556,589,12,577,3819,3068,751,2527,1871,656,497,111,22,1897
1/1/2019,VA,Virginia,Covington City,51580,1589,1351,238,1232,16,1216,357,*,*,1485,1247,238,1210,995,215,317,53,20,820
1/1/2019,VA,Virginia,Craig,51045,1365,1017,348,1086,*,*,279,*,*,1255,907,348,1018,703,315,211,41,13,753
1/1/2019,VA,Virginia,Culpeper,51047,9456,8010,1446,8285,45,8240,1171,48,1123,8537,7093,1444,6009,4923,1086,1210,234,71,4494
1/1/2019,VA,Virginia,Cumberland,51049,2353,1798,555,1970,13,1957,383,*,*,2186,1631,555,1721,1239,482,424,95,35,1167
1/1/2019,VA,Virginia,Danville City,51590,11025,8000,3025,8773,95,8678,2252,118,2134,10376,7351,3025,8892,6742,2150,3180,407,163,5142
1/1/2019,VA,Virginia,Dickenson,51051,4883,2632,2251,3211,*,*,1672,*,*,4676,2426,2250,3919,1911,2008,1134,205,80,2500
1/1/2019,VA,Virginia,Dinwiddie,51053,6019,4675,1344,4924,44,4880,1095,31,1064,5546,4202,1344,4134,2883,1251,931,189,54,2960
1/1/2019,VA,Virginia,Emporia City,51595,1317,960,357,1035,22,1013,282,12,270,1232,875,357,1015,726,289,445,*,*,492
1/1/2019,VA,Virginia,Essex,51057,2971,2353,618,2557,19,2538,414,16,398,2748,2130,618,2099,1630,469,443,91,33,1532
1/1/2019,VA,Virginia,Fairfax,51059,150475,123134,27341,142496,668,141828,7979,454,7525,121540,94239,27301,73196,50111,23085,13796,2703,572,56125
1/1/2019,VA,Virginia,Fairfax City,51600,3870,3126,744,3616,15,3601,254,13,241,3237,2494,743,2016,1429,587,373,69,18,1556
1/1/2019,VA,Virginia,Falls Church City,51610,2037,1702,335,1957,*,*,80,0,80,1579,1246,333,1003,718,285,125,*,*,862
1/1/2019,VA,Virginia,Fauquier,51061,12639,11155,1484,11584,74,11510,1055,41,1014,11236,9752,1484,7345,6276,1069,984,195,57,6109
1/1/2019,VA,Virginia,Floyd,51063,4112,3236,876,3574,19,3555,538,*,*,3841,2965,876,3094,2291,803,584,104,49,2357
1/1/2019,VA,Virginia,Fluvanna,51065,6019,5178,841,5408,24,5384,611,18,593,5483,4642,841,4065,3404,661,558,106,25,3376
1/1/2019,VA,Virginia,Franklin,51067,14939,10654,4285,12643,61,12582,2296,34,2262,14024,9741,4283,11547,7733,3814,1992,486,162,8907
1/1/2019,VA,Virginia,Franklin City,51620,2150,1793,357,1749,22,1727,401,21,380,2006,1649,357,1637,1318,319,536,62,17,1022
1/1/2019,VA,Virginia,Frederick,51069,16694,14225,2469,14978,69,14909,1716,50,1666,15184,12719,2465,10591,8683,1908,1389,363,123,8716
1/1/2019,VA,Virginia,Fredericksburg City,51630,4121,3535,586,3415,27,3388,706,24,682,3692,3106,586,2597,2089,508,805,92,41,1659
1/1/2019,VA,Virginia,Galax City,51640,1776,1572,204,1441,*,*,335,*,*,1679,1475,204,1377,1217,160,581,52,23,721
1/1/2019,VA,Virginia,Giles,51071,4612,3538,1074,3701,23,3678,911,14,897,4355,3281,1074,3627,2994,633,815,127,36,2649
1/1/2019,VA,Virginia,Gloucester,51073,8623,7082,1541,7502,43,7459,1121,23,1098,7948,6409,1539,5199,3889,1310,990,181,50,3978
1/1/2019,VA,Virginia,Goochland,51075,5846,4566,1280,5376,29,5347,470,16,454,5327,4048,1279,4401,3363,1038,380,98,29,3894
1/1/2019,VA,Virginia,Grayson,51077,4549,3654,895,3788,16,3772,761,12,749,4340,3445,895,3351,2573,778,930,179,85,2157
1/1/2019,VA,Virginia,Greene,51079,3973,3422,551,3498,16,3482,475,*,*,3607,3056,551,2669,2193,476,471,89,26,2083
1/1/2019,VA,Virginia,Greensville,51081,2102,1515,587,1708,21,1687,394,15,379,1955,1368,587,1595,1149,446,436,103,27,1029
1/1/2019,VA,Virginia,Halifax,51083,9815,8122,1693,8158,75,8083,1657,50,1607,9215,7522,1693,7467,5993,1474,2104,431,151,4781
1/1/2019,VA,Virginia,Hampton City,51650,25161,18334,6827,20894,231,20663,4267,208,4059,22931,16105,6826,14349,7986,6363,3742,799,176,9632
1/1/2019,VA,Virginia,Hanover,51085,21292,15946,5346,19467,105,19362,1825,54,1771,19420,14075,5345,15800,11422,4378,1451,343,98,13908
1/1/2019,VA,Virginia,Harrisonburg City,51660,5493,4800,693,4683,25,4658,810,24,786,4992,4299,693,4021,3519,502,995,134,39,2853
1/1/2019,VA,Virginia,Henrico,51087,56890,41087,15803,50234,365,49869,6656,287,6369,51429,35642,15787,42175,28467,13708,6391,1411,396,33977
1/1/2019,VA,Virginia,Henry,51089,14866,10450,4416,11945,87,11858,2921,68,2853,14136,9721,4415,12136,8057,4079,2948,738,253,8197
1/1/2019,VA,Virginia,Highland,51091,792,709,83,721,*,*,71,*,*,743,660,83,559,492,67,54,*,*,475
1/1/2019,VA,Virginia,Hopewell City,51670,4546,3474,1072,3549,38,3511,997,36,961,4209,3137,1072,2981,1962,1019,1000,148,35,1798
1/1/2019,VA,Virginia,Isle of Wight,51093,8338,6493,1845,7404,61,7343,934,39,895,7706,5861,1845,5496,3827,1669,963,196,72,4265
1/1/2019,VA,Virginia,James City,51095,20859,17728,3131,19677,66,19611,1182,52,1130,19256,16128,3128,12455,10166,2289,875,239,63,11278
1/1/2019,VA,Virginia,King and Queen,51097,1783,1453,330,1521,13,1508,262,*,*,1651,1321,330,1250,968,282,273,*,*,900
1/1/2019,VA,Virginia,King George,51099,3959,3548,411,3446,17,3429,513,27,486,3446,3035,411,1758,1420,338,458,73,16,1211
1/1/2019,VA,Virginia,King William,51101,3456,2855,601,2974,28,2946,482,22,460,3163,2562,601,2562,2052,510,398,113,24,2027
1/1/2019,VA,Virginia,Lancaster,51103,4363,3728,635,4036,22,4014,327,18,309,4135,3501,634,3045,2648,397,490,102,15,2438
1/1/2019,VA,Virginia,Lee,51105,6435,3536,2899,4551,17,4534,1884,15,1869,6106,3209,2897,5024,2319,2705,1928,260,82,2754
1/1/2019,VA,Virginia,Lexington City,51678,1407,1256,151,1293,11,1282,114,*,*,1291,1141,150,1000,881,119,195,31,13,761
1/1/2019,VA,Virginia,Loudoun,51107,38376,31365,7011,36041,191,35850,2335,114,2221,31937,24935,7002,21538,15638,5900,3211,646,156,17525
1/1/2019,VA,Virginia,Louisa,51109,8288,6636,1652,7055,48,7007,1233,35,1198,7584,5933,1651,5703,4292,1411,1071,256,73,4303
1/1/2019,VA,Virginia,Lunenburg,51111,3096,2621,475,2566,21,2545,530,15,515,2853,2378,475,2190,1777,413,712,110,41,1327
1/1/2019,VA,Virginia,Lynchburg City,51680,14539,11743,2796,12021,99,11922,2518,102,2416,13471,10677,2794,11033,8585,2448,2908,469,137,7519
1/1/2019,VA,Virginia,Madison,51113,3239,2744,495,2899,16,2883,340,12,328,3005,2510,495,2237,1862,375,412,93,26,1706
1/1/2019,VA,Virginia,Manassas City,51683,4555,3638,917,4049,24,4025,506,42,464,3820,2903,917,2695,1909,786,519,99,34,2043
1/1/2019,VA,Virginia,Manassas Park City,51685,1311,999,312,1144,16,1128,167,11,156,1101,789,312,780,498,282,199,*,*,524
1/1/2019,VA,Virginia,Martinsville City,51690,3870,2822,1048,2933,46,2887,937,38,899,3668,2621,1047,3175,2178,997,1297,170,59,1649
1/1/2019,VA,Virginia,Mathews,51115,2853,2361,492,2628,12,2616,225,*,*,2695,2203,492,1921,1523,398,267,42,19,1593
1/1/2019,VA,Virginia,Mecklenburg,51117,9207,7282,1925,7735,62,7673,1472,65,1407,8642,6717,1925,6879,5301,1578,1787,374,102,4616
1/1/2019,VA,Virginia,Middlesex,51119,3581,2983,598,3230,17,3213,351,*,*,3383,2785,598,2593,2150,443,447,77,29,2040
1/1/2019,VA,Virginia,Montgomery,51121,14027,11275,2752,11794,57,11737,2233,30,2203,12663,9912,2751,10590,8154,2436,1878,360,126,8226
1/1/2019,VA,Virginia,Nelson,51125,4626,3910,716,4149,21,4128,477,11,466,4254,3539,715,3159,2563,596,552,109,44,2454
1/1/2019,VA,Virginia,New Kent,51127,4588,3693,895,4140,24,4116,448,*,*,4176,3282,894,2970,2286,684,299,79,18,2574
1/1/2019,VA,Virginia,Newport News City,51700,28328,20445,7883,23503,230,23273,4825,239,4586,25928,18048,7880,17261,9851,7410,4719,908,221,11413
1/1/2019,VA,Virginia,Norfolk City,51710,33046,24021,9025,26807,312,26495,6239,331,5908,29719,20698,9021,20443,11918,8525,7098,1376,296,11673
1/1/2019,VA,Virginia,Northampton,51131,3709,2976,733,3232,27,3205,477,19,458,3456,2724,732,2793,2181,612,893,101,33,1766
1/1/2019,VA,Virginia,Northumberland,51133,4622,3926,696,4297,17,4280,325,16,309,4330,3634,696,2914,2517,397,412,82,28,2392
1/1/2019,VA,Virginia,Norton City,51720,1137,703,434,787,*,*,350,*,*,1060,626,434,880,482,398,340,47,14,479
1/1/2019,VA,Virginia,Nottoway,51135,3645,2998,647,3018,28,2990,627,17,610,3377,2731,646,2651,2187,464,861,126,41,1623
1/1/2019,VA,Virginia,Orange,51137,8737,7476,1261,7747,56,7691,990,32,958,7987,6727,1260,5397,4551,846,943,194,66,4194
1/1/2019,VA,Virginia,Page,51139,6195,5272,923,5154,27,5127,1041,25,1016,5799,4876,923,4283,3515,768,1063,242,88,2890
1/1/2019,VA,Virginia,Patrick,51141,5463,4137,1326,4577,*,*,886,12,874,5178,3854,1324,4257,3171,1086,1064,197,75,2921
1/1/2019,VA,Virginia,Petersburg City,51730,7156,5135,2021,5384,95,5289,1772,77,1695,6537,4517,2020,4905,2961,1944,2049,356,70,2430
1/1/2019,VA,Virginia,Pittsylvania,51143,16406,11890,4516,13592,102,13490,2814,78,2736,15433,10917,4516,12912,9602,3310,3012,544,205,9151
1/1/2019,VA,Virginia,Poquoson City,51735,2568,2232,336,2388,*,*,180,*,*,2366,2032,334,1233,946,287,114,26,13,1080
1/1/2019,VA,Virginia,Portsmouth City,51740,18235,13314,4921,14373,208,14165,3862,209,3653,16301,11384,4917,11011,6365,4646,3842,728,152,6289
1/1/2019,VA,Virginia,Powhatan,51145,6100,4747,1353,5514,23,5491,586,19,567,5596,4243,1353,4514,3370,1144,411,115,28,3960
1/1/2019,VA,Virginia,Prince Edward,51147,4637,3813,824,3785,48,3737,852,33,819,4311,3487,824,3376,2772,604,1041,166,55,2114
1/1/2019,VA,Virginia,Prince George,51149,6104,5216,888,5196,34,5162,908,36,872,5631,4743,888,3452,2677,775,556,125,29,2742
1/1/2019,VA,Virginia,Prince William,51153,48894,39154,9740,43970,325,43645,4924,297,4627,41626,31896,9730,24631,16073,8558,5102,1093,220,18216
1/1/2019,VA,Virginia,Pulaski,51155,9182,7236,1946,7445,37,7408,1737,30,1707,8554,6609,1945,7067,5393,1674,1574,300,112,5081
1/1/2019,VA,Virginia,Radford City,51750,2040,1630,410,1671,*,*,369,*,*,1864,1454,410,1586,1220,366,333,39,24,1190
1/1/2019,VA,Virginia,Rappahannock,51157,1945,1747,198,1820,*,*,125,*,*,1751,1554,197,1208,1070,138,134,35,11,1028
1/1/2019,VA,Virginia,Richmond,51159,1949,1564,385,1708,*,*,241,15,226,1807,1423,384,1355,1113,242,299,68,15,973
1/1/2019,VA,Virginia,Richmond City,51760,34404,22738,11666,27677,307,27370,6727,329,6398,30945,19288,11657,26425,15417,11008,8580,1429,303,16113
1/1/2019,VA,Virginia,Roanoke,51161,23548,17710,5838,21027,109,20918,2521,62,2459,21759,15923,5836,17729,12797,4932,2065,453,138,15073
1/1/2019,VA,Virginia,Roanoke City,51770,21062,14783,6279,16231,164,16067,4831,146,4685,19157,12884,6273,15821,10094,5727,4743,889,216,9973
1/1/2019,VA,Virginia,Rockbridge,51163,6288,5258,1030,5416,14,5402,872,*,*,5842,4812,1030,4414,3570,844,824,189,56,3345
1/1/2019,VA,Virginia,Rockingham,51165,17769,15161,2608,15711,48,15663,2058,44,2014,16433,13826,2607,12908,11078,1830,1789,508,137,10474
1/1/2019,VA,Virginia,Russell,51167,7975,4786,3189,5660,15,5645,2315,20,2295,7629,4443,3186,6555,3972,2583,1646,342,149,4418
1/1/2019,VA,Virginia,Salem City,51775,6064,4710,1354,5166,40,5126,898,17,881,5609,4255,1354,4556,3357,1199,828,136,39,3553
1/1/2019,VA,Virginia,Scott,51169,6763,3160,3603,5193,14,5179,1570,16,1554,6488,2888,3600,5690,2190,3500,1518,246,110,3816
1/1/2019,VA,Virginia,Shenandoah,51171,10566,8982,1584,9433,43,9390,1133,26,1107,9869,8285,1584,7104,5861,1243,1216,279,87,5522
1/1/2019,VA,Virginia,Smyth,51173,8678,6154,2524,6599,38,6561,2079,29,2050,8207,5683,2524,6800,4506,2294,2068,406,135,4191
1/1/2019,VA,Virginia,Southampton,51175,3933,3236,697,3314,37,3277,619,24,595,3656,2959,697,2897,2291,606,690,122,35,2050
1/1/2019,VA,Virginia,Spotsylvania,51177,21314,18337,2977,18706,127,18579,2608,107,2501,18952,15976,2976,11591,9248,2343,1977,545,142,8927
1/1/2019,VA,Virginia,Stafford,51179,17743,15641,2102,15753,111,15642,1990,85,1905,15524,13426,2098,8044,6374,1670,1418,374,89,6163
1/1/2019,VA,Virginia,Staunton City,51790,6276,5366,910,5287,26,5261,989,17,972,5906,4996,910,4703,3968,735,1087,156,54,3406
1/1/2019,VA,Virginia,Suffolk City,51800,16572,12776,3796,13749,131,13618,2823,110,2713,15153,11360,3793,10521,7092,3429,2716,482,121,7202
1/1/2019,VA,Virginia,Surry,51181,1694,1300,394,1466,11,1455,228,*,*,1558,1164,394,1145,783,362,197,65,13,870
1/1/2019,VA,Virginia,Sussex,51183,2520,1922,598,2090,41,2049,430,*,*,2350,1752,598,1818,1260,558,518,145,23,1132
1/1/2019,VA,Virginia,Tazewell,51185,11957,7853,4104,8975,39,8936,2982,39,2943,11320,7217,4103,9127,6249,2878,2225,485,185,6232
1/1/2019,VA,Virginia,Unknown,51999,*,*,*,*,*,*,*,*,*,*,*,*,*,*,*,*,*,*,*
1/1/2019,VA,Virginia,Virginia Beach City,51810,72456,58344,14112,64355,447,63908,8101,345,7756,66277,52181,14096,38912,26295,12617,6805,1543,415,30149
1/1/2019,VA,Virginia,Warren,51187,7725,6703,1022,6690,30,6660,1035,33,1002,7028,6007,1021,4839,4039,800,900,234,78,3627
1/1/2019,VA,Virginia,Washington,51191,14915,9302,5613,12231,49,12182,2684,32,2652,14058,8447,5611,11691,6602,5089,2347,553,200,8591
1/1/2019,VA,Virginia,Waynesboro City,51820,4945,4171,774,4104,18,4086,841,24,817,4611,3837,774,3665,2991,674,886,124,43,2612
1/1/2019,VA,Virginia,Westmoreland,51193,5048,4373,675,4453,26,4427,595,16,579,4595,3920,675,2987,2441,546,741,148,49,2049
1/1/2019,VA,Virginia,Williamsburg City,51830,2738,2272,466,2519,*,*,219,12,207,2517,2051,466,1799,1423,376,240,*,*,1519
1/1/2019,VA,Virginia,Winchester City,51840,5479,4711,768,4746,33,4713,733,18,715,4984,4216,768,3636,3019,617,839,153,47,2597
1/1/2019,VA,Virginia,Wise,51195,10693,6114,4579,7360,28,7332,3333,26,3307,10108,5529,4579,8185,3986,4199,2418,479,191,5097
1/1/2019,VA,Virginia,Wythe,51197,7937,5879,2058,6287,43,6244,1650,18,1632,7511,5454,2057,6113,4338,1775,1617,294,104,4098
1/1/2019,VA,Virginia,York,51199,12053,10286,1767,11094,43,11051,959,33,926,11038,9272,1766,6018,4522,1496,673,156,38,5151
7/1/2019,VA,Virginia,Accomack,51001,8982,7409,1573,7807,52,7755,1175,41,1134,8323,6751,1572,6163,4930,1233,1523,360,92,4188
7/1/2019,VA,Virginia,Albemarle,51003,21340,18755,2585,19803,70,19733,1537,42,1495,19214,16633,2581,14851,12703,2148,1577,295,95,12884
7/1/2019,VA,Virginia,Alexandria City,51510,18160,15099,3061,16807,75,16732,1353,82,1271,14648,11590,3058,9003,6284,2719,2144,280,64,6515
7/1/2019,VA,Virginia,Alleghany,51005,4553,3790,763,3715,19,3696,838,13,825,4334,3571,763,3503,2888,615,819,103,47,2534
7/1/2019,VA,Virginia,Amelia,51007,3101,2290,811,2648,*,*,453,17,436,2862,2051,811,2300,1552,748,475,94,37,1694
7/1/2019,VA,Virginia,Amherst,51009,7880,6246,1634,6598,50,6548,1282,29,1253,7334,5700,1634,5975,4527,1448,1241,209,75,4450
7/1/2019,VA,Virginia,Appomattox,51011,3956,3187,769,3266,18,3248,690,22,668,3720,2951,769,3014,2331,683,691,91,42,2190
7/1/2019,VA,Virginia,Arlington,51013,24826,21081,3745,23258,99,23159,1568,86,1482,19534,15793,3741,11927,8570,3357,2971,359,107,8490
7/1/2019,VA,Virginia,Augusta,51015,18488,15622,2866,16091,56,16035,2397,50,2347,17329,14464,2865,13467,11076,2391,1883,384,140,11060
7/1/2019,VA,Virginia,Bath,51017,1271,1154,117,1117,*,*,154,*,*,1205,1088,117,942,845,97,152,34,18,738
7/1/2019,VA,Virginia,Bedford,51019,19884,16048,3836,17189,88,17101,2695,49,2646,18522,14689,3833,14612,11833,2779,2038,462,153,11959
7/1/2019,VA,Virginia,Bland,51021,1791,1336,455,1429,*,*,362,*,*,1691,1236,455,1325,1003,322,235,53,17,1020
7/1/2019,VA,Virginia,Botetourt,51023,8765,6585,2180,7708,49,7659,1057,23,1034,8162,5982,2180,6483,4640,1843,732,159,51,5541
7/1/2019,VA,Virginia,Bristol City,51520,4645,2514,2131,3673,12,3661,972,17,955,4370,2240,2130,3706,1665,2041,1117,146,62,2381
7/1/2019,VA,Virginia,Brunswick,51025,4050,3165,885,3393,34,3359,657,20,637,3771,2886,885,3010,2250,760,1065,129,43,1773
7/1/2019,VA,Virginia,Buchanan,51027,7270,3992,3278,4677,19,4658,2593,22,2571,7020,3743,3277,5942,3502,2440,1670,388,110,3774
7/1/2019,VA,Virginia,Buckingham,51029,3661,3021,640,3020,19,3001,641,18,623,3432,2792,640,2635,2223,412,792,136,41,1666
7/1/2019,VA,Virginia,Buena Vista City,51530,1499,1185,314,1231,*,*,268,*,*,1403,1089,314,1105,842,263,307,52,17,729
7/1/2019,VA,Virginia,Campbell,51031,13138,10497,2641,11012,81,10931,2126,63,2063,12307,9666,2641,10040,7723,2317,2115,357,138,7430
7/1/2019,VA,Virginia,Caroline,51033,6030,4835,1195,5079,37,5042,951,35,916,5429,4234,1195,3732,2694,1038,869,202,48,2613
7/1/2019,VA,Virginia,Carroll,51035,8476,7016,1460,7045,25,7020,1431,14,1417,8034,6574,1460,6320,5173,1147,1619,252,104,4345
7/1/2019,VA,Virginia,Charles City,51036,1948,1478,470,1684,18,1666,264,15,249,1786,1316,470,1371,966,405,257,75,17,1022
7/1/2019,VA,Virginia,Charlotte,51037,3267,2655,612,2691,16,2675,576,16,560,3075,2463,612,2439,1908,531,748,124,40,1527
7/1/2019,VA,Virginia,Charlottesville City,51540,6313,5499,814,5297,28,5269,1016,40,976,5673,4860,813,4573,3840,733,1246,142,38,3147
7/1/2019,VA,Virginia,Chesapeake City,51550,39082,30182,8900,33884,300,33584,5198,225,4973,35373,26481,8892,21987,14086,7901,4331,910,209,16537
7/1/2019,VA,Virginia,Chesterfield,51041,61753,46053,15700,54403,262,54141,7350,245,7105,55763,40072,15691,43506,29534,13972,5684,1010,280,36532
7/1/2019,VA,Virginia,Clarke,51043,3351,2901,450,3094,13,3081,257,*,*,3026,2576,450,2102,1760,342,285,64,25,1728
7/1/2019,VA,Virginia,Colonial Heights City,51570,4175,3398,777,3583,11,3572,592,13,579,3824,3047,777,2523,1837,686,501,102,21,1899
7/1/2019,VA,Virginia,Covington City,51580,1598,1333,265,1229,15,1214,369,*,*,1497,1232,265,1205,966,239,330,49,15,811
7/1/2019,VA,Virginia,Craig,51045,1375,1007,368,1085,*,*,290,*,*,1276,908,368,1025,689,336,220,44,14,747
7/1/2019,VA,Virginia,Culpeper,51047,9577,8063,1514,8380,39,8341,1197,45,1152,8668,7156,1512,6107,4953,1154,1282,214,68,4543
7/1/2019,VA,Virginia,Cumberland,51049,2361,1796,565,1971,13,1958,390,*,*,2197,1632,565,1728,1235,493,441,90,33,1164
7/1/2019,VA,Virginia,Danville City,51590,11012,7788,3224,8725,82,8643,2287,121,2166,10358,7134,3224,8881,6524,2357,3244,382,154,5101
7/1/2019,VA,Virginia,Dickenson,51051,4908,2604,2304,3203,*,*,1705,*,*,4706,2403,2303,3943,1880,2063,1173,197,78,2495
7/1/2019,VA,Virginia,Dinwiddie,51053,6080,4695,1385,4963,39,4924,1117,31,1086,5614,4229,1385,4200,2905,1295,970,177,50,3003
7/1/2019,VA,Virginia,Emporia City,51595,1336,959,377,1052,22,1030,284,11,273,1255,878,377,1014,702,312,461,*,*,481
7/1/2019,VA,Virginia,Essex,51057,3005,2360,645,2582,16,2566,423,15,408,2770,2125,645,2114,1615,499,463,89,36,1526
7/1/2019,VA,Virginia,Fairfax,51059,153764,125343,28421,145586,620,144966,8178,468,7710,124260,95879,28381,74617,50485,24132,14359,2598,562,57098
7/1/2019,VA,Virginia,Fairfax City,51600,3888,3133,755,3627,14,3613,261,14,247,3265,2511,754,2047,1443,604,390,72,18,1567
7/1/2019,VA,Virginia,Falls Church City,51610,2076,1726,350,1995,*,*,81,0,81,1620,1272,348,1026,728,298,124,*,*,887
7/1/2019,VA,Virginia,Fauquier,51061,12816,11295,1521,11725,70,11655,1091,41,1050,11377,9856,1521,7416,6312,1104,1012,178,54,6172
7/1/2019,VA,Virginia,Floyd,51063,4168,3273,895,3620,18,3602,548,*,*,3897,3002,895,3138,2313,825,608,105,48,2377
7/1/2019,VA,Virginia,Fluvanna,51065,6115,5236,879,5492,24,5468,623,20,603,5564,4685,879,4117,3423,694,586,103,25,3403
7/1/2019,VA,Virginia,Franklin,51067,15091,10734,4357,12745,56,12689,2346,35,2311,14194,9839,4355,11631,7750,3881,2075,459,157,8940
7/1/2019,VA,Virginia,Franklin City,51620,2161,1779,382,1747,19,1728,414,20,394,2017,1635,382,1635,1288,347,543,58,17,1017
7/1/2019,VA,Virginia,Frederick,51069,16948,14396,2552,15177,65,15112,1771,49,1722,15443,12895,2548,10737,8738,1999,1456,355,117,8809
7/1/2019,VA,Virginia,Fredericksburg City,51630,4161,3566,595,3442,27,3415,719,24,695,3710,3115,595,2588,2068,520,843,77,39,1629
7/1/2019,VA,Virginia,Galax City,51640,1767,1561,206,1426,*,*,341,*,*,1676,1470,206,1373,1210,163,586,49,23,715
7/1/2019,VA,Virginia,Giles,51071,4624,3546,1078,3697,22,3675,927,15,912,4367,3289,1078,3634,2983,651,839,117,33,2645
7/1/2019,VA,Virginia,Gloucester,51073,8716,7136,1580,7569,40,7529,1147,23,1124,8060,6482,1578,5256,3902,1354,1011,171,49,4025
7/1/2019,VA,Virginia,Goochland,51075,5947,4650,1297,5478,26,5452,469,15,454,5456,4160,1296,4507,3450,1057,405,93,27,3982
7/1/2019,VA,Virginia,Grayson,51077,4572,3634,938,3786,15,3771,786,12,774,4378,3440,938,3377,2551,826,948,174,82,2173
7/1/2019,VA,Virginia,Greene,51079,4015,3446,569,3526,15,3511,489,11,478,3635,3066,569,2684,2191,493,477,79,28,2100
7/1/2019,VA,Virginia,Greensville,51081,2116,1524,592,1711,21,1690,405,15,390,1966,1374,592,1595,1138,457,454,102,24,1015
7/1/2019,VA,Virginia,Halifax,51083,9843,8111,1732,8171,70,8101,1672,50,1622,9215,7483,1732,7427,5911,1516,2178,404,139,4706
7/1/2019,VA,Virginia,Hampton City,51650,25457,18358,7099,21103,216,20887,4354,212,4142,23190,16091,7099,14513,7875,6638,3960,742,174,9637
7/1/2019,VA,Virginia,Hanover,51085,21638,16238,5400,19771,98,19673,1867,55,1812,19678,14280,5398,15999,11564,4435,1534,319,96,14050
7/1/2019,VA,Virginia,Harrisonburg City,51660,5543,4845,698,4715,22,4693,828,25,803,5035,4337,698,4032,3518,514,1025,121,40,2846
7/1/2019,VA,Virginia,Henrico,51087,57617,41474,16143,50778,339,50439,6839,299,6540,52100,35973,16127,42643,28558,14085,6678,1319,378,34268
7/1/2019,VA,Virginia,Henry,51089,14854,10297,4557,11896,75,11821,2958,68,2890,14133,9578,4555,12118,7894,4224,3052,699,226,8141
7/1/2019,VA,Virginia,Highland,51091,800,718,82,728,*,*,72,*,*,753,671,82,560,495,65,59,*,*,475
7/1/2019,VA,Virginia,Hopewell City,51670,4550,3438,1112,3543,35,3508,1007,35,972,4210,3098,1112,2976,1916,1060,1028,139,38,1771
7/1/2019,VA,Virginia,Isle of Wight,51093,8434,6569,1865,7474,55,7419,960,40,920,7799,5934,1865,5532,3839,1693,1007,183,70,4272
7/1/2019,VA,Virginia,James City,51095,21096,17923,3173,19863,58,19805,1233,53,1180,19521,16352,3169,12631,10288,2343,937,218,61,11415
7/1/2019,VA,Virginia,King and Queen,51097,1803,1452,351,1528,12,1516,275,*,*,1676,1325,351,1273,969,304,287,*,*,910
7/1/2019,VA,Virginia,King George,51099,4016,3600,416,3494,14,3480,522,27,495,3491,3075,416,1746,1403,343,463,63,17,1203
7/1/2019,VA,Virginia,King William,51101,3502,2875,627,3004,23,2981,498,25,473,3217,2590,627,2592,2058,534,419,105,23,2045
7/1/2019,VA,Virginia,Lancaster,51103,4370,3722,648,4037,21,4016,333,18,315,4143,3496,647,3052,2634,418,508,94,14,2436
7/1/2019,VA,Virginia,Lee,51105,6434,3407,3027,4513,14,4499,1921,15,1906,6115,3090,3025,5032,2281,2751,1968,241,81,2742
7/1/2019,VA,Virginia,Lexington City,51678,1385,1219,166,1269,*,*,116,*,*,1267,1102,165,977,844,133,182,33,13,749
7/1/2019,VA,Virginia,Loudoun,51107,39216,31966,7250,36795,177,36618,2421,122,2299,32605,25362,7243,21950,15806,6144,3381,621,135,17813
7/1/2019,VA,Virginia,Louisa,51109,8378,6713,1665,7110,47,7063,1268,39,1229,7684,6019,1665,5741,4315,1426,1110,239,65,4327
7/1/2019,VA,Virginia,Lunenburg,51111,3120,2615,505,2584,18,2566,536,15,521,2882,2377,505,2205,1760,445,739,108,36,1322
7/1/2019,VA,Virginia,Lynchburg City,51680,14609,11673,2936,12034,91,11943,2575,106,2469,13544,10611,2933,11085,8487,2598,3008,443,137,7497
7/1/2019,VA,Virginia,Madison,51113,3288,2776,512,2936,14,2922,352,14,338,3063,2551,512,2275,1880,395,431,82,20,1742
7/1/2019,VA,Virginia,Manassas City,51683,4649,3695,954,4135,23,4112,514,43,471,3910,2956,954,2726,1907,819,553,83,30,2060
7/1/2019,VA,Virginia,Manassas Park City,51685,1321,996,325,1149,17,1132,172,14,158,1104,779,325,789,493,296,199,*,*,529
7/1/2019,VA,Virginia,Martinsville City,51690,3856,2738,1118,2910,38,2872,946,39,907,3650,2533,1117,3140,2071,1069,1299,162,54,1625
7/1/2019,VA,Virginia,Mathews,51115,2878,2388,490,2637,*,*,241,*,*,2715,2225,490,1920,1523,397,287,33,19,1581
7/1/2019,VA,Virginia,Mecklenburg,51117,9251,7291,1960,7752,57,7695,1499,66,1433,8684,6725,1959,6880,5250,1630,1822,346,90,4622
7/1/2019,VA,Virginia,Middlesex,51119,3622,3017,605,3265,15,3250,357,*,*,3410,2805,605,2619,2164,455,462,75,29,2053
7/1/2019,VA,Virginia,Montgomery,51121,14178,11334,2844,11900,52,11848,2278,32,2246,12798,9955,2843,10705,8178,2527,1957,338,124,8286
7/1/2019,VA,Virginia,Nelson,51125,4666,3931,735,4177,16,4161,489,12,477,4310,3576,734,3192,2574,618,573,102,42,2475
7/1/2019,VA,Virginia,New Kent,51127,4669,3772,897,4209,18,4191,460,11,449,4239,3343,896,3025,2340,685,306,74,19,2626
7/1/2019,VA,Virginia,Newport News City,51700,28659,20502,8157,23736,216,23520,4923,243,4680,26237,18084,8153,17426,9727,7699,5016,864,208,11338
7/1/2019,VA,Virginia,Norfolk City,51710,33464,24085,9379,27060,287,26773,6404,334,6070,30105,20731,9374,20597,11706,8891,7404,1264,283,11646
7/1/2019,VA,Virginia,Northampton,51131,3746,2996,750,3262,26,3236,484,19,465,3484,2735,749,2802,2171,631,923,84,26,1769
7/1/2019,VA,Virginia,Northumberland,51133,4649,3929,720,4315,14,4301,334,14,320,4356,3636,720,2932,2509,423,430,74,28,2400
7/1/2019,VA,Virginia,Norton City,51720,1159,691,468,798,*,*,361,*,*,1077,609,468,895,473,422,353,43,13,486
7/1/2019,VA,Virginia,Nottoway,51135,3636,2954,682,2998,27,2971,638,14,624,3372,2690,682,2623,2113,510,872,116,43,1592
7/1/2019,VA,Virginia,Orange,51137,8787,7520,1267,7780,54,7726,1007,31,976,8025,6759,1266,5407,4550,857,986,179,62,4180
7/1/2019,VA,Virginia,Page,51139,6219,5289,930,5160,25,5135,1059,23,1036,5818,4888,930,4303,3524,779,1091,229,80,2903
7/1/2019,VA,Virginia,Patrick,51141,5476,4129,1347,4572,*,*,904,12,892,5184,3839,1345,4247,3143,1104,1094,184,73,2896
7/1/2019,VA,Virginia,Petersburg City,51730,7183,5048,2135,5385,84,5301,1798,77,1721,6578,4444,2134,4903,2841,2062,2118,333,68,2384
7/1/2019,VA,Virginia,Pittsylvania,51143,16505,11833,4672,13646,93,13553,2859,75,2784,15532,10860,4672,12989,9516,3473,3091,527,184,9187
7/1/2019,VA,Virginia,Poquoson City,51735,2621,2285,336,2439,*,*,182,*,*,2412,2077,335,1250,961,289,119,25,12,1094
7/1/2019,VA,Virginia,Portsmouth City,51740,18432,13253,5179,14490,190,14300,3942,208,3734,16498,11324,5174,11147,6240,4907,4068,678,147,6254
7/1/2019,VA,Virginia,Powhatan,51145,6227,4866,1361,5627,20,5607,600,19,581,5707,4346,1361,4614,3459,1155,414,112,28,4060
7/1/2019,VA,Virginia,Prince Edward,51147,4683,3855,828,3813,44,3769,870,29,841,4343,3515,828,3383,2768,615,1074,143,51,2115
7/1/2019,VA,Virginia,Prince George,51149,6177,5275,902,5242,32,5210,935,34,901,5719,4818,901,3514,2717,797,589,122,28,2775
7/1/2019,VA,Virginia,Prince William,51153,50034,39896,10138,44959,307,44652,5075,292,4783,42686,32559,10127,25095,16141,8954,5337,1051,224,18483
7/1/2019,VA,Virginia,Pulaski,51155,9204,7218,1986,7417,32,7385,1787,32,1755,8574,6589,1985,7086,5364,1722,1622,281,106,5077
7/1/2019,VA,Virginia,Radford City,51750,2049,1620,429,1673,*,*,376,*,*,1864,1435,429,1590,1205,385,342,40,22,1186
7/1/2019,VA,Virginia,Rappahannock,51157,1947,1753,194,1820,*,*,127,*,*,1754,1561,193,1208,1073,135,146,*,*,1019
7/1/2019,VA,Virginia,Richmond,51159,1960,1568,392,1717,*,*,243,14,229,1823,1432,391,1362,1110,252,310,61,14,977
7/1/2019,VA,Virginia,Richmond City,51760,34741,22673,12068,27933,284,27649,6808,323,6485,31235,19179,12056,26583,15161,11422,8987,1306,282,16008
7/1/2019,VA,Virginia,Roanoke,51161,23723,17792,5931,21131,102,21029,2592,63,2529,21915,15987,5928,17845,12814,5031,2162,422,136,15125
7/1/2019,VA,Virginia,Roanoke City,51770,21273,14746,6527,16357,151,16206,4916,145,4771,19351,12830,6521,15908,9917,5991,4921,853,216,9918
7/1/2019,VA,Virginia,Rockbridge,51163,6356,5287,1069,5474,12,5462,882,*,*,5901,4832,1069,4463,3578,885,863,180,54,3366
7/1/2019,VA,Virginia,Rockingham,51165,17975,15329,2646,15851,45,15806,2124,42,2082,16609,13964,2645,13078,11209,1869,1878,484,139,10577
7/1/2019,VA,Virginia,Russell,51167,7991,4736,3255,5629,14,5615,2362,22,2340,7652,4400,3252,6568,3913,2655,1697,326,149,4396
7/1/2019,VA,Virginia,Salem City,51775,6069,4716,1353,5145,30,5115,924,17,907,5604,4251,1353,4544,3341,1203,854,128,37,3525
7/1/2019,VA,Virginia,Scott,51169,6785,3105,3680,5200,13,5187,1585,17,1568,6517,2840,3677,5693,2155,3538,1550,238,103,3802
7/1/2019,VA,Virginia,Shenandoah,51171,10672,9028,1644,9510,39,9471,1162,25,1137,9984,8340,1644,7173,5862,1311,1273,263,89,5548
7/1/2019,VA,Virginia,Smyth,51173,8641,6042,2599,6548,35,6513,2093,27,2066,8214,5615,2599,6806,4424,2382,2101,373,122,4210
7/1/2019,VA,Virginia,Southampton,51175,3990,3272,718,3356,33,3323,634,26,608,3699,2981,718,2928,2302,626,725,110,34,2059
7/1/2019,VA,Virginia,Spotsylvania,51177,21638,18600,3038,18976,115,18861,2662,101,2561,19251,16215,3036,11719,9312,2407,2070,508,133,9008
7/1/2019,VA,Virginia,Stafford,51179,18103,15959,2144,16047,106,15941,2056,87,1969,15883,13743,2140,8139,6422,1717,1486,360,85,6208
7/1/2019,VA,Virginia,Staunton City,51790,6287,5311,976,5282,24,5258,1005,15,990,5907,4931,976,4680,3874,806,1110,154,51,3365
7/1/2019,VA,Virginia,Suffolk City,51800,16803,12888,3915,13899,120,13779,2904,114,2790,15376,11463,3913,10599,7044,3555,2821,454,114,7210
7/1/2019,VA,Virginia,Surry,51181,1726,1332,394,1488,*,*,238,*,*,1582,1188,394,1168,805,363,222,60,13,873
7/1/2019,VA,Virginia,Sussex,51183,2526,1893,633,2082,36,2046,444,*,*,2359,1726,633,1829,1234,595,542,141,21,1125
7/1/2019,VA,Virginia,Tazewell,51185,11997,7817,4180,8956,36,8920,3041,38,3003,11389,7210,4179,9130,6156,2974,2291,463,165,6211
7/1/2019,VA,Virginia,Unknown,51999,*,*,*,*,*,*,*,*,*,*,*,*,*,*,*,*,*,*,*
7/1/2019,VA,Virginia,Virginia Beach City,51810,73613,59157,14456,65290,410,64880,8323,347,7976,67407,52967,14440,39398,26391,13007,7085,1483,397,30433
7/1/2019,VA,Virginia,Warren,51187,7824,6774,1050,6778,27,6751,1046,33,1013,7125,6076,1049,4894,4068,826,950,213,71,3660
7/1/2019,VA,Virginia,Washington,51191,15013,9296,5717,12260,45,12215,2753,34,2719,14159,8444,5715,11781,6567,5214,2434,523,198,8626
7/1/2019,VA,Virginia,Waynesboro City,51820,4987,4179,808,4138,18,4120,849,23,826,4652,3844,808,3701,2991,710,932,112,45,2612
7/1/2019,VA,Virginia,Westmoreland,51193,5073,4392,681,4468,23,4445,605,16,589,4607,3926,681,2986,2435,551,766,137,44,2039
7/1/2019,VA,Virginia,Williamsburg City,51830,2746,2263,483,2526,*,*,220,*,*,2538,2055,483,1812,1421,391,253,*,*,1522
7/1/2019,VA,Virginia,Winchester City,51840,5520,4715,805,4765,29,4736,755,21,734,5017,4212,805,3668,3015,653,887,136,43,2602
7/1/2019,VA,Virginia,Wise,51195,10672,5858,4814,7309,25,7284,3363,27,3336,10089,5276,4813,8189,3912,4277,2474,463,183,5069
7/1/2019,VA,Virginia,Wythe,51197,7951,5852,2099,6277,37,6240,1674,18,1656,7519,5421,2098,6135,4311,1824,1674,279,112,4070
7/1/2019,VA,Virginia,York,51199,12208,10427,1781,11229,41,11188,979,34,945,11167,9387,1780,6076,4562,1514,706,153,35,5182
6/1/2019,VA,Virginia,Accomack,51001,8953,7387,1566,7781,52,7729,1172,41,1131,8281,6716,1565,6140,4912,1228,1500,365,90,4185
6/1/2019,VA,Virginia,Albemarle,51003,21287,18729,2558,19757,70,19687,1530,43,1487,19135,16581,2554,14799,12675,2124,1569,296,93,12841
6/1/2019,VA,Virginia,Alexandria City,51510,18097,15064,3033,16745,78,16667,1352,82,1270,14511,11481,3030,8965,6275,2690,2133,284,66,6482
6/1/2019,VA,Virginia,Alleghany,51005,4558,3800,758,3718,20,3698,840,13,827,4332,3574,758,3505,2896,609,816,102,50,2537
6/1/2019,VA,Virginia,Amelia,51007,3099,2290,809,2647,*,*,452,16,436,2859,2050,809,2297,1550,747,465,98,37,1697
6/1/2019,VA,Virginia,Amherst,51009,7875,6255,1620,6589,50,6539,1286,30,1256,7311,5691,1620,5957,4521,1436,1233,215,72,4437
6/1/2019,VA,Virginia,Appomattox,51011,3950,3181,769,3264,18,3246,686,22,664,3705,2936,769,3017,2334,683,689,93,42,2193
6/1/2019,VA,Virginia,Arlington,51013,24730,21043,3687,23156,101,23055,1574,86,1488,19345,15662,3683,11851,8552,3299,2953,359,108,8431
6/1/2019,VA,Virginia,Augusta,51015,18468,15615,2853,16078,58,16020,2390,50,2340,17275,14423,2852,13453,11080,2373,1869,382,142,11060
6/1/2019,VA,Virginia,Bath,51017,1272,1155,117,1119,*,*,153,*,*,1207,1090,117,940,843,97,150,34,18,738
6/1/2019,VA,Virginia,Bedford,51019,19862,16039,3823,17171,88,17083,2691,49,2642,18477,14657,3820,14579,11816,2763,2026,466,152,11935
6/1/2019,VA,Virginia,Bland,51021,1792,1338,454,1430,*,*,362,*,*,1685,1231,454,1321,1002,319,235,53,17,1016
6/1/2019,VA,Virginia,Botetourt,51023,8752,6580,2172,7704,49,7655,1048,23,1025,8133,5961,2172,6462,4628,1834,725,156,52,5529
6/1/2019,VA,Virginia,Bristol City,51520,4641,2513,2128,3672,12,3660,969,17,952,4356,2229,2127,3701,1663,2038,1110,143,61,2387
6/1/2019,VA,Virginia,Brunswick,51025,4046,3170,876,3390,34,3356,656,20,636,3761,2886,875,3005,2255,750,1062,131,43,1769
6/1/2019,VA,Virginia,Buchanan,51027,7267,3994,3273,4679,19,4660,2588,22,2566,7010,3738,3272,5931,3498,2433,1652,389,110,3780
6/1/2019,VA,Virginia,Buckingham,51029,3648,3016,632,3011,19,2992,637,18,619,3417,2785,632,2633,2228,405,786,137,43,1667
6/1/2019,VA,Virginia,Buena Vista City,51530,1497,1188,309,1229,*,*,268,*,*,1402,1093,309,1104,846,258,307,52,18,727
6/1/2019,VA,Virginia,Campbell,51031,13120,10493,2627,11001,82,10919,2119,64,2055,12277,9650,2627,10034,7731,2303,2101,357,139,7437
6/1/2019,VA,Virginia,Caroline,51033,6014,4831,1183,5069,37,5032,945,35,910,5400,4217,1183,3721,2693,1028,861,201,50,2609
6/1/2019,VA,Virginia,Carroll,51035,8476,7017,1459,7050,25,7025,1426,14,1412,8017,6558,1459,6305,5158,1147,1608,256,104,4337
6/1/2019,VA,Virginia,Charles City,51036,1946,1477,469,1684,18,1666,262,14,248,1781,1312,469,1370,967,403,254,75,17,1024
6/1/2019,VA,Virginia,Charlotte,51037,3260,2651,609,2682,16,2666,578,16,562,3062,2453,609,2438,1910,528,744,124,40,1530
6/1/2019,VA,Virginia,Charlottesville City,51540,6294,5490,804,5279,28,5251,1015,40,975,5632,4829,803,4559,3836,723,1240,141,39,3139
6/1/2019,VA,Virginia,Chesapeake City,51550,38968,30128,8840,33796,302,33494,5172,224,4948,35145,26313,8832,21924,14087,7837,4301,918,209,16496
6/1/2019,VA,Virginia,Chesterfield,51041,61547,45972,15575,54217,267,53950,7330,246,7084,55408,39841,15567,43268,29413,13855,5633,1010,282,36343
6/1/2019,VA,Virginia,Clarke,51043,3339,2887,452,3081,13,3068,258,*,*,2997,2545,452,2089,1745,344,281,66,25,1717
6/1/2019,VA,Virginia,Colonial Heights City,51570,4170,3394,776,3579,11,3568,591,12,579,3813,3037,776,2519,1834,685,500,103,21,1895
6/1/2019,VA,Virginia,Covington City,51580,1594,1336,258,1227,16,1211,367,*,*,1486,1228,258,1205,972,233,331,49,15,810
6/1/2019,VA,Virginia,Craig,51045,1376,1010,366,1087,*,*,289,*,*,1274,908,366,1027,692,335,216,44,14,753
6/1/2019,VA,Virginia,Culpeper,51047,9541,8039,1502,8349,41,8308,1192,45,1147,8618,7118,1500,6081,4938,1143,1265,218,68,4530
6/1/2019,VA,Virginia,Cumberland,51049,2358,1799,559,1974,13,1961,384,*,*,2187,1628,559,1727,1241,486,438,91,33,1165
6/1/2019,VA,Virginia,Danville City,51590,11013,7824,3189,8732,85,8647,2281,120,2161,10349,7160,3189,8872,6554,2318,3227,384,150,5111
6/1/2019,VA,Virginia,Dickenson,51051,4898,2611,2287,3198,*,*,1700,*,*,4689,2403,2286,3932,1887,2045,1164,194,78,2496
6/1/2019,VA,Virginia,Dinwiddie,51053,6075,4698,1377,4960,39,4921,1115,30,1085,5587,4210,1377,4191,2904,1287,967,180,49,2995
6/1/2019,VA,Virginia,Emporia City,51595,1333,958,375,1050,22,1028,283,12,271,1250,875,375,1013,705,308,458,*,*,481
6/1/2019,VA,Virginia,Essex,51057,2999,2353,646,2582,17,2565,417,15,402,2760,2114,646,2108,1608,500,457,91,36,1524
6/1/2019,VA,Virginia,Fairfax,51059,153075,124949,28126,144934,628,144306,8141,465,7676,122925,94839,28086,74196,50341,23855,14247,2571,563,56815
6/1/2019,VA,Virginia,Fairfax City,51600,3870,3126,744,3613,15,3598,257,14,243,3236,2493,743,2036,1442,594,382,69,18,1567
6/1/2019,VA,Virginia,Falls Church City,51610,2073,1727,346,1992,*,*,81,0,81,1606,1262,344,1020,725,295,122,*,*,882
6/1/2019,VA,Virginia,Fauquier,51061,12776,11265,1511,11693,70,11623,1083,41,1042,11314,9803,1511,7401,6310,1091,1007,182,54,6158
6/1/2019,VA,Virginia,Floyd,51063,4161,3269,892,3613,18,3595,548,*,*,3879,2987,892,3136,2314,822,603,106,49,2378
6/1/2019,VA,Virginia,Fluvanna,51065,6095,5228,867,5474,24,5450,621,20,601,5534,4667,867,4104,3420,684,585,104,24,3391
6/1/2019,VA,Virginia,Franklin,51067,15044,10702,4342,12707,58,12649,2337,35,2302,14120,9780,4340,11599,7729,3870,2066,457,154,8922
6/1/2019,VA,Virginia,Franklin City,51620,2157,1779,378,1744,19,1725,413,20,393,2009,1631,378,1633,1291,342,537,61,17,1018
6/1/2019,VA,Virginia,Frederick,51069,16899,14362,2537,15140,65,15075,1759,49,1710,15358,12825,2533,10707,8726,1981,1449,356,117,8785
6/1/2019,VA,Virginia,Fredericksburg City,51630,4154,3560,594,3436,27,3409,718,24,694,3694,3100,594,2586,2069,517,839,80,39,1628
6/1/2019,VA,Virginia,Galax City,51640,1767,1560,207,1427,*,*,340,*,*,1670,1463,207,1371,1207,164,587,50,23,711
6/1/2019,VA,Virginia,Giles,51071,4628,3551,1077,3706,22,3684,922,15,907,4364,3287,1077,3634,2986,648,832,119,33,2650
6/1/2019,VA,Virginia,Gloucester,51073,8703,7141,1562,7561,40,7521,1142,23,1119,8031,6471,1560,5247,3910,1337,1007,172,49,4019
6/1/2019,VA,Virginia,Goochland,51075,5923,4635,1288,5457,26,5431,466,16,450,5416,4129,1287,4480,3433,1047,402,95,27,3956
6/1/2019,VA,Virginia,Grayson,51077,4564,3635,929,3783,15,3768,781,12,769,4358,3429,929,3354,2537,817,940,170,82,2162
6/1/2019,VA,Virginia,Greene,51079,4007,3438,569,3518,15,3503,489,11,478,3622,3053,569,2680,2187,493,474,81,28,2097
6/1/2019,VA,Virginia,Greensville,51081,2111,1519,592,1709,21,1688,402,15,387,1960,1368,592,1588,1135,453,448,104,24,1012
6/1/2019,VA,Virginia,Halifax,51083,9841,8115,1726,8164,71,8093,1677,50,1627,9211,7485,1726,7446,5936,1510,2167,410,141,4728
6/1/2019,VA,Virginia,Hampton City,51650,25389,18345,7044,21044,217,20827,4345,214,4131,23078,16034,7044,14469,7885,6584,3920,744,175,9630
6/1/2019,VA,Virginia,Hanover,51085,21573,16188,5385,19710,100,19610,1863,55,1808,19591,14207,5384,15955,11535,4420,1522,321,94,14018
6/1/2019,VA,Virginia,Harrisonburg City,51660,5525,4827,698,4700,24,4676,825,25,800,5008,4310,698,4021,3507,514,1016,118,41,2846
6/1/2019,VA,Virginia,Henrico,51087,57434,41366,16068,50617,344,50273,6817,295,6522,51786,35734,16052,42484,28482,14002,6620,1325,378,34161
6/1/2019,VA,Virginia,Henry,51089,14846,10304,4542,11899,77,11822,2947,68,2879,14102,9562,4540,12109,7900,4209,3023,702,230,8154
6/1/2019,VA,Virginia,Highland,51091,799,718,81,727,*,*,72,*,*,749,668,81,559,495,64,58,*,*,475
6/1/2019,VA,Virginia,Hopewell City,51670,4543,3436,1107,3541,35,3506,1002,35,967,4195,3088,1107,2973,1918,1055,1022,144,36,1771
6/1/2019,VA,Virginia,Isle of Wight,51093,8417,6559,1858,7459,55,7404,958,38,920,7762,5904,1858,5515,3831,1684,1002,186,70,4257
6/1/2019,VA,Virginia,James City,51095,21047,17892,3155,19822,58,19764,1225,53,1172,19416,16264,3152,12577,10254,2323,925,223,59,11370
6/1/2019,VA,Virginia,King and Queen,51097,1797,1455,342,1525,12,1513,272,*,*,1666,1324,342,1267,971,296,284,*,*,908
6/1/2019,VA,Virginia,King George,51099,3996,3576,420,3474,14,3460,522,27,495,3462,3042,420,1745,1398,347,461,64,17,1203
6/1/2019,VA,Virginia,King William,51101,3482,2859,623,2987,23,2964,495,25,470,3189,2566,623,2582,2052,530,411,107,24,2040
6/1/2019,VA,Virginia,Lancaster,51103,4380,3731,649,4047,21,4026,333,18,315,4146,3498,648,3052,2635,417,511,96,14,2431
6/1/2019,VA,Virginia,Lee,51105,6431,3409,3022,4515,14,4501,1916,15,1901,6110,3090,3020,5022,2275,2747,1957,238,82,2745
6/1/2019,VA,Virginia,Lexington City,51678,1386,1226,160,1272,11,1261,114,*,*,1265,1106,159,982,854,128,184,33,13,752
6/1/2019,VA,Virginia,Loudoun,51107,39071,31887,7184,36654,181,36473,2417,120,2297,32308,25132,7176,21843,15756,6087,3361,620,138,17724
6/1/2019,VA,Virginia,Louisa,51109,8368,6712,1656,7105,47,7058,1263,37,1226,7649,5993,1656,5720,4302,1418,1102,240,65,4313
6/1/2019,VA,Virginia,Lunenburg,51111,3117,2613,504,2581,18,2563,536,15,521,2869,2365,504,2203,1759,444,736,108,37,1322
6/1/2019,VA,Virginia,Lynchburg City,51680,14615,11722,2893,12044,94,11950,2571,105,2466,13521,10631,2890,11071,8519,2552,2985,449,135,7502
6/1/2019,VA,Virginia,Madison,51113,3271,2769,502,2923,14,2909,348,14,334,3037,2535,502,2261,1877,384,427,86,20,1728
6/1/2019,VA,Virginia,Manassas City,51683,4627,3687,940,4117,24,4093,510,43,467,3861,2921,940,2713,1908,805,547,84,31,2051
6/1/2019,VA,Virginia,Manassas Park City,51685,1320,997,323,1147,16,1131,173,14,159,1098,775,323,781,488,293,198,*,*,525
6/1/2019,VA,Virginia,Martinsville City,51690,3852,2743,1109,2910,37,2873,942,38,904,3645,2537,1108,3140,2081,1059,1297,161,55,1627
6/1/2019,VA,Virginia,Mathews,51115,2874,2383,491,2636,*,*,238,*,*,2711,2220,491,1917,1520,397,283,34,19,1581
6/1/2019,VA,Virginia,Mecklenburg,51117,9235,7284,1951,7750,58,7692,1485,66,1419,8648,6698,1950,6865,5247,1618,1820,349,91,4605
6/1/2019,VA,Virginia,Middlesex,51119,3604,3002,602,3251,15,3236,353,*,*,3393,2791,602,2606,2153,453,456,75,29,2046
6/1/2019,VA,Virginia,Montgomery,51121,14148,11332,2816,11874,54,11820,2274,31,2243,12754,9939,2815,10676,8174,2502,1946,345,124,8261
6/1/2019,VA,Virginia,Nelson,51125,4660,3930,730,4173,16,4157,487,12,475,4292,3563,729,3189,2576,613,566,103,40,2480
6/1/2019,VA,Virginia,New Kent,51127,4660,3767,893,4200,18,4182,460,11,449,4230,3338,892,3017,2333,684,303,76,20,2618
6/1/2019,VA,Virginia,Newport News City,51700,28584,20506,8078,23677,217,23460,4907,243,4664,26106,18032,8074,17369,9750,7619,4978,872,207,11312
6/1/2019,VA,Virginia,Norfolk City,51710,33403,24098,9305,27029,293,26736,6374,332,6042,29960,20659,9301,20531,11718,8813,7353,1276,281,11621
6/1/2019,VA,Virginia,Northampton,51131,3738,2993,745,3254,26,3228,484,19,465,3474,2730,744,2799,2172,627,914,86,26,1773
6/1/2019,VA,Virginia,Northumberland,51133,4648,3932,716,4318,15,4303,330,14,316,4345,3629,716,2934,2515,419,427,75,28,2404
6/1/2019,VA,Virginia,Norton City,51720,1158,693,465,798,*,*,360,*,*,1078,613,465,893,474,419,350,42,12,489
6/1/2019,VA,Virginia,Nottoway,51135,3635,2963,672,2999,27,2972,636,14,622,3359,2688,671,2625,2125,500,869,119,43,1594
6/1/2019,VA,Virginia,Orange,51137,8759,7507,1252,7765,54,7711,994,30,964,7972,6721,1251,5382,4536,846,974,181,62,4165
6/1/2019,VA,Virginia,Page,51139,6208,5275,933,5152,25,5127,1056,24,1032,5799,4866,933,4281,3501,780,1085,228,80,2888
6/1/2019,VA,Virginia,Patrick,51141,5475,4127,1348,4578,*,*,897,12,885,5184,3838,1346,4251,3142,1109,1089,187,74,2901
6/1/2019,VA,Virginia,Petersburg City,51730,7178,5058,2120,5383,87,5296,1795,77,1718,6554,4435,2119,4896,2851,2045,2110,337,67,2382
6/1/2019,VA,Virginia,Pittsylvania,51143,16469,11823,4646,13619,94,13525,2850,75,2775,15490,10844,4646,12956,9508,3448,3076,529,186,9165
6/1/2019,VA,Virginia,Poquoson City,51735,2616,2285,331,2433,*,*,183,*,*,2401,2071,330,1244,960,284,119,25,12,1088
6/1/2019,VA,Virginia,Portsmouth City,51740,18368,13253,5115,14443,192,14251,3925,205,3720,16367,11257,5110,11101,6257,4844,4018,681,148,6254
6/1/2019,VA,Virginia,Powhatan,51145,6201,4838,1363,5604,21,5583,597,19,578,5685,4322,1363,4589,3431,1158,412,110,28,4039
6/1/2019,VA,Virginia,Prince Edward,51147,4674,3851,823,3807,45,3762,867,29,838,4328,3505,823,3372,2763,609,1061,147,53,2111
6/1/2019,VA,Virginia,Prince George,51149,6154,5254,900,5228,34,5194,926,33,893,5686,4787,899,3497,2705,792,582,120,28,2767
6/1/2019,VA,Virginia,Prince William,51153,49809,39768,10041,44756,307,44449,5053,291,4762,42241,32211,10030,24948,16090,8858,5302,1047,222,18377
6/1/2019,VA,Virginia,Pulaski,51155,9193,7221,1972,7413,32,7381,1780,32,1748,8548,6577,1971,7074,5367,1707,1607,286,106,5075
6/1/2019,VA,Virginia,Radford City,51750,2045,1620,425,1669,*,*,376,*,*,1856,1431,425,1590,1209,381,342,40,23,1185
6/1/2019,VA,Virginia,Rappahannock,51157,1945,1755,190,1820,*,*,125,*,*,1744,1555,189,1202,1069,133,140,*,*,1019
6/1/2019,VA,Virginia,Richmond,51159,1962,1569,393,1723,*,*,239,14,225,1815,1423,392,1363,1112,251,309,61,14,979
6/1/2019,VA,Virginia,Richmond City,51760,34672,22688,11984,27896,288,27608,6776,322,6454,31072,19099,11973,26496,15160,11336,8897,1323,282,15994
6/1/2019,VA,Virginia,Roanoke,51161,23688,17790,5898,21104,102,21002,2584,64,2520,21826,15931,5895,17806,12806,5000,2150,432,138,15086
6/1/2019,VA,Virginia,Roanoke City,51770,21223,14743,6480,16322,153,16169,4901,144,4757,19252,12777,6475,15860,9918,5942,4891,852,210,9907
6/1/2019,VA,Virginia,Rockbridge,51163,6350,5296,1054,5476,12,5464,874,*,*,5879,4825,1054,4451,3579,872,851,180,55,3365
6/1/2019,VA,Virginia,Rockingham,51165,17927,15293,2634,15807,45,15762,2120,43,2077,16547,13914,2633,13031,11175,1856,1862,484,135,10550
6/1/2019,VA,Virginia,Russell,51167,7985,4741,3244,5630,14,5616,2355,22,2333,7643,4402,3241,6553,3912,2641,1674,327,147,4405
6/1/2019,VA,Virginia,Salem City,51775,6064,4713,1351,5142,31,5111,922,17,905,5595,4244,1351,4545,3346,1199,849,130,37,3529
6/1/2019,VA,Virginia,Scott,51169,6780,3102,3678,5200,13,5187,1580,16,1564,6506,2831,3675,5696,2162,3534,1549,240,103,3804
6/1/2019,VA,Virginia,Shenandoah,51171,10661,9030,1631,9503,41,9462,1158,25,1133,9958,8327,1631,7162,5864,1298,1263,268,91,5540
6/1/2019,VA,Virginia,Smyth,51173,8638,6068,2570,6550,35,6515,2088,28,2060,8192,5622,2570,6790,4438,2352,2079,382,120,4209
6/1/2019,VA,Virginia,Southampton,51175,3988,3274,714,3356,34,3322,632,26,606,3688,2974,714,2923,2300,623,717,110,34,2062
6/1/2019,VA,Virginia,Spotsylvania,51177,21565,18533,3032,18913,116,18797,2652,102,2550,19107,16076,3031,11688,9285,2403,2044,517,133,8994
6/1/2019,VA,Virginia,Stafford,51179,18032,15893,2139,15985,107,15878,2047,85,1962,15759,13624,2135,8099,6388,1711,1474,359,86,6180
6/1/2019,VA,Virginia,Staunton City,51790,6283,5309,974,5283,24,5259,1000,17,983,5897,4923,974,4675,3873,802,1105,149,52,3369
6/1/2019,VA,Virginia,Suffolk City,51800,16750,12875,3875,13857,122,13735,2893,114,2779,15278,11406,3872,10573,7056,3517,2813,456,114,7190
6/1/2019,VA,Virginia,Surry,51181,1719,1330,389,1484,*,*,235,*,*,1570,1181,389,1157,799,358,218,59,13,867
6/1/2019,VA,Virginia,Sussex,51183,2529,1907,622,2089,37,2052,440,*,*,2356,1734,622,1828,1245,583,538,142,21,1127
6/1/2019,VA,Virginia,Tazewell,51185,11988,7811,4177,8952,36,8916,3036,39,2997,11355,7179,4176,9124,6157,2967,2279,464,167,6214
6/1/2019,VA,Virginia,Unknown,51999,*,*,*,*,*,*,*,*,*,*,*,*,*,*,*,*,*,*,*
6/1/2019,VA,Virginia,Virginia Beach City,51810,73325,58991,14334,65045,415,64630,8280,345,7935,66948,52630,14318,39193,26313,12880,7038,1478,393,30284
6/1/2019,VA,Virginia,Warren,51187,7807,6764,1043,6763,28,6735,1044,33,1011,7090,6048,1042,4875,4055,820,943,212,72,3648
6/1/2019,VA,Virginia,Washington,51191,15000,9298,5702,12265,47,12218,2735,34,2701,14130,8430,5700,11757,6563,5194,2408,525,195,8629
6/1/2019,VA,Virginia,Waynesboro City,51820,4967,4171,796,4122,18,4104,845,23,822,4629,3833,796,3683,2987,696,921,114,46,2602
6/1/2019,VA,Virginia,Westmoreland,51193,5066,4393,673,4462,23,4439,604,15,589,4596,3923,673,2990,2442,548,772,139,44,2035
6/1/2019,VA,Virginia,Williamsburg City,51830,2742,2263,479,2523,*,*,219,11,208,2522,2043,479,1807,1419,388,250,*,*,1520
6/1/2019,VA,Virginia,Winchester City,51840,5512,4717,795,4758,29,4729,754,21,733,4998,4203,795,3650,3005,645,876,135,42,2597
6/1/2019,VA,Virginia,Wise,51195,10661,5865,4796,7305,26,7279,3356,27,3329,10070,5275,4795,8174,3917,4257,2461,465,184,5064
6/1/2019,VA,Virginia,Wythe,51197,7947,5866,2081,6275,37,6238,1672,19,1653,7510,5430,2080,6128,4321,1807,1664,285,109,4070
6/1/2019,VA,Virginia,York,51199,12179,10407,1772,11203,41,11162,976,35,941,11126,9355,1771,6054,4545,1509,700,152,36,5166
3/1/2019,VA,Virginia,Accomack,51001,8909,7346,1563,7756,56,7700,1153,44,1109,8257,6695,1562,6137,4914,1223,1481,378,89,4189
3/1/2019,VA,Virginia,Albemarle,51003,21187,18658,2529,19664,72,19592,1523,43,1480,19027,16502,2525,14712,12619,2093,1529,312,95,12776
3/1/2019,VA,Virginia,Alexandria City,51510,17919,14938,2981,16582,80,16502,1337,82,1255,14427,11448,2979,8917,6280,2637,2091,295,68,6463
3/1/2019,VA,Virginia,Alleghany,51005,4546,3801,745,3720,21,3699,826,13,813,4329,3584,745,3508,2912,596,798,107,51,2552
3/1/2019,VA,Virginia,Amelia,51007,3085,2292,793,2640,*,*,445,16,429,2841,2048,793,2294,1563,731,462,99,37,1696
3/1/2019,VA,Virginia,Amherst,51009,7850,6274,1576,6584,54,6530,1266,30,1236,7300,5724,1576,5936,4546,1390,1216,222,74,4424
3/1/2019,VA,Virginia,Appomattox,51011,3938,3195,743,3259,20,3239,679,23,656,3703,2960,743,3015,2358,657,680,107,43,2185
3/1/2019,VA,Virginia,Arlington,51013,24485,20873,3612,22928,109,22819,1557,87,1470,19218,15610,3608,11804,8576,3228,2913,369,117,8405
3/1/2019,VA,Virginia,Augusta,51015,18397,15577,2820,16035,60,15975,2362,51,2311,17228,14408,2820,13418,11083,2335,1829,396,147,11046
3/1/2019,VA,Virginia,Bath,51017,1269,1154,115,1118,*,*,151,*,*,1201,1086,115,941,844,97,146,36,20,739
3/1/2019,VA,Virginia,Bedford,51019,19738,15970,3768,17070,95,16975,2668,49,2619,18373,14607,3766,14519,11812,2707,1988,483,157,11891
3/1/2019,VA,Virginia,Bland,51021,1774,1334,440,1420,*,*,354,*,*,1673,1233,440,1312,1003,309,233,53,18,1008
3/1/2019,VA,Virginia,Botetourt,51023,8707,6549,2158,7677,51,7626,1030,21,1009,8094,5936,2158,6432,4620,1812,700,166,57,5509
3/1/2019,VA,Virginia,Bristol City,51520,4645,2523,2122,3689,13,3676,956,17,939,4363,2242,2121,3715,1684,2031,1087,149,61,2418
3/1/2019,VA,Virginia,Brunswick,51025,4032,3188,844,3387,33,3354,645,21,624,3751,2908,843,3003,2282,721,1037,129,45,1792
3/1/2019,VA,Virginia,Buchanan,51027,7273,4021,3252,4706,21,4685,2567,22,2545,7013,3761,3252,5932,3527,2405,1629,401,113,3789
3/1/2019,VA,Virginia,Buckingham,51029,3638,3029,609,3008,19,2989,630,19,611,3399,2790,609,2611,2232,379,769,146,50,1646
3/1/2019,VA,Virginia,Buena Vista City,51530,1500,1199,301,1237,*,*,263,*,*,1407,1106,301,1108,859,249,301,54,18,735
3/1/2019,VA,Virginia,Campbell,51031,13075,10507,2568,10990,85,10905,2085,63,2022,12243,9675,2568,10011,7770,2241,2077,367,139,7428
3/1/2019,VA,Virginia,Caroline,51033,5983,4803,1180,5041,37,5004,942,34,908,5383,4203,1180,3725,2701,1024,844,213,51,2617
3/1/2019,VA,Virginia,Carroll,51035,8464,7023,1441,7034,28,7006,1430,13,1417,7997,6556,1441,6277,5153,1124,1583,270,104,4320
3/1/2019,VA,Virginia,Charles City,51036,1947,1483,464,1685,20,1665,262,14,248,1787,1323,464,1379,983,396,255,78,16,1030
3/1/2019,VA,Virginia,Charlotte,51037,3263,2672,591,2688,17,2671,575,17,558,3069,2478,591,2444,1932,512,735,129,40,1540
3/1/2019,VA,Virginia,Charlottesville City,51540,6233,5449,784,5225,28,5197,1008,41,967,5577,4794,783,4520,3814,706,1221,148,45,3106
3/1/2019,VA,Virginia,Chesapeake City,51550,38687,29937,8750,33586,323,33263,5101,221,4880,34961,26219,8742,21862,14125,7737,4199,938,231,16494
3/1/2019,VA,Virginia,Chesterfield,51041,61046,45604,15442,53789,280,53509,7257,253,7004,55028,39594,15434,43013,29302,13711,5505,1046,288,36174
3/1/2019,VA,Virginia,Clarke,51043,3323,2874,449,3073,14,3059,250,*,*,2989,2540,449,2082,1738,344,272,71,24,1715
3/1/2019,VA,Virginia,Colonial Heights City,51570,4158,3398,760,3567,12,3555,591,12,579,3803,3043,760,2521,1851,670,495,109,22,1895
3/1/2019,VA,Virginia,Covington City,51580,1586,1338,248,1228,16,1212,358,*,*,1483,1235,248,1215,990,225,326,51,17,821
3/1/2019,VA,Virginia,Craig,51045,1373,1014,359,1090,*,*,283,*,*,1266,907,359,1026,698,328,212,42,13,759
3/1/2019,VA,Virginia,Culpeper,51047,9479,8006,1473,8304,44,8260,1175,48,1127,8554,7083,1471,6050,4934,1116,1241,230,71,4508
3/1/2019,VA,Virginia,Cumberland,51049,2356,1801,555,1973,14,1959,383,*,*,2190,1635,555,1728,1245,483,428,94,34,1172
3/1/2019,VA,Virginia,Danville City,51590,11027,7924,3103,8765,91,8674,2262,115,2147,10378,7275,3103,8911,6685,2226,3207,404,162,5138
3/1/2019,VA,Virginia,Dickenson,51051,4897,2629,2268,3213,*,*,1684,*,*,4685,2418,2267,3935,1908,2027,1144,202,83,2506
3/1/2019,VA,Virginia,Dinwiddie,51053,6053,4698,1355,4945,41,4904,1108,30,1078,5575,4220,1355,4155,2892,1263,949,191,52,2963
3/1/2019,VA,Virginia,Emporia City,51595,1325,962,363,1040,22,1018,285,12,273,1240,877,363,1015,719,296,455,*,*,482
3/1/2019,VA,Virginia,Essex,51057,2979,2354,625,2564,19,2545,415,15,400,2756,2131,625,2105,1626,479,449,92,33,1531
3/1/2019,VA,Virginia,Fairfax,51059,151417,123778,27639,143389,651,142738,8028,463,7565,122119,94520,27599,73684,50310,23374,13971,2695,580,56438
3/1/2019,VA,Virginia,Fairfax City,51600,3874,3133,741,3617,15,3602,257,13,244,3243,2503,740,2029,1442,587,379,67,19,1564
3/1/2019,VA,Virginia,Falls Church City,51610,2055,1716,339,1974,*,*,81,0,81,1587,1250,337,1010,721,289,126,*,*,868
3/1/2019,VA,Virginia,Fauquier,51061,12690,11201,1489,11622,72,11550,1068,41,1027,11275,9786,1489,7359,6285,1074,983,193,56,6127
3/1/2019,VA,Virginia,Floyd,51063,4133,3246,887,3591,18,3573,542,*,*,3861,2974,887,3116,2302,814,591,105,49,2371
3/1/2019,VA,Virginia,Fluvanna,51065,6049,5202,847,5437,24,5413,612,18,594,5502,4655,847,4094,3428,666,571,110,25,3388
3/1/2019,VA,Virginia,Franklin,51067,14996,10688,4308,12680,61,12619,2316,34,2282,14079,9773,4306,11583,7745,3838,2021,482,162,8918
3/1/2019,VA,Virginia,Franklin City,51620,2157,1795,362,1752,20,1732,405,20,385,2009,1647,362,1641,1315,326,538,62,18,1023
3/1/2019,VA,Virginia,Frederick,51069,16776,14286,2490,15038,68,14970,1738,50,1688,15252,12766,2486,10654,8725,1929,1410,364,121,8759
3/1/2019,VA,Virginia,Fredericksburg City,51630,4136,3545,591,3428,26,3402,708,25,683,3692,3101,591,2599,2085,514,821,92,40,1646
3/1/2019,VA,Virginia,Galax City,51640,1766,1553,213,1429,*,*,337,*,*,1673,1460,213,1374,1205,169,583,52,24,715
3/1/2019,VA,Virginia,Giles,51071,4621,3546,1075,3703,23,3680,918,14,904,4364,3289,1075,3644,3002,642,820,124,35,2665
3/1/2019,VA,Virginia,Gloucester,51073,8651,7111,1540,7518,42,7476,1133,22,1111,7969,6431,1538,5221,3908,1313,997,180,49,3995
3/1/2019,VA,Virginia,Goochland,51075,5885,4596,1289,5416,27,5389,469,16,453,5368,4080,1288,4445,3399,1046,390,101,29,3925
3/1/2019,VA,Virginia,Grayson,51077,4561,3651,910,3787,15,3772,774,12,762,4348,3438,910,3362,2566,796,940,178,84,2160
3/1/2019,VA,Virginia,Greene,51079,3983,3427,556,3508,16,3492,475,*,*,3612,3056,556,2675,2195,480,471,90,28,2086
3/1/2019,VA,Virginia,Greensville,51081,2107,1512,595,1711,21,1690,396,14,382,1965,1370,595,1600,1150,450,444,102,27,1027
3/1/2019,VA,Virginia,Halifax,51083,9819,8134,1685,8152,72,8080,1667,48,1619,9220,7535,1685,7465,5998,1467,2126,428,150,4761
3/1/2019,VA,Virginia,Hampton City,51650,25235,18340,6895,20938,227,20711,4297,210,4087,22986,16091,6895,14408,7974,6434,3819,779,183,9627
3/1/2019,VA,Virginia,Hanover,51085,21343,15989,5354,19510,104,19406,1833,53,1780,19440,14087,5353,15842,11458,4384,1478,338,95,13931
3/1/2019,VA,Virginia,Harrisonburg City,51660,5504,4811,693,4687,24,4663,817,24,793,4994,4301,693,4034,3530,504,1009,127,40,2858
3/1/2019,VA,Virginia,Henrico,51087,57088,41153,15935,50381,354,50027,6707,288,6419,51575,35656,15919,42367,28518,13849,6491,1399,398,34079
3/1/2019,VA,Virginia,Henry,51089,14846,10390,4456,11919,81,11838,2927,67,2860,14113,9658,4455,12120,7997,4123,2975,733,251,8161
3/1/2019,VA,Virginia,Highland,51091,799,716,83,728,*,*,71,*,*,747,664,83,562,495,67,54,*,*,477
3/1/2019,VA,Virginia,Hopewell City,51670,4552,3468,1084,3554,38,3516,998,35,963,4206,3122,1084,2971,1940,1031,1008,142,34,1787
3/1/2019,VA,Virginia,Isle of Wight,51093,8366,6524,1842,7422,56,7366,944,38,906,7722,5880,1842,5504,3838,1666,979,193,71,4261
3/1/2019,VA,Virginia,James City,51095,20912,17771,3141,19715,63,19652,1197,51,1146,19299,16161,3138,12510,10204,2306,900,230,64,11316
3/1/2019,VA,Virginia,King and Queen,51097,1793,1460,333,1529,13,1516,264,*,*,1664,1331,333,1258,972,286,275,*,*,907
3/1/2019,VA,Virginia,King George,51099,3971,3555,416,3452,15,3437,519,28,491,3445,3029,416,1757,1414,343,462,70,17,1208
3/1/2019,VA,Virginia,King William,51101,3465,2850,615,2979,25,2954,486,23,463,3174,2559,615,2573,2051,522,405,111,24,2033
3/1/2019,VA,Virginia,Lancaster,51103,4368,3729,639,4040,21,4019,328,18,310,4138,3500,638,3049,2644,405,496,101,16,2436
3/1/2019,VA,Virginia,Lee,51105,6433,3517,2916,4539,16,4523,1894,15,1879,6108,3194,2914,5026,2304,2722,1941,250,83,2752
3/1/2019,VA,Virginia,Lexington City,51678,1398,1241,157,1283,11,1272,115,*,*,1279,1123,156,989,864,125,192,30,14,753
3/1/2019,VA,Virginia,Loudoun,51107,38632,31553,7079,36262,186,36076,2370,117,2253,32072,25002,7070,21684,15716,5968,3276,650,151,17607
3/1/2019,VA,Virginia,Louisa,51109,8315,6657,1658,7065,48,7017,1250,36,1214,7613,5955,1658,5717,4300,1417,1088,253,72,4304
3/1/2019,VA,Virginia,Lunenburg,51111,3101,2613,488,2571,20,2551,530,15,515,2860,2372,488,2200,1771,429,723,113,41,1323
3/1/2019,VA,Virginia,Lynchburg City,51680,14560,11727,2833,12022,96,11926,2538,104,2434,13478,10647,2831,11054,8565,2489,2925,465,134,7530
3/1/2019,VA,Virginia,Madison,51113,3249,2755,494,2904,15,2889,345,13,332,3020,2526,494,2245,1870,375,417,92,25,1711
3/1/2019,VA,Virginia,Manassas City,51683,4583,3657,926,4077,24,4053,506,43,463,3837,2911,926,2701,1909,792,532,92,35,2042
3/1/2019,VA,Virginia,Manassas Park City,51685,1313,996,317,1142,16,1126,171,12,159,1101,784,317,790,502,288,198,*,*,533
3/1/2019,VA,Virginia,Martinsville City,51690,3855,2791,1064,2918,44,2874,937,37,900,3650,2587,1063,3162,2149,1013,1296,168,59,1639
3/1/2019,VA,Virginia,Mathews,51115,2853,2359,494,2625,11,2614,228,*,*,2694,2200,494,1916,1514,402,267,41,20,1588
3/1/2019,VA,Virginia,Mecklenburg,51117,9218,7294,1924,7744,62,7682,1474,65,1409,8642,6718,1924,6890,5306,1584,1806,369,100,4615
3/1/2019,VA,Virginia,Middlesex,51119,3598,2994,604,3245,16,3229,353,*,*,3393,2789,604,2603,2155,448,454,77,29,2043
3/1/2019,VA,Virginia,Montgomery,51121,14084,11310,2774,11835,56,11779,2249,31,2218,12707,9934,2773,10630,8168,2462,1901,366,127,8236
3/1/2019,VA,Virginia,Nelson,51125,4638,3920,718,4159,18,4141,479,11,468,4266,3549,717,3167,2566,601,550,108,43,2466
3/1/2019,VA,Virginia,New Kent,51127,4622,3726,896,4173,22,4151,449,*,*,4202,3307,895,2993,2307,686,298,78,20,2597
3/1/2019,VA,Virginia,Newport News City,51700,28447,20480,7967,23588,226,23362,4859,239,4620,26047,18083,7964,17354,9852,7502,4830,908,220,11396
3/1/2019,VA,Virginia,Norfolk City,51710,33172,24035,9137,26881,307,26574,6291,330,5961,29820,20687,9133,20505,11866,8639,7172,1351,298,11684
3/1/2019,VA,Virginia,Northampton,51131,3719,2981,738,3238,27,3211,481,19,462,3464,2727,737,2797,2178,619,906,90,32,1769
3/1/2019,VA,Virginia,Northumberland,51133,4628,3924,704,4303,17,4286,325,15,310,4331,3627,704,2927,2519,408,421,82,28,2396
3/1/2019,VA,Virginia,Norton City,51720,1146,704,442,793,*,*,353,*,*,1065,623,442,887,482,405,342,46,14,485
3/1/2019,VA,Virginia,Nottoway,51135,3641,2994,647,3013,28,2985,628,16,612,3367,2721,646,2644,2173,471,862,127,42,1613
3/1/2019,VA,Virginia,Orange,51137,8738,7490,1248,7740,56,7684,998,33,965,7967,6720,1247,5380,4548,832,952,192,65,4171
3/1/2019,VA,Virginia,Page,51139,6204,5268,936,5158,26,5132,1046,25,1021,5799,4863,936,4295,3515,780,1080,238,84,2893
3/1/2019,VA,Virginia,Patrick,51141,5465,4125,1340,4575,*,*,890,12,878,5177,3839,1338,4258,3157,1101,1076,196,74,2912
3/1/2019,VA,Virginia,Petersburg City,51730,7151,5106,2045,5367,89,5278,1784,79,1705,6547,4503,2044,4899,2931,1968,2077,352,66,2404
3/1/2019,VA,Virginia,Pittsylvania,51143,16435,11858,4577,13615,96,13519,2820,76,2744,15463,10886,4577,12948,9574,3374,3032,542,204,9170
3/1/2019,VA,Virginia,Poquoson City,51735,2588,2256,332,2407,*,*,181,*,*,2377,2047,330,1233,950,283,116,25,11,1081
3/1/2019,VA,Virginia,Portsmouth City,51740,18301,13309,4992,14405,203,14202,3896,209,3687,16340,11352,4988,11090,6373,4717,3921,723,153,6293
3/1/2019,VA,Virginia,Powhatan,51145,6152,4789,1363,5559,23,5536,593,19,574,5653,4290,1363,4565,3409,1156,418,115,28,4004
3/1/2019,VA,Virginia,Prince Edward,51147,4657,3839,818,3798,47,3751,859,33,826,4322,3504,818,3379,2778,601,1051,158,54,2116
3/1/2019,VA,Virginia,Prince George,51149,6128,5236,892,5210,34,5176,918,34,884,5650,4758,892,3467,2688,779,566,125,29,2747
3/1/2019,VA,Virginia,Prince William,51153,49193,39369,9824,44225,318,43907,4968,294,4674,41809,31996,9813,24749,16104,8645,5177,1088,220,18264
3/1/2019,VA,Virginia,Pulaski,51155,9201,7235,1966,7444,37,7407,1757,30,1727,8552,6587,1965,7090,5391,1699,1595,293,109,5093
3/1/2019,VA,Virginia,Radford City,51750,2051,1636,415,1677,*,*,374,*,*,1868,1453,415,1588,1217,371,338,43,24,1183
3/1/2019,VA,Virginia,Rappahannock,51157,1941,1747,194,1817,*,*,124,*,*,1740,1547,193,1206,1071,135,132,*,*,1029
3/1/2019,VA,Virginia,Richmond,51159,1952,1560,392,1713,*,*,239,15,224,1812,1421,391,1360,1112,248,303,65,15,977
3/1/2019,VA,Virginia,Richmond City,51760,34505,22677,11828,27758,303,27455,6747,326,6421,31013,19195,11818,26478,15302,11176,8699,1418,307,16054
3/1/2019,VA,Virginia,Roanoke,51161,23601,17740,5861,21047,108,20939,2554,63,2491,21783,15925,5858,17775,12825,4950,2100,449,139,15087
3/1/2019,VA,Virginia,Roanoke City,51770,21134,14775,6359,16267,162,16105,4867,147,4720,19204,12851,6353,15856,10041,5815,4821,873,211,9951
3/1/2019,VA,Virginia,Rockbridge,51163,6311,5279,1032,5441,14,5427,870,*,*,5851,4819,1032,4433,3584,849,837,190,55,3351
3/1/2019,VA,Virginia,Rockingham,51165,17828,15216,2612,15747,45,15702,2081,43,2038,16469,13858,2611,12958,11123,1835,1819,496,138,10505
3/1/2019,VA,Virginia,Russell,51167,7982,4773,3209,5642,14,5628,2340,22,2318,7632,4426,3206,6562,3956,2606,1661,337,152,4412
3/1/2019,VA,Virginia,Salem City,51775,6063,4712,1351,5157,38,5119,906,17,889,5604,4253,1351,4557,3361,1196,834,132,40,3551
3/1/2019,VA,Virginia,Scott,51169,6777,3146,3631,5203,14,5189,1574,16,1558,6510,2882,3628,5709,2184,3525,1529,245,111,3824
3/1/2019,VA,Virginia,Shenandoah,51171,10594,8991,1603,9455,42,9413,1139,25,1114,9886,8283,1603,7120,5855,1265,1237,277,89,5517
3/1/2019,VA,Virginia,Smyth,51173,8658,6122,2536,6581,37,6544,2077,28,2049,8198,5662,2536,6795,4487,2308,2069,401,135,4190
3/1/2019,VA,Virginia,Southampton,51175,3951,3249,702,3328,37,3291,623,26,597,3667,2965,702,2916,2304,612,701,119,34,2062
3/1/2019,VA,Virginia,Spotsylvania,51177,21415,18417,2998,18786,124,18662,2629,107,2522,19027,16030,2997,11651,9276,2375,2010,544,141,8956
3/1/2019,VA,Virginia,Stafford,51179,17844,15726,2118,15825,111,15714,2019,86,1933,15603,13489,2114,8077,6393,1684,1443,372,92,6170
3/1/2019,VA,Virginia,Staunton City,51790,6269,5341,928,5275,25,5250,994,17,977,5885,4957,928,4691,3935,756,1086,156,55,3394
3/1/2019,VA,Virginia,Suffolk City,51800,16634,12810,3824,13776,129,13647,2858,112,2746,15187,11366,3821,10538,7075,3463,2740,475,121,7202
3/1/2019,VA,Virginia,Surry,51181,1704,1311,393,1473,*,*,231,*,*,1562,1169,393,1151,791,360,202,66,13,870
3/1/2019,VA,Virginia,Sussex,51183,2529,1925,604,2095,39,2056,434,*,*,2358,1754,604,1824,1259,565,528,146,21,1129
3/1/2019,VA,Virginia,Tazewell,51185,11974,7845,4129,8961,38,8923,3013,38,2975,11340,7212,4128,9148,6239,2909,2253,474,183,6238
3/1/2019,VA,Virginia,Unknown,51999,*,*,*,*,*,*,*,*,*,*,*,*,*,*,*,*,*,*,*
3/1/2019,VA,Virginia,Virginia Beach City,51810,72813,58648,14165,64644,430,64214,8169,351,7818,66540,52391,14149,39053,26362,12691,6894,1521,416,30222
3/1/2019,VA,Virginia,Warren,51187,7757,6724,1033,6723,30,6693,1034,33,1001,7050,6018,1032,4861,4048,813,924,228,77,3632
3/1/2019,VA,Virginia,Washington,51191,14963,9317,5646,12246,47,12199,2717,33,2684,14093,8449,5644,11725,6599,5126,2373,551,205,8596
3/1/2019,VA,Virginia,Waynesboro City,51820,4952,4176,776,4109,18,4091,843,24,819,4621,3845,776,3675,2996,679,902,121,42,2610
3/1/2019,VA,Virginia,Westmoreland,51193,5054,4379,675,4458,25,4433,596,15,581,4602,3927,675,2997,2449,548,751,143,49,2054
3/1/2019,VA,Virginia,Williamsburg City,51830,2746,2276,470,2529,*,*,217,12,205,2527,2057,470,1808,1427,381,242,*,*,1527
3/1/2019,VA,Virginia,Winchester City,51840,5493,4710,783,4749,33,4716,744,20,724,5000,4217,783,3656,3024,632,852,153,46,2605
3/1/2019,VA,Virginia,Wise,51195,10692,6107,4585,7345,26,7319,3347,27,3320,10104,5520,4584,8195,3986,4209,2448,467,190,5090
3/1/2019,VA,Virginia,Wythe,51197,7937,5868,2069,6278,39,6239,1659,19,1640,7504,5436,2068,6113,4320,1793,1636,291,108,4078
3/1/2019,VA,Virginia,York,51199,12103,10332,1771,11140,41,11099,963,34,929,11073,9303,1770,6038,4533,1505,685,154,39,5160
5/1/2019,VA,Virginia,Accomack,51001,8933,7373,1560,7766,55,7711,1167,42,1125,8267,6708,1559,6124,4901,1223,1489,363,86,4186
5/1/2019,VA,Virginia,Albemarle,51003,21245,18687,2558,19717,70,19647,1528,43,1485,19069,16515,2554,14741,12619,2122,1560,297,89,12795
5/1/2019,VA,Virginia,Alexandria City,51510,18028,15014,3014,16681,78,16603,1347,83,1264,14473,11462,3011,8928,6260,2668,2114,281,64,6469
5/1/2019,VA,Virginia,Alleghany,51005,4556,3805,751,3718,20,3698,838,13,825,4332,3581,751,3504,2902,602,813,104,50,2537
5/1/2019,VA,Virginia,Amelia,51007,3094,2295,799,2644,*,*,450,16,434,2857,2058,799,2293,1555,738,466,95,37,1695
5/1/2019,VA,Virginia,Amherst,51009,7862,6256,1606,6586,51,6535,1276,29,1247,7307,5701,1606,5948,4526,1422,1223,214,71,4440
5/1/2019,VA,Virginia,Appomattox,51011,3941,3185,756,3259,20,3239,682,22,660,3703,2947,756,3015,2345,670,691,94,40,2190
5/1/2019,VA,Virginia,Arlington,51013,24662,21002,3660,23097,104,22993,1565,88,1477,19311,15655,3656,11842,8570,3272,2944,355,108,8435
5/1/2019,VA,Virginia,Augusta,51015,18452,15602,2850,16074,59,16015,2378,51,2327,17272,14423,2849,13436,11069,2367,1857,381,140,11058
5/1/2019,VA,Virginia,Bath,51017,1267,1148,119,1116,*,*,151,*,*,1202,1083,119,940,840,100,150,34,19,737
5/1/2019,VA,Virginia,Bedford,51019,19826,16028,3798,17143,91,17052,2683,49,2634,18440,14645,3795,14545,11807,2738,2017,462,147,11919
5/1/2019,VA,Virginia,Bland,51021,1790,1339,451,1429,*,*,361,*,*,1687,1236,451,1319,1002,317,235,53,18,1013
5/1/2019,VA,Virginia,Botetourt,51023,8737,6569,2168,7695,50,7645,1042,24,1018,8122,5954,2168,6461,4631,1830,725,157,53,5526
5/1/2019,VA,Virginia,Bristol City,51520,4642,2517,2125,3679,13,3666,963,17,946,4356,2232,2124,3703,1667,2036,1103,140,58,2402
5/1/2019,VA,Virginia,Brunswick,51025,4035,3172,863,3383,34,3349,652,20,632,3756,2894,862,3000,2261,739,1051,130,42,1777
5/1/2019,VA,Virginia,Buchanan,51027,7258,3991,3267,4681,19,4662,2577,22,2555,7003,3737,3266,5912,3488,2424,1637,389,109,3777
5/1/2019,VA,Virginia,Buckingham,51029,3644,3017,627,3006,19,2987,638,18,620,3409,2782,627,2620,2221,399,782,137,42,1659
5/1/2019,VA,Virginia,Buena Vista City,51530,1498,1195,303,1232,*,*,266,*,*,1405,1102,303,1106,854,252,306,52,18,730
5/1/2019,VA,Virginia,Campbell,51031,13093,10484,2609,10992,84,10908,2101,63,2038,12254,9645,2609,10012,7727,2285,2097,358,137,7420
5/1/2019,VA,Virginia,Caroline,51033,6000,4812,1188,5058,37,5021,942,35,907,5388,4200,1188,3715,2683,1032,853,202,50,2610
5/1/2019,VA,Virginia,Carroll,51035,8476,7022,1454,7046,27,7019,1430,14,1416,8009,6555,1454,6290,5148,1142,1604,257,101,4328
5/1/2019,VA,Virginia,Charles City,51036,1946,1479,467,1682,19,1663,264,15,249,1782,1315,467,1370,970,400,256,74,16,1024
5/1/2019,VA,Virginia,Charlotte,51037,3260,2653,607,2679,17,2662,581,16,565,3066,2459,607,2441,1915,526,749,125,40,1527
5/1/2019,VA,Virginia,Charlottesville City,51540,6275,5476,799,5267,28,5239,1008,40,968,5604,4806,798,4529,3810,719,1231,139,40,3119
5/1/2019,VA,Virginia,Chesapeake City,51550,38840,30037,8803,33692,306,33386,5148,224,4924,35063,26268,8795,21867,14068,7799,4265,902,204,16496
5/1/2019,VA,Virginia,Chesterfield,51041,61402,45846,15556,54091,269,53822,7311,252,7059,55281,39733,15548,43169,29338,13831,5602,1009,277,36281
5/1/2019,VA,Virginia,Clarke,51043,3330,2876,454,3076,13,3063,254,*,*,2995,2541,454,2089,1742,347,276,69,24,1720
5/1/2019,VA,Virginia,Colonial Heights City,51570,4155,3383,772,3566,11,3555,589,12,577,3801,3029,772,2514,1833,681,497,104,20,1893
5/1/2019,VA,Virginia,Covington City,51580,1591,1340,251,1229,16,1213,362,*,*,1485,1234,251,1205,977,228,329,48,15,813
5/1/2019,VA,Virginia,Craig,51045,1373,1007,366,1086,*,*,287,*,*,1266,900,366,1022,687,335,214,41,14,753
5/1/2019,VA,Virginia,Culpeper,51047,9504,8013,1491,8317,42,8275,1187,45,1142,8592,7103,1489,6053,4921,1132,1256,217,67,4513
5/1/2019,VA,Virginia,Cumberland,51049,2356,1800,556,1973,13,1960,383,*,*,2185,1629,556,1720,1236,484,433,91,32,1164
5/1/2019,VA,Virginia,Danville City,51590,11014,7843,3171,8742,87,8655,2272,119,2153,10350,7179,3171,8867,6570,2297,3214,387,150,5116
5/1/2019,VA,Virginia,Dickenson,51051,4894,2617,2277,3203,*,*,1691,*,*,4685,2409,2276,3931,1897,2034,1156,194,80,2501
5/1/2019,VA,Virginia,Dinwiddie,51053,6069,4696,1373,4957,40,4917,1112,30,1082,5583,4210,1373,4181,2898,1283,967,181,49,2984
5/1/2019,VA,Virginia,Emporia City,51595,1328,956,372,1045,22,1023,283,12,271,1245,873,372,1011,707,304,457,*,*,480
5/1/2019,VA,Virginia,Essex,51057,2993,2353,640,2577,18,2559,416,15,401,2752,2112,640,2098,1604,494,454,89,36,1519
5/1/2019,VA,Virginia,Fairfax,51059,152457,124499,27958,144356,637,143719,8101,465,7636,122625,94707,27918,73934,50236,23698,14150,2556,554,56674
5/1/2019,VA,Virginia,Fairfax City,51600,3869,3126,743,3612,15,3597,257,14,243,3232,2490,742,2026,1433,593,381,68,18,1559
5/1/2019,VA,Virginia,Falls Church City,51610,2064,1720,344,1983,*,*,81,0,81,1600,1258,342,1015,722,293,123,*,*,876
5/1/2019,VA,Virginia,Fauquier,51061,12753,11251,1502,11677,71,11606,1076,41,1035,11307,9805,1502,7384,6298,1086,1003,181,52,6148
5/1/2019,VA,Virginia,Floyd,51063,4147,3257,890,3601,18,3583,546,*,*,3867,2977,890,3127,2308,819,596,104,49,2378
5/1/2019,VA,Virginia,Fluvanna,51065,6079,5221,858,5463,24,5439,616,20,596,5520,4662,858,4091,3416,675,579,104,24,3384
5/1/2019,VA,Virginia,Franklin,51067,15031,10699,4332,12702,58,12644,2329,35,2294,14106,9776,4330,11583,7722,3861,2051,457,150,8925
5/1/2019,VA,Virginia,Franklin City,51620,2156,1778,378,1747,19,1728,409,20,389,2005,1627,378,1633,1291,342,538,61,17,1017
5/1/2019,VA,Virginia,Frederick,51069,16835,14307,2528,15090,65,15025,1745,48,1697,15295,12771,2524,10674,8702,1972,1433,351,118,8772
5/1/2019,VA,Virginia,Fredericksburg City,51630,4143,3544,599,3431,27,3404,712,24,688,3689,3090,599,2588,2066,522,833,83,39,1633
5/1/2019,VA,Virginia,Galax City,51640,1770,1566,204,1433,*,*,337,*,*,1673,1469,204,1375,1214,161,587,49,22,717
5/1/2019,VA,Virginia,Giles,51071,4628,3551,1077,3709,22,3687,919,15,904,4356,3279,1077,3625,2977,648,833,118,33,2641
5/1/2019,VA,Virginia,Gloucester,51073,8686,7138,1548,7545,40,7505,1141,23,1118,8010,6464,1546,5239,3918,1321,1011,171,47,4010
5/1/2019,VA,Virginia,Goochland,51075,5917,4632,1285,5448,27,5421,469,16,453,5397,4113,1284,4472,3428,1044,396,94,29,3953
5/1/2019,VA,Virginia,Grayson,51077,4551,3627,924,3772,15,3757,779,12,767,4343,3419,924,3348,2537,811,938,172,81,2157
5/1/2019,VA,Virginia,Greene,51079,3995,3435,560,3511,15,3496,484,11,473,3609,3049,560,2669,2185,484,475,82,27,2085
5/1/2019,VA,Virginia,Greensville,51081,2112,1516,596,1713,21,1692,399,14,385,1963,1367,596,1592,1137,455,447,103,23,1019
5/1/2019,VA,Virginia,Halifax,51083,9831,8115,1716,8159,72,8087,1672,49,1623,9207,7491,1716,7441,5942,1499,2155,412,141,4733
5/1/2019,VA,Virginia,Hampton City,51650,25318,18321,6997,20996,217,20779,4322,212,4110,23037,16040,6997,14427,7892,6535,3883,747,171,9626
5/1/2019,VA,Virginia,Hanover,51085,21498,16119,5379,19648,103,19545,1850,55,1795,19545,14167,5378,15905,11491,4414,1505,321,89,13990
5/1/2019,VA,Virginia,Harrisonburg City,51660,5511,4816,695,4692,24,4668,819,25,794,5000,4305,695,4015,3507,508,1010,120,36,2849
5/1/2019,VA,Virginia,Henrico,51087,57347,41337,16010,50583,348,50235,6764,293,6471,51732,35738,15994,42431,28492,13939,6586,1324,373,34148
5/1/2019,VA,Virginia,Henry,51089,14829,10334,4495,11892,79,11813,2937,67,2870,14088,9594,4494,12091,7928,4163,3002,704,228,8157
5/1/2019,VA,Virginia,Highland,51091,800,718,82,729,*,*,71,*,*,751,669,82,564,498,66,58,*,*,480
5/1/2019,VA,Virginia,Hopewell City,51670,4541,3452,1089,3543,36,3507,998,35,963,4195,3106,1089,2966,1929,1037,1021,142,32,1771
5/1/2019,VA,Virginia,Isle of Wight,51093,8408,6563,1845,7452,55,7397,956,38,918,7756,5911,1845,5503,3833,1670,996,186,67,4254
5/1/2019,VA,Virginia,James City,51095,21006,17858,3148,19796,60,19736,1210,51,1159,19377,16232,3145,12551,10236,2315,922,220,55,11354
5/1/2019,VA,Virginia,King and Queen,51097,1798,1461,337,1528,13,1515,270,*,*,1667,1330,337,1265,974,291,281,*,*,910
5/1/2019,VA,Virginia,King George,51099,3991,3569,422,3469,15,3454,522,27,495,3457,3035,422,1747,1398,349,465,62,17,1203
5/1/2019,VA,Virginia,King William,51101,3472,2852,620,2984,24,2960,488,23,465,3182,2562,620,2581,2055,526,411,106,24,2040
5/1/2019,VA,Virginia,Lancaster,51103,4376,3729,647,4045,21,4024,331,18,313,4141,3495,646,3048,2634,414,505,95,14,2434
5/1/2019,VA,Virginia,Lee,51105,6434,3499,2935,4522,14,4508,1912,15,1897,6114,3181,2933,5025,2281,2744,1953,240,81,2751
5/1/2019,VA,Virginia,Lexington City,51678,1392,1232,160,1278,11,1267,114,*,*,1273,1114,159,986,858,128,188,32,13,753
5/1/2019,VA,Virginia,Loudoun,51107,38917,31773,7144,36517,183,36334,2400,118,2282,32226,25091,7135,21773,15735,6038,3330,612,135,17696
5/1/2019,VA,Virginia,Louisa,51109,8338,6683,1655,7083,47,7036,1255,36,1219,7623,5968,1655,5696,4279,1417,1094,239,65,4298
5/1/2019,VA,Virginia,Lunenburg,51111,3112,2615,497,2579,19,2560,533,15,518,2864,2367,497,2202,1764,438,734,108,37,1323
5/1/2019,VA,Virginia,Lynchburg City,51680,14575,11700,2875,12023,94,11929,2552,104,2448,13491,10619,2872,11042,8509,2533,2959,447,130,7506
5/1/2019,VA,Virginia,Madison,51113,3263,2762,501,2915,15,2900,348,14,334,3031,2530,501,2256,1872,384,425,88,20,1723
5/1/2019,VA,Virginia,Manassas City,51683,4600,3665,935,4094,24,4070,506,43,463,3844,2909,935,2691,1890,801,539,85,30,2037
5/1/2019,VA,Virginia,Manassas Park City,51685,1315,992,323,1144,16,1128,171,13,158,1096,773,323,783,490,293,198,*,*,527
5/1/2019,VA,Virginia,Martinsville City,51690,3855,2761,1094,2912,39,2873,943,38,905,3646,2553,1093,3143,2099,1044,1296,163,53,1631
5/1/2019,VA,Virginia,Mathews,51115,2874,2383,491,2637,*,*,237,*,*,2708,2217,491,1918,1521,397,279,35,19,1585
5/1/2019,VA,Virginia,Mecklenburg,51117,9230,7287,1943,7750,58,7692,1480,66,1414,8649,6707,1942,6855,5247,1608,1817,351,92,4595
5/1/2019,VA,Virginia,Middlesex,51119,3598,2991,607,3242,15,3227,356,*,*,3395,2788,607,2603,2148,455,459,73,28,2043
5/1/2019,VA,Virginia,Montgomery,51121,14131,11341,2790,11867,55,11812,2264,31,2233,12737,9948,2789,10650,8172,2478,1937,346,122,8245
5/1/2019,VA,Virginia,Nelson,51125,4653,3933,720,4168,16,4152,485,12,473,4284,3565,719,3176,2573,603,565,104,40,2467
5/1/2019,VA,Virginia,New Kent,51127,4646,3756,890,4190,21,4169,456,*,*,4218,3329,889,3003,2321,682,300,76,19,2608
5/1/2019,VA,Virginia,Newport News City,51700,28540,20482,8058,23646,220,23426,4894,243,4651,26074,18020,8054,17350,9756,7594,4930,875,205,11340
5/1/2019,VA,Virginia,Norfolk City,51710,33296,24091,9205,26958,297,26661,6338,329,6009,29886,20685,9201,20449,11735,8714,7286,1275,279,11609
5/1/2019,VA,Virginia,Northampton,51131,3733,2992,741,3251,26,3225,482,19,463,3478,2738,740,2791,2167,624,909,85,28,1769
5/1/2019,VA,Virginia,Northumberland,51133,4643,3930,713,4314,15,4299,329,15,314,4342,3629,713,2933,2517,416,426,75,27,2405
5/1/2019,VA,Virginia,Norton City,51720,1157,707,450,801,*,*,356,*,*,1075,625,450,888,475,413,344,42,13,489
5/1/2019,VA,Virginia,Nottoway,51135,3638,2972,666,3006,28,2978,632,15,617,3363,2698,665,2625,2132,493,865,120,41,1599
5/1/2019,VA,Virginia,Orange,51137,8743,7490,1253,7748,55,7693,995,30,965,7967,6715,1252,5382,4539,843,971,182,61,4168
5/1/2019,VA,Virginia,Page,51139,6211,5276,935,5159,26,5133,1052,25,1027,5802,4867,935,4281,3501,780,1085,231,80,2885
5/1/2019,VA,Virginia,Patrick,51141,5470,4124,1346,4579,*,*,891,12,879,5180,3836,1344,4254,3148,1106,1092,185,74,2903
5/1/2019,VA,Virginia,Petersburg City,51730,7160,5064,2096,5374,86,5288,1786,78,1708,6544,4449,2095,4891,2871,2020,2101,337,64,2389
5/1/2019,VA,Virginia,Pittsylvania,51143,16458,11823,4635,13617,95,13522,2841,77,2764,15480,10845,4635,12937,9501,3436,3062,526,182,9167
5/1/2019,VA,Virginia,Poquoson City,51735,2605,2274,331,2425,*,*,180,*,*,2390,2060,330,1237,953,284,118,25,11,1083
5/1/2019,VA,Virginia,Portsmouth City,51740,18330,13269,5061,14422,194,14228,3908,206,3702,16341,11285,5056,11076,6288,4788,3984,680,145,6267
5/1/2019,VA,Virginia,Powhatan,51145,6177,4815,1362,5582,23,5559,595,19,576,5670,4308,1362,4579,3423,1156,414,108,28,4029
5/1/2019,VA,Virginia,Prince Edward,51147,4678,3857,821,3809,45,3764,869,31,838,4339,3518,821,3376,2771,605,1067,146,53,2110
5/1/2019,VA,Virginia,Prince George,51149,6157,5263,894,5235,34,5201,922,33,889,5685,4792,893,3496,2711,785,578,117,28,2773
5/1/2019,VA,Virginia,Prince William,51153,49551,39591,9960,44547,309,44238,5004,288,4716,42072,32123,9949,24842,16066,8776,5247,1036,217,18342
5/1/2019,VA,Virginia,Pulaski,51155,9186,7226,1960,7417,33,7384,1769,31,1738,8544,6585,1959,7068,5371,1697,1605,284,103,5076
5/1/2019,VA,Virginia,Radford City,51750,2049,1627,422,1672,*,*,377,*,*,1863,1441,422,1587,1209,378,342,40,23,1182
5/1/2019,VA,Virginia,Rappahannock,51157,1942,1754,188,1817,*,*,125,*,*,1740,1553,187,1197,1066,131,137,*,*,1017
5/1/2019,VA,Virginia,Richmond,51159,1959,1568,391,1720,*,*,239,15,224,1815,1425,390,1359,1112,247,305,62,14,978
5/1/2019,VA,Virginia,Richmond City,51760,34606,22675,11931,27848,292,27556,6758,322,6436,31028,19108,11920,26460,15178,11282,8834,1324,276,16026
5/1/2019,VA,Virginia,Roanoke,51161,23651,17769,5882,21081,103,20978,2570,65,2505,21805,15926,5879,17781,12802,4979,2128,436,137,15080
5/1/2019,VA,Virginia,Roanoke City,51770,21198,14748,6450,16307,155,16152,4891,147,4744,19244,12799,6445,15836,9928,5908,4869,846,207,9914
5/1/2019,VA,Virginia,Rockbridge,51163,6341,5288,1053,5467,12,5455,874,11,863,5869,4816,1053,4440,3570,870,851,179,54,3356
5/1/2019,VA,Virginia,Rockingham,51165,17884,15265,2619,15782,45,15737,2102,43,2059,16511,13893,2618,12985,11146,1839,1839,481,130,10535
5/1/2019,VA,Virginia,Russell,51167,7975,4739,3236,5629,14,5615,2346,22,2324,7632,4399,3233,6545,3913,2632,1666,325,144,4410
5/1/2019,VA,Virginia,Salem City,51775,6068,4721,1347,5150,31,5119,918,17,901,5604,4257,1347,4550,3358,1192,850,128,37,3535
5/1/2019,VA,Virginia,Scott,51169,6781,3145,3636,5203,13,5190,1578,16,1562,6509,2876,3633,5691,2161,3530,1547,237,104,3803
5/1/2019,VA,Virginia,Shenandoah,51171,10649,9025,1624,9492,41,9451,1157,25,1132,9927,8303,1624,7142,5852,1290,1256,264,89,5533
5/1/2019,VA,Virginia,Smyth,51173,8639,6093,2546,6563,36,6527,2076,28,2048,8192,5646,2546,6782,4457,2325,2077,377,121,4207
5/1/2019,VA,Virginia,Southampton,51175,3972,3262,710,3346,36,3310,626,26,600,3673,2963,710,2918,2300,618,716,113,34,2055
5/1/2019,VA,Virginia,Spotsylvania,51177,21506,18483,3023,18867,119,18748,2639,105,2534,19056,16034,3022,11654,9258,2396,2032,520,133,8969
5/1/2019,VA,Virginia,Stafford,51179,17968,15843,2125,15932,110,15822,2036,87,1949,15696,13575,2121,8070,6373,1697,1462,361,87,6160
5/1/2019,VA,Virginia,Staunton City,51790,6278,5320,958,5279,24,5255,999,17,982,5889,4931,958,4669,3882,787,1097,149,51,3372
5/1/2019,VA,Virginia,Suffolk City,51800,16711,12862,3849,13839,123,13716,2872,113,2759,15258,11412,3846,10554,7068,3486,2786,455,109,7204
5/1/2019,VA,Virginia,Surry,51181,1716,1327,389,1482,*,*,234,*,*,1568,1179,389,1156,801,355,210,59,13,874
5/1/2019,VA,Virginia,Sussex,51183,2527,1909,618,2089,37,2052,438,*,*,2356,1738,618,1823,1244,579,536,141,20,1126
5/1/2019,VA,Virginia,Tazewell,51185,11983,7819,4164,8955,38,8917,3028,39,2989,11349,7186,4163,9127,6177,2950,2271,459,166,6231
5/1/2019,VA,Virginia,Unknown,51999,*,*,*,*,*,*,*,*,*,*,*,*,*,*,*,*,*,*,*
5/1/2019,VA,Virginia,Virginia Beach City,51810,73149,58881,14268,64908,420,64488,8241,351,7890,66807,52555,14252,39092,26284,12808,6994,1462,383,30253
5/1/2019,VA,Virginia,Warren,51187,7788,6755,1033,6746,28,6718,1042,33,1009,7073,6041,1032,4856,4044,812,935,208,71,3642
5/1/2019,VA,Virginia,Washington,51191,14972,9284,5688,12257,47,12210,2715,33,2682,14099,8413,5686,11726,6548,5178,2393,528,195,8610
5/1/2019,VA,Virginia,Waynesboro City,51820,4958,4172,786,4113,18,4095,845,24,821,4625,3839,786,3674,2988,686,914,111,44,2605
5/1/2019,VA,Virginia,Westmoreland,51193,5065,4390,675,4464,25,4439,601,15,586,4595,3920,675,2992,2443,549,763,138,44,2047
5/1/2019,VA,Virginia,Williamsburg City,51830,2749,2275,474,2530,*,*,219,12,207,2527,2053,474,1807,1422,385,247,*,*,1524
5/1/2019,VA,Virginia,Winchester City,51840,5499,4710,789,4754,29,4725,745,20,725,4990,4201,789,3643,3005,638,866,138,40,2599
5/1/2019,VA,Virginia,Wise,51195,10666,6053,4613,7317,26,7291,3349,27,3322,10074,5462,4612,8170,3932,4238,2455,455,179,5081
5/1/2019,VA,Virginia,Wythe,51197,7954,5869,2085,6285,37,6248,1669,19,1650,7514,5430,2084,6127,4318,1809,1661,283,104,4079
5/1/2019,VA,Virginia,York,51199,12149,10373,1776,11171,41,11130,978,34,944,11107,9332,1775,6048,4538,1510,701,149,35,5163
11/1/2019,VA,Virginia,Accomack,51001,9038,7443,1595,7838,50,7788,1200,42,1158,8372,6778,1594,6193,4934,1259,1552,360,90,4191
11/1/2019,VA,Virginia,Albemarle,51003,21563,18964,2599,20007,67,19940,1556,43,1513,19393,16798,2595,14984,12817,2167,1601,287,101,12995
11/1/2019,VA,Virginia,Alexandria City,51510,18409,15261,3148,17034,69,16965,1375,87,1288,14807,11662,3145,9116,6320,2796,2191,282,62,6581
11/1/2019,VA,Virginia,Alleghany,51005,4590,3796,794,3742,17,3725,848,12,836,4362,3568,794,3538,2890,648,837,101,51,2549
11/1/2019,VA,Virginia,Amelia,51007,3119,2290,829,2655,*,*,464,19,445,2872,2043,829,2302,1534,768,482,91,37,1692
11/1/2019,VA,Virginia,Amherst,51009,7948,6261,1687,6642,46,6596,1306,28,1278,7392,5705,1687,6035,4533,1502,1270,213,73,4479
11/1/2019,VA,Virginia,Appomattox,51011,3968,3173,795,3266,18,3248,702,21,681,3731,2936,795,3028,2313,715,708,93,41,2186
11/1/2019,VA,Virginia,Arlington,51013,25124,21281,3843,23535,93,23442,1589,88,1501,19712,15874,3838,12060,8605,3455,3020,360,120,8560
11/1/2019,VA,Virginia,Augusta,51015,18606,15694,2912,16178,52,16126,2428,51,2377,17453,14542,2911,13597,11150,2447,1937,379,145,11136
11/1/2019,VA,Virginia,Bath,51017,1277,1156,121,1118,*,*,159,*,*,1210,1089,121,951,851,100,155,34,16,746
11/1/2019,VA,Virginia,Bedford,51019,20069,16167,3902,17328,83,17245,2741,48,2693,18657,14758,3899,14722,11862,2860,2080,450,148,12044
11/1/2019,VA,Virginia,Bland,51021,1807,1349,458,1438,*,*,369,*,*,1704,1246,458,1324,1001,323,233,54,17,1020
11/1/2019,VA,Virginia,Botetourt,51023,8837,6627,2210,7756,45,7711,1081,21,1060,8218,6008,2210,6544,4669,1875,743,161,52,5588
11/1/2019,VA,Virginia,Bristol City,51520,4641,2493,2148,3655,11,3644,986,15,971,4350,2203,2147,3705,1647,2058,1142,138,54,2371
11/1/2019,VA,Virginia,Brunswick,51025,4079,3169,910,3415,33,3382,664,20,644,3795,2885,910,3039,2255,784,1094,126,44,1775
11/1/2019,VA,Virginia,Buchanan,51027,7268,3973,3295,4652,18,4634,2616,21,2595,7007,3713,3294,5948,3482,2466,1704,386,109,3749
11/1/2019,VA,Virginia,Buckingham,51029,3685,3031,654,3034,19,3015,651,18,633,3458,2804,654,2653,2224,429,807,135,43,1668
11/1/2019,VA,Virginia,Buena Vista City,51530,1502,1189,313,1232,*,*,270,*,*,1398,1085,313,1099,836,263,310,53,17,719
11/1/2019,VA,Virginia,Campbell,51031,13252,10518,2734,11080,76,11004,2172,64,2108,12399,9665,2734,10128,7715,2413,2157,359,136,7476
11/1/2019,VA,Virginia,Caroline,51033,6066,4848,1218,5107,34,5073,959,35,924,5459,4241,1218,3753,2692,1061,885,198,45,2625
11/1/2019,VA,Virginia,Carroll,51035,8527,7044,1483,7062,24,7038,1465,15,1450,8075,6593,1482,6361,5189,1172,1648,248,107,4358
11/1/2019,VA,Virginia,Charles City,51036,1969,1488,481,1696,18,1678,273,15,258,1803,1322,481,1375,960,415,265,73,18,1019
11/1/2019,VA,Virginia,Charlotte,51037,3297,2672,625,2707,14,2693,590,17,573,3092,2468,624,2446,1901,545,747,125,40,1534
11/1/2019,VA,Virginia,Charlottesville City,51540,6406,5551,855,5363,26,5337,1043,41,1002,5753,4899,854,4648,3876,772,1285,149,37,3177
11/1/2019,VA,Virginia,Chesapeake City,51550,39522,30427,9095,34246,283,33963,5276,230,5046,35730,26643,9087,22173,14072,8101,4404,911,209,16649
11/1/2019,VA,Virginia,Chesterfield,51041,62456,46521,15935,54991,240,54751,7465,244,7221,56337,40410,15927,44036,29816,14220,5887,1001,281,36867
11/1/2019,VA,Virginia,Clarke,51043,3375,2928,447,3113,11,3102,262,*,*,3048,2601,447,2118,1780,338,285,65,25,1743
11/1/2019,VA,Virginia,Colonial Heights City,51570,4183,3396,787,3590,11,3579,593,12,581,3821,3034,787,2539,1844,695,514,99,21,1905
11/1/2019,VA,Virginia,Covington City,51580,1604,1322,282,1230,14,1216,374,*,*,1500,1218,282,1208,950,258,337,48,15,808
11/1/2019,VA,Virginia,Craig,51045,1379,998,381,1087,*,*,292,*,*,1280,899,381,1029,680,349,224,44,15,746
11/1/2019,VA,Virginia,Culpeper,51047,9636,8086,1550,8414,35,8379,1222,43,1179,8744,7196,1548,6168,4982,1186,1312,214,68,4574
11/1/2019,VA,Virginia,Cumberland,51049,2378,1796,582,1983,13,1970,395,*,*,2211,1629,582,1749,1238,511,457,89,32,1171
11/1/2019,VA,Virginia,Danville City,51590,11056,7721,3335,8748,77,8671,2308,117,2191,10384,7049,3335,8898,6434,2464,3290,370,158,5080
11/1/2019,VA,Virginia,Dickenson,51051,4905,2562,2343,3179,*,*,1726,*,*,4704,2362,2342,3967,1862,2105,1183,196,76,2512
11/1/2019,VA,Virginia,Dinwiddie,51053,6109,4713,1396,4982,35,4947,1127,32,1095,5625,4229,1396,4212,2903,1309,974,179,49,3010
11/1/2019,VA,Virginia,Emporia City,51595,1329,937,392,1042,22,1020,287,12,275,1247,855,392,1011,689,322,456,*,*,479
11/1/2019,VA,Virginia,Essex,51057,3024,2372,652,2596,14,2582,428,16,412,2780,2128,652,2127,1618,509,473,84,36,1534
11/1/2019,VA,Virginia,Fairfax,51059,156239,127050,29189,147922,583,147339,8317,470,7847,125814,96666,29148,75792,51014,24778,14700,2599,572,57921
11/1/2019,VA,Virginia,Fairfax City,51600,3930,3159,771,3667,13,3654,263,14,249,3303,2533,770,2081,1461,620,400,67,19,1595
11/1/2019,VA,Virginia,Falls Church City,51610,2104,1745,359,2023,*,*,81,0,81,1633,1276,357,1038,730,308,126,*,*,897
11/1/2019,VA,Virginia,Fauquier,51061,13001,11459,1542,11886,66,11820,1115,42,1073,11515,9973,1542,7520,6401,1119,1036,174,56,6254
11/1/2019,VA,Virginia,Floyd,51063,4215,3307,908,3663,15,3648,552,*,*,3939,3031,908,3176,2337,839,630,105,45,2396
11/1/2019,VA,Virginia,Fluvanna,51065,6169,5274,895,5535,21,5514,634,17,617,5622,4727,895,4181,3471,710,606,99,28,3448
11/1/2019,VA,Virginia,Franklin,51067,15206,10763,4443,12837,55,12782,2369,34,2335,14268,9827,4441,11706,7748,3958,2105,455,157,8989
11/1/2019,VA,Virginia,Franklin City,51620,2179,1769,410,1764,19,1745,415,19,396,2021,1611,410,1658,1282,376,549,60,19,1030
11/1/2019,VA,Virginia,Frederick,51069,17106,14519,2587,15304,58,15246,1802,49,1753,15567,12984,2583,10858,8824,2034,1496,351,122,8889
11/1/2019,VA,Virginia,Fredericksburg City,51630,4207,3587,620,3483,26,3457,724,23,701,3733,3113,620,2612,2070,542,866,75,41,1630
11/1/2019,VA,Virginia,Galax City,51640,1776,1560,216,1427,*,*,349,*,*,1678,1462,216,1378,1205,173,599,47,24,708
11/1/2019,VA,Virginia,Giles,51071,4620,3539,1081,3681,22,3659,939,15,924,4374,3293,1081,3641,2981,660,857,115,32,2637
11/1/2019,VA,Virginia,Gloucester,51073,8804,7193,1611,7643,40,7603,1161,22,1139,8129,6520,1609,5319,3934,1385,1051,166,51,4051
11/1/2019,VA,Virginia,Goochland,51075,6018,4704,1314,5542,25,5517,476,13,463,5531,4218,1313,4557,3484,1073,414,93,27,4023
11/1/2019,VA,Virginia,Grayson,51077,4582,3618,964,3784,14,3770,798,*,*,4389,3425,964,3402,2549,853,957,174,86,2185
11/1/2019,VA,Virginia,Greene,51079,4058,3483,575,3560,15,3545,498,11,487,3679,3104,575,2718,2218,500,496,71,28,2123
11/1/2019,VA,Virginia,Greensville,51081,2123,1522,601,1717,21,1696,406,14,392,1967,1366,601,1591,1123,468,456,99,25,1011
11/1/2019,VA,Virginia,Halifax,51083,9874,8116,1758,8188,66,8122,1686,51,1635,9236,7478,1758,7456,5911,1545,2206,398,138,4714
11/1/2019,VA,Virginia,Hampton City,51650,25787,18519,7268,21365,208,21157,4422,216,4206,23446,16179,7267,14698,7892,6806,4087,740,176,9695
11/1/2019,VA,Virginia,Hanover,51085,21848,16416,5432,19950,92,19858,1898,53,1845,19839,14409,5430,16145,11668,4477,1558,305,95,14187
11/1/2019,VA,Virginia,Harrisonburg City,51660,5590,4871,719,4742,22,4720,848,23,825,5076,4357,719,4062,3522,540,1048,116,44,2854
11/1/2019,VA,Virginia,Henrico,51087,58192,41767,16425,51247,321,50926,6945,294,6651,52558,36147,16411,43094,28718,14376,6841,1315,385,34553
11/1/2019,VA,Virginia,Henry,51089,14901,10253,4648,11915,73,11842,2986,71,2915,14165,9519,4646,12134,7812,4322,3127,675,223,8109
11/1/2019,VA,Virginia,Highland,51091,805,721,84,734,*,*,71,*,*,758,674,84,567,501,66,62,*,*,477
11/1/2019,VA,Virginia,Hopewell City,51670,4579,3449,1130,3553,32,3521,1026,35,991,4242,3112,1130,3010,1932,1078,1064,131,39,1776
11/1/2019,VA,Virginia,Isle of Wight,51093,8523,6645,1878,7529,53,7476,994,39,955,7879,6001,1878,5577,3870,1707,1034,179,67,4297
11/1/2019,VA,Virginia,James City,51095,21277,18052,3225,20020,54,19966,1257,50,1207,19673,16452,3221,12777,10376,2401,968,220,63,11526
11/1/2019,VA,Virginia,King and Queen,51097,1813,1457,356,1540,11,1529,273,*,*,1686,1330,356,1279,970,309,294,*,*,915
11/1/2019,VA,Virginia,King George,51099,4052,3643,409,3519,14,3505,533,26,507,3518,3109,409,1760,1421,339,470,60,17,1213
11/1/2019,VA,Virginia,King William,51101,3531,2897,634,3026,23,3003,505,26,479,3253,2619,634,2623,2081,542,428,102,22,2071
11/1/2019,VA,Virginia,Lancaster,51103,4391,3737,654,4055,21,4034,336,19,317,4150,3497,653,3047,2625,422,521,87,14,2425
11/1/2019,VA,Virginia,Lee,51105,6435,3384,3051,4492,12,4480,1943,17,1926,6121,3072,3049,5061,2280,2781,2005,239,79,2738
11/1/2019,VA,Virginia,Lexington City,51678,1378,1208,170,1264,*,*,114,*,*,1252,1083,169,966,829,137,180,31,13,742
11/1/2019,VA,Virginia,Loudoun,51107,39866,32508,7358,37405,165,37240,2461,123,2338,33016,25665,7351,22245,15995,6250,3482,620,145,17998
11/1/2019,VA,Virginia,Louisa,51109,8474,6773,1701,7185,42,7143,1289,40,1249,7750,6049,1701,5803,4341,1462,1137,238,65,4363
11/1/2019,VA,Virginia,Lunenburg,51111,3134,2620,514,2595,14,2581,539,13,526,2898,2384,514,2225,1770,455,744,108,39,1334
11/1/2019,VA,Virginia,Lynchburg City,51680,14636,11598,3038,12033,85,11948,2603,102,2501,13582,10548,3034,11138,8428,2710,3055,435,136,7512
11/1/2019,VA,Virginia,Madison,51113,3328,2800,528,2969,13,2956,359,12,347,3091,2563,528,2299,1890,409,440,81,18,1760
11/1/2019,VA,Virginia,Manassas City,51683,4715,3736,979,4189,21,4168,526,42,484,3970,2991,979,2775,1935,840,573,76,30,2096
11/1/2019,VA,Virginia,Manassas Park City,51685,1348,1008,340,1173,17,1156,175,13,162,1125,785,340,803,492,311,204,*,*,536
11/1/2019,VA,Virginia,Martinsville City,51690,3847,2692,1155,2898,36,2862,949,38,911,3645,2491,1154,3139,2033,1106,1315,156,52,1616
11/1/2019,VA,Virginia,Mathews,51115,2894,2402,492,2643,*,*,251,*,*,2734,2242,492,1937,1537,400,296,32,18,1591
11/1/2019,VA,Virginia,Mecklenburg,51117,9294,7289,2005,7771,54,7717,1523,69,1454,8713,6709,2004,6908,5227,1681,1849,350,91,4618
11/1/2019,VA,Virginia,Middlesex,51119,3646,3041,605,3283,14,3269,363,*,*,3423,2819,604,2625,2169,456,470,74,29,2052
11/1/2019,VA,Virginia,Montgomery,51121,14325,11435,2890,12018,49,11969,2307,33,2274,12887,9998,2889,10784,8211,2573,1997,326,121,8340
11/1/2019,VA,Virginia,Nelson,51125,4709,3960,749,4220,15,4205,489,11,478,4348,3600,748,3234,2601,633,591,100,43,2500
11/1/2019,VA,Virginia,New Kent,51127,4757,3862,895,4287,16,4271,470,*,*,4318,3424,894,3085,2399,686,331,65,22,2667
11/1/2019,VA,Virginia,Newport News City,51700,28922,20587,8335,23892,203,23689,5030,249,4781,26406,18076,8330,17603,9719,7884,5181,835,202,11385
11/1/2019,VA,Virginia,Norfolk City,51710,33778,24115,9663,27248,273,26975,6530,326,6204,30336,20678,9658,20840,11662,9178,7630,1243,278,11689
11/1/2019,VA,Virginia,Northampton,51131,3781,3005,776,3292,24,3268,489,21,468,3520,2745,775,2833,2179,654,936,83,28,1786
11/1/2019,VA,Virginia,Northumberland,51133,4679,3956,723,4339,12,4327,340,14,326,4385,3662,723,2956,2528,428,448,68,27,2413
11/1/2019,VA,Virginia,Norton City,51720,1157,680,477,793,*,*,364,*,*,1072,595,477,897,464,433,356,42,12,487
11/1/2019,VA,Virginia,Nottoway,51135,3644,2953,691,3000,25,2975,644,14,630,3386,2695,691,2644,2117,527,885,119,44,1596
11/1/2019,VA,Virginia,Orange,51137,8869,7599,1270,7852,49,7803,1017,30,987,8083,6813,1270,5451,4587,864,1010,176,64,4201
11/1/2019,VA,Virginia,Page,51139,6240,5298,942,5179,23,5156,1061,23,1038,5816,4874,942,4300,3511,789,1098,234,77,2891
11/1/2019,VA,Virginia,Patrick,51141,5488,4142,1346,4569,*,*,919,12,907,5202,3857,1345,4252,3144,1108,1098,178,74,2902
11/1/2019,VA,Virginia,Petersburg City,51730,7229,5037,2192,5406,79,5327,1823,74,1749,6591,4401,2190,4944,2823,2121,2187,314,68,2375
11/1/2019,VA,Virginia,Pittsylvania,51143,16587,11797,4790,13704,87,13617,2883,74,2809,15595,10805,4790,13042,9449,3593,3138,523,183,9198
11/1/2019,VA,Virginia,Poquoson City,51735,2641,2301,340,2457,*,*,184,*,*,2426,2087,339,1265,972,293,127,23,12,1103
11/1/2019,VA,Virginia,Portsmouth City,51740,18575,13263,5312,14569,171,14398,4006,203,3803,16595,11287,5308,11244,6196,5048,4185,669,145,6245
11/1/2019,VA,Virginia,Powhatan,51145,6310,4934,1376,5703,19,5684,607,19,588,5783,4407,1376,4683,3510,1173,432,110,27,4114
11/1/2019,VA,Virginia,Prince Edward,51147,4702,3869,833,3823,40,3783,879,30,849,4352,3519,833,3397,2776,621,1086,143,53,2115
11/1/2019,VA,Virginia,Prince George,51149,6231,5325,906,5281,29,5252,950,33,917,5758,4853,905,3545,2746,799,603,120,28,2794
11/1/2019,VA,Virginia,Prince William,51153,50874,40542,10332,45684,295,45389,5190,304,4886,43284,32964,10320,25444,16302,9142,5487,1061,228,18668
11/1/2019,VA,Virginia,Pulaski,51155,9246,7234,2012,7447,28,7419,1799,32,1767,8606,6595,2011,7113,5364,1749,1643,280,100,5090
11/1/2019,VA,Virginia,Radford City,51750,2073,1632,441,1696,*,*,377,*,*,1881,1440,441,1601,1205,396,344,41,23,1193
11/1/2019,VA,Virginia,Rappahannock,51157,1972,1771,201,1840,*,*,132,*,*,1775,1575,200,1221,1078,143,152,*,*,1023
11/1/2019,VA,Virginia,Richmond,51159,1965,1578,387,1720,*,*,245,12,233,1823,1437,386,1358,1105,253,314,62,14,968
11/1/2019,VA,Virginia,Richmond City,51760,34969,22645,12324,28098,267,27831,6871,315,6556,31438,19125,12313,26819,15134,11685,9234,1271,289,16025
11/1/2019,VA,Virginia,Roanoke,51161,23954,17959,5995,21306,96,21210,2648,64,2584,22079,16087,5992,17984,12884,5100,2225,415,138,15206
11/1/2019,VA,Virginia,Roanoke City,51770,21410,14707,6703,16428,144,16284,4982,148,4834,19453,12756,6697,16013,9841,6172,5048,831,213,9921
11/1/2019,VA,Virginia,Rockbridge,51163,6397,5300,1097,5491,*,*,906,*,*,5935,4838,1097,4490,3577,913,890,177,55,3368
11/1/2019,VA,Virginia,Rockingham,51165,18169,15526,2643,16007,45,15962,2162,43,2119,16794,14152,2642,13208,11325,1883,1945,474,141,10648
11/1/2019,VA,Virginia,Russell,51167,8005,4717,3288,5616,14,5602,2389,22,2367,7667,4381,3286,6593,3902,2691,1746,326,146,4375
11/1/2019,VA,Virginia,Salem City,51775,6106,4725,1381,5170,26,5144,936,19,917,5632,4251,1381,4562,3329,1233,867,122,37,3536
11/1/2019,VA,Virginia,Scott,51169,6781,3099,3682,5182,12,5170,1599,17,1582,6506,2827,3679,5692,2149,3543,1561,238,106,3787
11/1/2019,VA,Virginia,Shenandoah,51171,10746,9070,1676,9570,36,9534,1176,24,1152,10037,8361,1676,7248,5899,1349,1331,258,83,5576
11/1/2019,VA,Virginia,Smyth,51173,8677,6028,2649,6552,35,6517,2125,29,2096,8228,5579,2649,6827,4390,2437,2131,357,122,4217
11/1/2019,VA,Virginia,Southampton,51175,4014,3288,726,3370,32,3338,644,26,618,3727,3001,726,2945,2307,638,745,108,34,2058
11/1/2019,VA,Virginia,Spotsylvania,51177,21940,18845,3095,19216,109,19107,2724,103,2621,19449,16356,3093,11810,9353,2457,2114,508,135,9053
11/1/2019,VA,Virginia,Stafford,51179,18377,16213,2164,16283,102,16181,2094,82,2012,16093,13933,2160,8213,6461,1752,1541,360,85,6227
11/1/2019,VA,Virginia,Staunton City,51790,6315,5315,1000,5296,20,5276,1019,16,1003,5937,4937,1000,4712,3877,835,1138,150,51,3373
11/1/2019,VA,Virginia,Suffolk City,51800,16987,12972,4015,14021,119,13902,2966,115,2851,15547,11534,4013,10699,7042,3657,2894,455,113,7237
11/1/2019,VA,Virginia,Surry,51181,1737,1334,403,1497,*,*,240,*,*,1598,1195,403,1176,804,372,228,57,12,879
11/1/2019,VA,Virginia,Sussex,51183,2538,1894,644,2092,32,2060,446,*,*,2366,1722,644,1836,1230,606,548,136,23,1129
11/1/2019,VA,Virginia,Tazewell,51185,12027,7806,4221,8957,32,8925,3070,38,3032,11423,7203,4220,9173,6150,3023,2345,459,162,6207
11/1/2019,VA,Virginia,Unknown,51999,*,*,*,*,*,*,*,*,*,*,*,*,*,*,*,*,*,*,*
11/1/2019,VA,Virginia,Virginia Beach City,51810,74501,59747,14754,66042,373,65669,8459,348,8111,68156,53418,14738,39804,26484,13320,7237,1470,398,30699
11/1/2019,VA,Virginia,Warren,51187,7885,6816,1069,6819,24,6795,1066,35,1031,7176,6108,1068,4929,4084,845,983,213,69,3664
11/1/2019,VA,Virginia,Washington,51191,15084,9291,5793,12310,44,12266,2774,34,2740,14234,8443,5791,11852,6555,5297,2475,517,200,8660
11/1/2019,VA,Virginia,Waynesboro City,51820,5019,4197,822,4155,18,4137,864,21,843,4669,3847,822,3725,2997,728,964,111,44,2606
11/1/2019,VA,Virginia,Westmoreland,51193,5116,4421,695,4501,21,4480,615,17,598,4653,3958,695,3017,2448,569,807,130,44,2036
11/1/2019,VA,Virginia,Williamsburg City,51830,2748,2262,486,2527,*,*,221,*,*,2538,2052,486,1819,1424,395,260,*,*,1523
11/1/2019,VA,Virginia,Winchester City,51840,5536,4703,833,4773,26,4747,763,21,742,5033,4200,833,3685,2997,688,905,136,43,2601
11/1/2019,VA,Virginia,Wise,51195,10703,5817,4886,7304,22,7282,3399,26,3373,10106,5220,4886,8231,3868,4363,2540,454,175,5062
11/1/2019,VA,Virginia,Wythe,51197,7985,5840,2145,6283,33,6250,1702,18,1684,7536,5392,2144,6178,4304,1874,1710,284,116,4068
11/1/2019,VA,Virginia,York,51199,12351,10547,1804,11351,37,11314,1000,34,966,11290,9487,1803,6132,4597,1535,726,152,35,5219
10/1/2019,VA,Virginia,Accomack,51001,9040,7447,1593,7843,51,7792,1197,42,1155,8374,6782,1592,6207,4950,1257,1554,359,89,4205
10/1/2019,VA,Virginia,Albemarle,51003,21522,18914,2608,19966,67,19899,1556,43,1513,19373,16769,2604,14971,12792,2179,1605,286,100,12980
10/1/2019,VA,Virginia,Alexandria City,51510,18352,15218,3134,16988,70,16918,1364,85,1279,14770,11639,3131,9094,6311,2783,2186,285,61,6562
10/1/2019,VA,Virginia,Alleghany,51005,4584,3793,791,3736,17,3719,848,13,835,4358,3567,791,3529,2885,644,833,103,50,2543
10/1/2019,VA,Virginia,Amelia,51007,3111,2288,823,2650,*,*,461,18,443,2865,2042,823,2295,1534,761,480,92,37,1686
10/1/2019,VA,Virginia,Amherst,51009,7920,6246,1674,6621,47,6574,1299,28,1271,7369,5695,1674,6012,4523,1489,1264,210,73,4465
10/1/2019,VA,Virginia,Appomattox,51011,3967,3173,794,3269,18,3251,698,20,678,3729,2935,794,3026,2312,714,697,89,42,2198
10/1/2019,VA,Virginia,Arlington,51013,25048,21218,3830,23463,94,23369,1585,88,1497,19692,15867,3825,12047,8605,3442,3012,360,113,8562
10/1/2019,VA,Virginia,Augusta,51015,18575,15655,2920,16155,52,16103,2420,49,2371,17427,14508,2919,13557,11108,2449,1916,384,146,11111
10/1/2019,VA,Virginia,Bath,51017,1275,1155,120,1118,*,*,157,*,*,1208,1088,120,949,850,99,154,34,17,744
10/1/2019,VA,Virginia,Bedford,51019,20030,16136,3894,17302,84,17218,2728,49,2679,18637,14746,3891,14698,11849,2849,2076,453,150,12019
10/1/2019,VA,Virginia,Bland,51021,1809,1349,460,1440,*,*,369,*,*,1705,1245,460,1327,1004,323,236,52,17,1022
10/1/2019,VA,Virginia,Botetourt,51023,8812,6606,2206,7738,46,7692,1074,22,1052,8198,5992,2206,6527,4657,1870,742,160,52,5573
10/1/2019,VA,Virginia,Bristol City,51520,4640,2495,2145,3660,11,3649,980,15,965,4357,2213,2144,3700,1645,2055,1133,138,55,2374
10/1/2019,VA,Virginia,Brunswick,51025,4068,3156,912,3408,33,3375,660,20,640,3787,2875,912,3032,2246,786,1089,128,44,1771
10/1/2019,VA,Virginia,Buchanan,51027,7279,3983,3296,4662,18,4644,2617,21,2596,7019,3724,3295,5955,3487,2468,1705,385,110,3755
10/1/2019,VA,Virginia,Buckingham,51029,3680,3029,651,3034,19,3015,646,18,628,3453,2802,651,2647,2220,427,800,135,41,1671
10/1/2019,VA,Virginia,Buena Vista City,51530,1506,1191,315,1237,*,*,269,*,*,1402,1087,315,1105,840,265,309,52,17,727
10/1/2019,VA,Virginia,Campbell,51031,13233,10512,2721,11079,77,11002,2154,64,2090,12386,9665,2721,10115,7716,2399,2149,356,134,7476
10/1/2019,VA,Virginia,Caroline,51033,6065,4846,1219,5108,34,5074,957,34,923,5463,4244,1219,3756,2694,1062,884,200,45,2627
10/1/2019,VA,Virginia,Carroll,51035,8520,7040,1480,7062,24,7038,1458,15,1443,8071,6592,1479,6353,5183,1170,1631,251,108,4363
10/1/2019,VA,Virginia,Charles City,51036,1962,1480,482,1691,18,1673,271,15,256,1798,1316,482,1374,958,416,264,74,18,1018
10/1/2019,VA,Virginia,Charlotte,51037,3293,2669,624,2705,16,2689,588,17,571,3092,2469,623,2446,1902,544,746,123,41,1536
10/1/2019,VA,Virginia,Charlottesville City,51540,6381,5531,850,5341,27,5314,1040,40,1000,5739,4890,849,4633,3865,768,1275,146,38,3174
10/1/2019,VA,Virginia,Chesapeake City,51550,39432,30368,9064,34173,289,33884,5259,230,5029,35658,26602,9056,22142,14068,8074,4393,912,211,16626
10/1/2019,VA,Virginia,Chesterfield,51041,62306,46403,15903,54871,245,54626,7435,248,7187,56197,40302,15895,43930,29751,14179,5864,1003,278,36785
10/1/2019,VA,Virginia,Clarke,51043,3373,2925,448,3114,12,3102,259,*,*,3048,2600,448,2117,1776,341,287,64,25,1741
10/1/2019,VA,Virginia,Colonial Heights City,51570,4182,3397,785,3590,11,3579,592,12,580,3822,3037,785,2533,1839,694,507,99,21,1906
10/1/2019,VA,Virginia,Covington City,51580,1606,1321,285,1231,15,1216,375,*,*,1503,1218,285,1212,951,261,337,49,15,811
10/1/2019,VA,Virginia,Craig,51045,1378,998,380,1088,*,*,290,*,*,1276,896,380,1025,677,348,223,43,14,745
10/1/2019,VA,Virginia,Culpeper,51047,9624,8073,1551,8408,36,8372,1216,44,1172,8733,7184,1549,6154,4966,1188,1307,210,67,4570
10/1/2019,VA,Virginia,Cumberland,51049,2376,1797,579,1983,13,1970,393,*,*,2209,1630,579,1748,1240,508,456,90,33,1169
10/1/2019,VA,Virginia,Danville City,51590,11037,7703,3334,8738,80,8658,2299,118,2181,10378,7044,3334,8906,6446,2460,3277,374,157,5098
10/1/2019,VA,Virginia,Dickenson,51051,4901,2563,2338,3182,*,*,1719,*,*,4699,2362,2337,3956,1856,2100,1181,195,76,2504
10/1/2019,VA,Virginia,Dinwiddie,51053,6108,4706,1402,4984,36,4948,1124,32,1092,5625,4223,1402,4213,2899,1314,968,183,49,3013
10/1/2019,VA,Virginia,Emporia City,51595,1332,938,394,1046,22,1024,286,11,275,1251,857,394,1019,695,324,461,*,*,482
10/1/2019,VA,Virginia,Essex,51057,3015,2363,652,2588,14,2574,427,15,412,2773,2121,652,2125,1616,509,471,86,36,1532
10/1/2019,VA,Virginia,Fairfax,51059,155681,126638,29043,147409,590,146819,8272,470,7802,125442,96439,29003,75572,50943,24629,14617,2599,567,57789
10/1/2019,VA,Virginia,Fairfax City,51600,3923,3155,768,3662,13,3649,261,14,247,3294,2527,767,2072,1455,617,396,69,19,1588
10/1/2019,VA,Virginia,Falls Church City,51610,2092,1736,356,2011,*,*,81,0,81,1623,1269,354,1036,731,305,127,*,*,895
10/1/2019,VA,Virginia,Fauquier,51061,12960,11421,1539,11853,66,11787,1107,42,1065,11496,9957,1539,7487,6371,1116,1025,175,56,6231
10/1/2019,VA,Virginia,Floyd,51063,4204,3291,913,3652,15,3637,552,*,*,3929,3016,913,3175,2332,843,627,105,45,2398
10/1/2019,VA,Virginia,Fluvanna,51065,6155,5260,895,5523,22,5501,632,19,613,5609,4714,895,4170,3460,710,598,99,26,3447
10/1/2019,VA,Virginia,Franklin,51067,15180,10743,4437,12820,56,12764,2360,34,2326,14259,9824,4435,11700,7746,3954,2101,452,159,8988
10/1/2019,VA,Virginia,Franklin City,51620,2172,1763,409,1757,19,1738,415,19,396,2016,1607,409,1654,1279,375,547,60,19,1028
10/1/2019,VA,Virginia,Frederick,51069,17072,14492,2580,15277,61,15216,1795,48,1747,15541,12965,2576,10834,8807,2027,1492,352,122,8868
10/1/2019,VA,Virginia,Fredericksburg City,51630,4202,3583,619,3476,27,3449,726,23,703,3735,3116,619,2623,2080,543,870,76,39,1638
10/1/2019,VA,Virginia,Galax City,51640,1768,1554,214,1423,*,*,345,*,*,1675,1461,214,1375,1202,173,591,49,24,711
10/1/2019,VA,Virginia,Giles,51071,4619,3531,1088,3683,22,3661,936,15,921,4367,3279,1088,3637,2972,665,855,116,32,2634
10/1/2019,VA,Virginia,Gloucester,51073,8786,7177,1609,7626,40,7586,1160,22,1138,8113,6506,1607,5301,3918,1383,1042,166,49,4044
10/1/2019,VA,Virginia,Goochland,51075,6000,4692,1308,5524,26,5498,476,14,462,5507,4200,1307,4541,3475,1066,411,92,27,4011
10/1/2019,VA,Virginia,Grayson,51077,4580,3621,959,3786,14,3772,794,*,*,4386,3427,959,3393,2545,848,956,172,84,2181
10/1/2019,VA,Virginia,Greene,51079,4040,3466,574,3544,15,3529,496,11,485,3661,3087,574,2706,2207,499,491,73,27,2115
10/1/2019,VA,Virginia,Greensville,51081,2121,1518,603,1716,21,1695,405,15,390,1964,1361,603,1590,1121,469,459,100,25,1006
10/1/2019,VA,Virginia,Halifax,51083,9861,8093,1768,8182,66,8116,1679,49,1630,9228,7460,1768,7452,5897,1555,2196,404,136,4716
10/1/2019,VA,Virginia,Hampton City,51650,25724,18470,7254,21316,212,21104,4408,218,4190,23407,16154,7253,14683,7886,6797,4076,737,174,9696
10/1/2019,VA,Virginia,Hanover,51085,21813,16384,5429,19918,92,19826,1895,53,1842,19810,14383,5427,16130,11655,4475,1554,312,92,14172
10/1/2019,VA,Virginia,Harrisonburg City,51660,5572,4857,715,4734,22,4712,838,23,815,5063,4348,715,4055,3518,537,1041,114,44,2856
10/1/2019,VA,Virginia,Henrico,51087,58081,41671,16410,51170,325,50845,6911,299,6612,52469,36076,16393,43026,28668,14358,6788,1316,382,34540
10/1/2019,VA,Virginia,Henry,51089,14899,10242,4657,11921,75,11846,2978,69,2909,14167,9512,4655,12140,7809,4331,3119,675,224,8122
10/1/2019,VA,Virginia,Highland,51091,802,718,84,731,*,*,71,*,*,758,674,84,566,500,66,62,*,*,478
10/1/2019,VA,Virginia,Hopewell City,51670,4567,3435,1132,3548,34,3514,1019,35,984,4232,3100,1132,3001,1921,1080,1061,130,39,1771
10/1/2019,VA,Virginia,Isle of Wight,51093,8510,6625,1885,7522,54,7468,988,39,949,7859,5974,1885,5568,3854,1714,1029,179,66,4294
10/1/2019,VA,Virginia,James City,51095,21230,18009,3221,19978,55,19923,1252,50,1202,19633,16416,3217,12748,10352,2396,963,223,63,11499
10/1/2019,VA,Virginia,King and Queen,51097,1811,1456,355,1538,11,1527,273,*,*,1685,1330,355,1275,967,308,293,*,*,911
10/1/2019,VA,Virginia,King George,51099,4055,3642,413,3521,14,3507,534,26,508,3525,3112,413,1767,1425,342,470,60,17,1220
10/1/2019,VA,Virginia,King William,51101,3522,2889,633,3018,23,2995,504,26,478,3243,2610,633,2617,2076,541,428,103,22,2064
10/1/2019,VA,Virginia,Lancaster,51103,4391,3735,656,4057,21,4036,334,18,316,4150,3495,655,3049,2626,423,515,94,14,2426
10/1/2019,VA,Virginia,Lee,51105,6436,3389,3047,4496,12,4484,1940,17,1923,6124,3079,3045,5056,2280,2776,1993,241,78,2744
10/1/2019,VA,Virginia,Lexington City,51678,1380,1207,173,1267,*,*,113,*,*,1257,1085,172,971,831,140,179,32,13,747
10/1/2019,VA,Virginia,Loudoun,51107,39691,32347,7344,37245,169,37076,2446,123,2323,32911,25574,7337,22191,15961,6230,3460,622,143,17966
10/1/2019,VA,Virginia,Louisa,51109,8442,6750,1692,7161,42,7119,1281,40,1241,7726,6034,1692,5780,4327,1453,1126,242,65,4347
10/1/2019,VA,Virginia,Lunenburg,51111,3130,2611,519,2588,15,2573,542,15,527,2894,2375,519,2225,1765,460,743,109,40,1333
10/1/2019,VA,Virginia,Lynchburg City,51680,14619,11581,3038,12023,88,11935,2596,105,2491,13572,10537,3035,11129,8420,2709,3051,435,136,7507
10/1/2019,VA,Virginia,Madison,51113,3317,2789,528,2961,13,2948,356,13,343,3084,2556,528,2296,1887,409,438,80,18,1760
10/1/2019,VA,Virginia,Manassas City,51683,4697,3723,974,4174,21,4153,523,43,480,3952,2978,974,2764,1928,836,569,77,30,2088
10/1/2019,VA,Virginia,Manassas Park City,51685,1343,1004,339,1169,17,1152,174,13,161,1123,784,339,801,491,310,202,*,*,537
10/1/2019,VA,Virginia,Martinsville City,51690,3852,2697,1155,2904,37,2867,948,38,910,3651,2497,1154,3141,2035,1106,1315,157,53,1616
10/1/2019,VA,Virginia,Mathews,51115,2890,2395,495,2642,*,*,248,*,*,2732,2237,495,1938,1535,403,294,34,18,1592
10/1/2019,VA,Virginia,Mecklenburg,51117,9283,7279,2004,7765,54,7711,1518,69,1449,8701,6698,2003,6897,5219,1678,1843,350,89,4615
10/1/2019,VA,Virginia,Middlesex,51119,3637,3031,606,3274,14,3260,363,*,*,3415,2809,606,2626,2170,456,465,76,29,2056
10/1/2019,VA,Virginia,Montgomery,51121,14283,11396,2887,11985,49,11936,2298,32,2266,12861,9975,2886,10769,8201,2568,1988,325,122,8334
10/1/2019,VA,Virginia,Nelson,51125,4707,3953,754,4217,15,4202,490,12,478,4347,3594,753,3233,2595,638,594,100,44,2495
10/1/2019,VA,Virginia,New Kent,51127,4748,3847,901,4279,17,4262,469,*,*,4311,3411,900,3082,2391,691,325,66,20,2671
10/1/2019,VA,Virginia,Newport News City,51700,28863,20557,8306,23873,211,23662,4990,251,4739,26360,18059,8301,17560,9705,7855,5144,838,203,11375
10/1/2019,VA,Virginia,Norfolk City,51710,33713,24085,9628,27210,276,26934,6503,328,6175,30269,20646,9623,20781,11640,9141,7571,1255,280,11675
10/1/2019,VA,Virginia,Northampton,51131,3776,3006,770,3288,24,3264,488,21,467,3517,2748,769,2831,2181,650,933,84,27,1787
10/1/2019,VA,Virginia,Northumberland,51133,4671,3946,725,4334,13,4321,337,14,323,4372,3647,725,2951,2524,427,444,70,27,2410
10/1/2019,VA,Virginia,Norton City,51720,1156,679,477,793,*,*,363,*,*,1073,596,477,897,465,432,358,41,12,486
10/1/2019,VA,Virginia,Nottoway,51135,3643,2952,691,2998,25,2973,645,14,631,3381,2690,691,2636,2109,527,880,118,43,1595
10/1/2019,VA,Virginia,Orange,51137,8851,7573,1278,7839,53,7786,1012,30,982,8069,6792,1277,5449,4579,870,1007,180,63,4199
10/1/2019,VA,Virginia,Page,51139,6240,5296,944,5179,24,5155,1061,23,1038,5816,4872,944,4308,3517,791,1101,232,77,2898
10/1/2019,VA,Virginia,Patrick,51141,5483,4138,1345,4569,*,*,914,12,902,5197,3853,1344,4251,3146,1105,1096,182,73,2900
10/1/2019,VA,Virginia,Petersburg City,51730,7222,5030,2192,5404,80,5324,1818,75,1743,6594,4404,2190,4944,2826,2118,2166,326,68,2384
10/1/2019,VA,Virginia,Pittsylvania,51143,16581,11802,4779,13699,87,13612,2882,74,2808,15587,10808,4779,13041,9460,3581,3131,525,180,9205
10/1/2019,VA,Virginia,Poquoson City,51735,2640,2302,338,2455,*,*,185,*,*,2423,2086,337,1258,967,291,124,25,12,1097
10/1/2019,VA,Virginia,Portsmouth City,51740,18534,13234,5300,14541,175,14366,3993,200,3793,16559,11263,5296,11214,6180,5034,4161,671,145,6237
10/1/2019,VA,Virginia,Powhatan,51145,6288,4916,1372,5683,19,5664,605,19,586,5765,4393,1372,4663,3494,1169,428,109,27,4099
10/1/2019,VA,Virginia,Prince Edward,51147,4697,3860,837,3820,42,3778,877,30,847,4349,3512,837,3400,2776,624,1087,146,52,2115
10/1/2019,VA,Virginia,Prince George,51149,6221,5312,909,5275,29,5246,946,32,914,5750,4842,908,3545,2742,803,601,120,27,2797
10/1/2019,VA,Virginia,Prince William,51153,50714,40387,10327,45550,297,45253,5164,301,4863,43171,32856,10315,25412,16275,9137,5465,1062,226,18659
10/1/2019,VA,Virginia,Pulaski,51155,9237,7228,2009,7441,29,7412,1796,32,1764,8600,6592,2008,7107,5361,1746,1634,282,106,5085
10/1/2019,VA,Virginia,Radford City,51750,2063,1626,437,1685,*,*,378,*,*,1871,1434,437,1594,1201,393,345,38,23,1188
10/1/2019,VA,Virginia,Rappahannock,51157,1967,1767,200,1837,*,*,130,*,*,1774,1575,199,1216,1074,142,150,*,*,1021
10/1/2019,VA,Virginia,Richmond,51159,1960,1572,388,1716,*,*,244,12,232,1821,1434,387,1356,1102,254,313,61,14,968
10/1/2019,VA,Virginia,Richmond City,51760,34911,22610,12301,28072,271,27801,6839,313,6526,31368,19079,12289,26774,15115,11659,9178,1285,287,16024
10/1/2019,VA,Virginia,Roanoke,51161,23901,17905,5996,21277,95,21182,2624,64,2560,22040,16047,5993,17974,12875,5099,2207,415,139,15213
10/1/2019,VA,Virginia,Roanoke City,51770,21392,14696,6696,16428,145,16283,4964,146,4818,19434,12744,6690,15993,9828,6165,5039,834,214,9906
10/1/2019,VA,Virginia,Rockbridge,51163,6384,5285,1099,5482,*,*,902,*,*,5920,4821,1099,4479,3564,915,881,178,55,3365
10/1/2019,VA,Virginia,Rockingham,51165,18121,15471,2650,15970,47,15923,2151,41,2110,16758,14109,2649,13193,11305,1888,1925,475,139,10654
10/1/2019,VA,Virginia,Russell,51167,7991,4712,3279,5613,14,5599,2378,21,2357,7662,4385,3277,6579,3897,2682,1732,326,144,4377
10/1/2019,VA,Virginia,Salem City,51775,6096,4716,1380,5165,26,5139,931,18,913,5626,4246,1380,4560,3329,1231,865,124,37,3534
10/1/2019,VA,Virginia,Scott,51169,6793,3105,3688,5198,13,5185,1595,17,1578,6519,2834,3685,5697,2150,3547,1560,236,105,3796
10/1/2019,VA,Virginia,Shenandoah,51171,10727,9056,1671,9558,37,9521,1169,24,1145,10014,8343,1671,7236,5891,1345,1318,257,89,5572
10/1/2019,VA,Virginia,Smyth,51173,8670,6027,2643,6554,35,6519,2116,30,2086,8228,5585,2643,6822,4392,2430,2122,363,121,4216
10/1/2019,VA,Virginia,Southampton,51175,4006,3277,729,3363,32,3331,643,26,617,3714,2985,729,2940,2299,641,742,108,34,2056
10/1/2019,VA,Virginia,Spotsylvania,51177,21884,18798,3086,19169,113,19056,2715,103,2612,19411,16327,3084,11799,9349,2450,2106,511,135,9047
10/1/2019,VA,Virginia,Stafford,51179,18331,16168,2163,16242,103,16139,2089,84,2005,16048,13889,2159,8204,6457,1747,1533,355,87,6229
10/1/2019,VA,Virginia,Staunton City,51790,6305,5300,1005,5290,20,5270,1015,15,1000,5930,4925,1005,4713,3874,839,1132,153,52,3376
10/1/2019,VA,Virginia,Suffolk City,51800,16948,12950,3998,14000,120,13880,2948,114,2834,15503,11507,3996,10676,7036,3640,2877,451,112,7236
10/1/2019,VA,Virginia,Surry,51181,1735,1334,401,1495,*,*,240,*,*,1597,1196,401,1174,804,370,226,57,11,880
10/1/2019,VA,Virginia,Sussex,51183,2538,1892,646,2096,33,2063,442,*,*,2368,1722,646,1843,1234,609,548,136,22,1137
10/1/2019,VA,Virginia,Tazewell,51185,12022,7798,4224,8961,34,8927,3061,39,3022,11419,7196,4223,9177,6153,3024,2339,461,163,6214
10/1/2019,VA,Virginia,Unknown,51999,*,*,*,*,*,*,*,*,*,*,*,*,*,*,*,*,*,*,*
10/1/2019,VA,Virginia,Virginia Beach City,51810,74339,59621,14718,65909,382,65527,8430,347,8083,68037,53335,14702,39752,26471,13281,7216,1476,399,30661
10/1/2019,VA,Virginia,Warren,51187,7876,6805,1071,6809,25,6784,1067,35,1032,7159,6089,1070,4922,4073,849,977,211,70,3664
10/1/2019,VA,Virginia,Washington,51191,15078,9291,5787,12309,44,12265,2769,34,2735,14230,8445,5785,11850,6565,5285,2468,517,200,8665
10/1/2019,VA,Virginia,Waynesboro City,51820,5010,4188,822,4145,18,4127,865,22,843,4663,3841,822,3715,2987,728,957,111,44,2603
10/1/2019,VA,Virginia,Westmoreland,51193,5112,4415,697,4499,22,4477,613,17,596,4650,3953,697,3016,2446,570,802,131,47,2036
10/1/2019,VA,Virginia,Williamsburg City,51830,2748,2262,486,2530,*,*,218,*,*,2534,2048,486,1823,1428,395,259,*,*,1528
10/1/2019,VA,Virginia,Winchester City,51840,5544,4715,829,4780,28,4752,764,21,743,5031,4202,829,3689,3007,682,905,135,44,2605
10/1/2019,VA,Virginia,Wise,51195,10698,5810,4888,7307,24,7283,3391,27,3364,10108,5220,4888,8226,3865,4361,2528,457,179,5062
10/1/2019,VA,Virginia,Wythe,51197,7992,5853,2139,6302,36,6266,1690,17,1673,7535,5397,2138,6175,4308,1867,1698,285,115,4077
10/1/2019,VA,Virginia,York,51199,12337,10529,1808,11336,38,11298,1001,35,966,11281,9474,1807,6139,4599,1540,725,153,36,5225
9/1/2019,VA,Virginia,Accomack,51001,9018,7428,1590,7830,51,7779,1188,42,1146,8346,6757,1589,6181,4931,1250,1545,356,90,4190
9/1/2019,VA,Virginia,Albemarle,51003,21470,18863,2607,19922,68,19854,1548,41,1507,19322,16719,2603,14937,12762,2175,1595,290,99,12953
9/1/2019,VA,Virginia,Alexandria City,51510,18290,15189,3101,16933,72,16861,1357,85,1272,14733,11635,3098,9058,6304,2754,2164,284,63,6547
9/1/2019,VA,Virginia,Alleghany,51005,4577,3789,788,3730,18,3712,847,13,834,4353,3565,788,3525,2882,643,829,103,50,2543
9/1/2019,VA,Virginia,Amelia,51007,3110,2290,820,2650,*,*,460,18,442,2868,2048,820,2299,1541,758,479,92,37,1691
9/1/2019,VA,Virginia,Amherst,51009,7913,6248,1665,6618,48,6570,1295,28,1267,7366,5701,1665,6012,4534,1478,1264,209,73,4466
9/1/2019,VA,Virginia,Appomattox,51011,3953,3165,788,3263,18,3245,690,21,669,3719,2931,788,3022,2316,706,695,89,42,2196
9/1/2019,VA,Virginia,Arlington,51013,24987,21174,3813,23407,95,23312,1580,87,1493,19651,15842,3809,12018,8594,3424,3001,357,109,8551
9/1/2019,VA,Virginia,Augusta,51015,18538,15635,2903,16126,53,16073,2412,49,2363,17383,14481,2902,13531,11100,2431,1901,388,143,11099
9/1/2019,VA,Virginia,Bath,51017,1272,1154,118,1116,*,*,156,*,*,1208,1090,118,945,848,97,151,34,17,743
9/1/2019,VA,Virginia,Bedford,51019,19985,16092,3893,17267,84,17183,2718,48,2670,18611,14721,3890,14688,11847,2841,2057,463,149,12019
9/1/2019,VA,Virginia,Bland,51021,1805,1344,461,1438,*,*,367,*,*,1702,1241,461,1327,1003,324,234,53,17,1023
9/1/2019,VA,Virginia,Botetourt,51023,8792,6596,2196,7724,46,7678,1068,22,1046,8185,5989,2196,6509,4650,1859,738,158,51,5562
9/1/2019,VA,Virginia,Bristol City,51520,4633,2499,2134,3659,11,3648,974,15,959,4355,2222,2133,3694,1650,2044,1120,141,56,2377
9/1/2019,VA,Virginia,Brunswick,51025,4061,3153,908,3401,34,3367,660,20,640,3782,2874,908,3025,2242,783,1079,129,42,1775
9/1/2019,VA,Virginia,Buchanan,51027,7272,3985,3287,4666,19,4647,2606,21,2585,7012,3726,3286,5945,3485,2460,1692,386,111,3756
9/1/2019,VA,Virginia,Buckingham,51029,3670,3023,647,3029,19,3010,641,18,623,3441,2794,647,2636,2215,421,798,135,40,1663
9/1/2019,VA,Virginia,Buena Vista City,51530,1498,1183,315,1231,*,*,267,*,*,1397,1082,315,1100,835,265,307,51,17,725
9/1/2019,VA,Virginia,Campbell,51031,13185,10493,2692,11039,77,10962,2146,63,2083,12354,9662,2692,10084,7714,2370,2131,358,136,7459
9/1/2019,VA,Virginia,Caroline,51033,6058,4845,1213,5100,35,5065,958,35,923,5457,4244,1213,3754,2698,1056,884,201,46,2623
9/1/2019,VA,Virginia,Carroll,51035,8501,7028,1473,7056,25,7031,1445,15,1430,8054,6581,1473,6341,5179,1162,1621,253,111,4356
9/1/2019,VA,Virginia,Charles City,51036,1959,1480,479,1689,18,1671,270,15,255,1797,1318,479,1374,960,414,265,74,18,1017
9/1/2019,VA,Virginia,Charlotte,51037,3281,2655,626,2697,16,2681,584,16,568,3080,2455,625,2437,1892,545,744,123,41,1529
9/1/2019,VA,Virginia,Charlottesville City,51540,6358,5527,831,5330,27,5303,1028,40,988,5710,4880,830,4602,3853,749,1260,144,37,3161
9/1/2019,VA,Virginia,Chesapeake City,51550,39309,30292,9017,34072,289,33783,5237,231,5006,35558,26549,9009,22085,14059,8026,4372,916,208,16589
9/1/2019,VA,Virginia,Chesterfield,51041,62128,46271,15857,54716,249,54467,7412,247,7165,56042,40193,15849,43789,29656,14133,5806,1002,274,36707
9/1/2019,VA,Virginia,Clarke,51043,3365,2915,450,3104,13,3091,261,*,*,3040,2590,450,2112,1769,343,284,64,26,1738
9/1/2019,VA,Virginia,Colonial Heights City,51570,4173,3388,785,3587,11,3576,586,13,573,3818,3033,785,2526,1833,693,502,100,21,1903
9/1/2019,VA,Virginia,Covington City,51580,1601,1323,278,1229,15,1214,372,*,*,1497,1219,278,1207,954,253,334,48,15,810
9/1/2019,VA,Virginia,Craig,51045,1372,995,377,1082,*,*,290,*,*,1271,894,377,1022,676,346,220,43,14,745
9/1/2019,VA,Virginia,Culpeper,51047,9615,8071,1544,8403,38,8365,1212,44,1168,8722,7180,1542,6144,4964,1180,1303,212,66,4563
9/1/2019,VA,Virginia,Cumberland,51049,2371,1800,571,1979,13,1966,392,*,*,2208,1637,571,1742,1243,499,452,90,35,1165
9/1/2019,VA,Virginia,Danville City,51590,11023,7732,3291,8732,82,8650,2291,119,2172,10372,7081,3291,8892,6472,2420,3257,373,157,5105
9/1/2019,VA,Virginia,Dickenson,51051,4897,2578,2319,3183,*,*,1714,*,*,4695,2377,2318,3954,1872,2082,1179,196,77,2502
9/1/2019,VA,Virginia,Dinwiddie,51053,6098,4697,1401,4978,37,4941,1120,32,1088,5622,4221,1401,4214,2902,1312,967,182,49,3016
9/1/2019,VA,Virginia,Emporia City,51595,1336,944,392,1050,22,1028,286,11,275,1254,862,392,1021,697,324,463,*,*,481
9/1/2019,VA,Virginia,Essex,51057,3016,2366,650,2590,15,2575,426,15,411,2776,2126,650,2122,1615,507,469,86,34,1533
9/1/2019,VA,Virginia,Fairfax,51059,155039,126169,28870,146795,605,146190,8244,470,7774,125069,96239,28830,75282,50821,24461,14543,2599,569,57571
9/1/2019,VA,Virginia,Fairfax City,51600,3901,3138,763,3640,13,3627,261,13,248,3277,2515,762,2058,1444,614,393,69,19,1577
9/1/2019,VA,Virginia,Falls Church City,51610,2087,1732,355,2005,*,*,82,0,82,1621,1268,353,1033,729,304,124,*,*,895
9/1/2019,VA,Virginia,Fauquier,51061,12905,11372,1533,11803,67,11736,1102,41,1061,11451,9918,1533,7446,6332,1114,1018,176,56,6196
9/1/2019,VA,Virginia,Floyd,51063,4191,3285,906,3640,15,3625,551,*,*,3920,3014,906,3161,2325,836,617,104,46,2394
9/1/2019,VA,Virginia,Fluvanna,51065,6143,5251,892,5514,22,5492,629,20,609,5591,4699,892,4158,3451,707,594,101,27,3436
9/1/2019,VA,Virginia,Franklin,51067,15161,10739,4422,12810,57,12753,2351,33,2318,14246,9826,4420,11687,7748,3939,2090,450,159,8988
9/1/2019,VA,Virginia,Franklin City,51620,2167,1765,402,1754,19,1735,413,19,394,2015,1613,402,1650,1283,367,542,59,19,1030
9/1/2019,VA,Virginia,Frederick,51069,17031,14444,2587,15241,62,15179,1790,49,1741,15514,12931,2583,10797,8764,2033,1479,355,120,8843
9/1/2019,VA,Virginia,Fredericksburg City,51630,4191,3579,612,3464,27,3437,727,23,704,3733,3121,612,2616,2079,537,859,77,39,1641
9/1/2019,VA,Virginia,Galax City,51640,1768,1558,210,1424,*,*,344,*,*,1673,1463,210,1374,1206,168,587,50,24,713
9/1/2019,VA,Virginia,Giles,51071,4626,3538,1088,3691,22,3669,935,15,920,4372,3284,1088,3642,2979,663,851,117,33,2641
9/1/2019,VA,Virginia,Gloucester,51073,8763,7162,1601,7609,40,7569,1154,23,1131,8094,6495,1599,5278,3904,1374,1032,169,50,4027
9/1/2019,VA,Virginia,Goochland,51075,5987,4682,1305,5515,26,5489,472,14,458,5496,4192,1304,4530,3466,1064,407,92,27,4004
9/1/2019,VA,Virginia,Grayson,51077,4575,3623,952,3785,15,3770,790,*,*,4382,3430,952,3393,2550,843,955,169,83,2186
9/1/2019,VA,Virginia,Greene,51079,4033,3464,569,3539,15,3524,494,11,483,3645,3076,569,2689,2196,493,484,74,26,2105
9/1/2019,VA,Virginia,Greensville,51081,2117,1519,598,1713,21,1692,404,15,389,1962,1364,598,1590,1124,466,457,99,24,1010
9/1/2019,VA,Virginia,Halifax,51083,9842,8079,1763,8167,67,8100,1675,50,1625,9217,7454,1763,7441,5892,1549,2178,410,138,4715
9/1/2019,VA,Virginia,Hampton City,51650,25628,18414,7214,21237,214,21023,4391,214,4177,23311,16097,7214,14610,7853,6757,4030,739,175,9666
9/1/2019,VA,Virginia,Hanover,51085,21754,16334,5420,19871,93,19778,1883,54,1829,19757,14339,5418,16097,11632,4465,1550,315,93,14139
9/1/2019,VA,Virginia,Harrisonburg City,51660,5563,4852,711,4729,22,4707,834,25,809,5055,4344,711,4050,3519,531,1028,118,42,2862
9/1/2019,VA,Virginia,Henrico,51087,57907,41560,16347,51018,330,50688,6889,297,6592,52351,36020,16331,42913,28620,14293,6749,1321,380,34463
9/1/2019,VA,Virginia,Henry,51089,14883,10260,4623,11908,75,11833,2975,68,2907,14142,9521,4621,12123,7829,4294,3096,686,224,8117
9/1/2019,VA,Virginia,Highland,51091,800,717,83,729,*,*,71,*,*,757,674,83,566,500,66,61,*,*,478
9/1/2019,VA,Virginia,Hopewell City,51670,4567,3436,1131,3551,35,3516,1016,35,981,4229,3098,1131,2998,1919,1079,1044,136,38,1780
9/1/2019,VA,Virginia,Isle of Wight,51093,8492,6613,1879,7510,55,7455,982,40,942,7848,5969,1879,5562,3856,1706,1024,184,66,4288
9/1/2019,VA,Virginia,James City,51095,21189,17986,3203,19946,56,19890,1243,51,1192,19600,16401,3199,12718,10339,2379,953,222,61,11482
9/1/2019,VA,Virginia,King and Queen,51097,1810,1455,355,1536,11,1525,274,*,*,1682,1327,355,1278,968,310,293,*,*,909
9/1/2019,VA,Virginia,King George,51099,4033,3627,406,3507,14,3493,526,26,500,3506,3100,406,1752,1417,335,460,62,17,1213
9/1/2019,VA,Virginia,King William,51101,3516,2883,633,3014,23,2991,502,26,476,3238,2605,633,2609,2068,541,429,102,22,2056
9/1/2019,VA,Virginia,Lancaster,51103,4384,3726,658,4051,21,4030,333,18,315,4145,3488,657,3056,2630,426,513,95,14,2434
9/1/2019,VA,Virginia,Lee,51105,6433,3388,3045,4497,13,4484,1936,18,1918,6117,3074,3043,5049,2276,2773,1986,240,76,2747
9/1/2019,VA,Virginia,Lexington City,51678,1384,1213,171,1268,*,*,116,*,*,1264,1094,170,976,838,138,178,33,13,752
9/1/2019,VA,Virginia,Loudoun,51107,39515,32195,7320,37084,171,36913,2431,122,2309,32804,25491,7313,22126,15919,6207,3437,622,140,17927
9/1/2019,VA,Virginia,Louisa,51109,8424,6736,1688,7144,46,7098,1280,40,1240,7723,6035,1688,5778,4329,1449,1121,240,66,4351
9/1/2019,VA,Virginia,Lunenburg,51111,3123,2605,518,2584,16,2568,539,15,524,2881,2363,518,2216,1757,459,743,108,37,1328
9/1/2019,VA,Virginia,Lynchburg City,51680,14630,11614,3016,12040,89,11951,2590,106,2484,13577,10564,3013,11130,8448,2682,3031,437,137,7525
9/1/2019,VA,Virginia,Madison,51113,3310,2788,522,2954,13,2941,356,14,342,3076,2554,522,2289,1885,404,435,80,18,1756
9/1/2019,VA,Virginia,Manassas City,51683,4689,3718,971,4168,21,4147,521,43,478,3950,2979,971,2764,1930,834,566,82,30,2086
9/1/2019,VA,Virginia,Manassas Park City,51685,1331,997,334,1158,17,1141,173,14,159,1115,781,334,799,494,305,201,*,*,538
9/1/2019,VA,Virginia,Martinsville City,51690,3860,2719,1141,2909,37,2872,951,38,913,3658,2518,1140,3147,2055,1092,1311,159,53,1624
9/1/2019,VA,Virginia,Mathews,51115,2887,2394,493,2640,*,*,247,*,*,2727,2234,493,1934,1533,401,290,35,19,1590
9/1/2019,VA,Virginia,Mecklenburg,51117,9265,7270,1995,7756,56,7700,1509,67,1442,8684,6690,1994,6885,5217,1668,1834,344,91,4616
9/1/2019,VA,Virginia,Middlesex,51119,3635,3027,608,3271,14,3257,364,*,*,3419,2811,608,2625,2168,457,465,76,29,2055
9/1/2019,VA,Virginia,Montgomery,51121,14248,11379,2869,11962,50,11912,2286,32,2254,12833,9965,2868,10750,8199,2551,1970,333,121,8326
9/1/2019,VA,Virginia,Nelson,51125,4701,3948,753,4212,16,4196,489,12,477,4341,3589,752,3226,2590,636,591,99,44,2492
9/1/2019,VA,Virginia,New Kent,51127,4721,3821,900,4254,17,4237,467,11,456,4289,3390,899,3073,2384,689,321,67,20,2665
9/1/2019,VA,Virginia,Newport News City,51700,28794,20517,8277,23826,214,23612,4968,249,4719,26315,18043,8272,17528,9706,7822,5107,851,205,11365
9/1/2019,VA,Virginia,Norfolk City,51710,33638,24065,9573,27168,280,26888,6470,330,6140,30243,20675,9568,20739,11651,9088,7524,1265,285,11665
9/1/2019,VA,Virginia,Northampton,51131,3760,2991,769,3271,25,3246,489,21,468,3501,2733,768,2822,2172,650,931,83,26,1782
9/1/2019,VA,Virginia,Northumberland,51133,4662,3939,723,4326,14,4312,336,14,322,4364,3641,723,2944,2519,425,439,69,27,2409
9/1/2019,VA,Virginia,Norton City,51720,1158,686,472,796,*,*,362,*,*,1075,603,472,897,471,426,357,42,12,486
9/1/2019,VA,Virginia,Nottoway,51135,3641,2947,694,2998,25,2973,643,15,628,3380,2686,694,2636,2111,525,873,119,43,1601
9/1/2019,VA,Virginia,Orange,51137,8839,7565,1274,7826,53,7773,1013,31,982,8059,6786,1273,5440,4572,868,1004,180,63,4193
9/1/2019,VA,Virginia,Page,51139,6233,5293,940,5173,24,5149,1060,23,1037,5816,4876,940,4317,3530,787,1103,230,78,2906
9/1/2019,VA,Virginia,Patrick,51141,5481,4128,1353,4570,*,*,911,13,898,5189,3838,1351,4247,3134,1113,1092,180,72,2903
9/1/2019,VA,Virginia,Petersburg City,51730,7200,5016,2184,5395,81,5314,1805,75,1730,6579,4397,2182,4929,2817,2112,2146,328,68,2387
9/1/2019,VA,Virginia,Pittsylvania,51143,16557,11819,4738,13670,88,13582,2887,75,2812,15573,10835,4738,13024,9485,3539,3114,529,184,9197
9/1/2019,VA,Virginia,Poquoson City,51735,2633,2293,340,2448,*,*,185,*,*,2419,2080,339,1255,962,293,121,26,12,1096
9/1/2019,VA,Virginia,Portsmouth City,51740,18518,13232,5286,14525,183,14342,3993,207,3786,16557,11276,5281,11200,6181,5019,4123,680,144,6253
9/1/2019,VA,Virginia,Powhatan,51145,6267,4899,1368,5663,19,5644,604,19,585,5750,4382,1368,4648,3483,1165,419,112,27,4090
9/1/2019,VA,Virginia,Prince Edward,51147,4695,3859,836,3820,42,3778,875,30,845,4354,3518,836,3401,2775,626,1087,146,52,2116
9/1/2019,VA,Virginia,Prince George,51149,6215,5303,912,5270,30,5240,945,34,911,5749,4838,911,3535,2729,806,595,121,27,2792
9/1/2019,VA,Virginia,Prince William,51153,50485,40192,10293,45337,302,45035,5148,300,4848,43026,32745,10281,25344,16243,9101,5435,1064,225,18620
9/1/2019,VA,Virginia,Pulaski,51155,9229,7220,2009,7438,30,7408,1791,33,1758,8597,6589,2008,7112,5368,1744,1632,284,107,5089
9/1/2019,VA,Virginia,Radford City,51750,2058,1621,437,1680,*,*,378,*,*,1869,1432,437,1593,1202,391,344,38,22,1189
9/1/2019,VA,Virginia,Rappahannock,51157,1963,1763,200,1833,*,*,130,*,*,1770,1571,199,1218,1077,141,147,*,*,1026
9/1/2019,VA,Virginia,Richmond,51159,1956,1566,390,1713,*,*,243,13,230,1820,1431,389,1356,1102,254,310,62,14,970
9/1/2019,VA,Virginia,Richmond City,51760,34867,22617,12250,28034,275,27759,6833,318,6515,31339,19101,12238,26714,15109,11605,9116,1287,286,16025
9/1/2019,VA,Virginia,Roanoke,51161,23843,17858,5985,21234,98,21136,2609,64,2545,21999,16017,5982,17936,12846,5090,2188,415,137,15196
9/1/2019,VA,Virginia,Roanoke City,51770,21349,14693,6656,16401,148,16253,4948,145,4803,19403,12753,6650,15966,9842,6124,4982,852,213,9919
9/1/2019,VA,Virginia,Rockbridge,51163,6379,5289,1090,5483,*,*,896,*,*,5921,4831,1090,4478,3573,905,877,179,55,3367
9/1/2019,VA,Virginia,Rockingham,51165,18088,15438,2650,15947,46,15901,2141,41,2100,16700,14051,2649,13153,11270,1883,1910,482,139,10622
9/1/2019,VA,Virginia,Russell,51167,7987,4718,3269,5615,14,5601,2372,21,2351,7657,4390,3267,6571,3896,2675,1722,324,145,4380
9/1/2019,VA,Virginia,Salem City,51775,6100,4729,1371,5166,26,5140,934,18,916,5631,4260,1371,4555,3333,1222,858,127,37,3533
9/1/2019,VA,Virginia,Scott,51169,6786,3095,3691,5196,13,5183,1590,18,1572,6513,2825,3688,5696,2147,3549,1557,235,104,3800
9/1/2019,VA,Virginia,Shenandoah,51171,10712,9053,1659,9546,37,9509,1166,24,1142,10011,8352,1659,7218,5886,1332,1301,256,88,5573
9/1/2019,VA,Virginia,Smyth,51173,8669,6036,2633,6559,35,6524,2110,29,2081,8234,5601,2633,6820,4401,2419,2116,371,123,4210
9/1/2019,VA,Virginia,Southampton,51175,4003,3272,731,3361,32,3329,642,26,616,3710,2979,731,2942,2301,641,739,110,34,2059
9/1/2019,VA,Virginia,Spotsylvania,51177,21805,18730,3075,19105,114,18991,2700,102,2598,19360,16287,3073,11774,9334,2440,2099,509,133,9033
9/1/2019,VA,Virginia,Stafford,51179,18253,16091,2162,16171,103,16068,2082,85,1997,15988,13830,2158,8185,6445,1740,1516,358,85,6226
9/1/2019,VA,Virginia,Staunton City,51790,6296,5298,998,5286,21,5265,1010,15,995,5916,4918,998,4693,3864,829,1115,155,52,3371
9/1/2019,VA,Virginia,Suffolk City,51800,16898,12920,3978,13971,119,13852,2927,113,2814,15464,11488,3976,10653,7036,3617,2854,451,113,7235
9/1/2019,VA,Virginia,Surry,51181,1728,1333,395,1493,*,*,235,*,*,1590,1195,395,1166,802,364,224,57,12,873
9/1/2019,VA,Virginia,Sussex,51183,2536,1892,644,2094,34,2060,442,*,*,2365,1721,644,1834,1227,607,544,138,21,1131
9/1/2019,VA,Virginia,Tazewell,51185,12013,7798,4215,8958,35,8923,3055,39,3016,11413,7199,4214,9160,6140,3020,2317,463,161,6219
9/1/2019,VA,Virginia,Unknown,51999,*,*,*,*,*,*,*,*,*,*,*,*,*,*,*,*,*,*,*
9/1/2019,VA,Virginia,Virginia Beach City,51810,74121,59468,14653,65724,398,65326,8397,343,8054,67850,53213,14637,39656,26442,13214,7170,1487,396,30603
9/1/2019,VA,Virginia,Warren,51187,7865,6797,1068,6801,26,6775,1064,35,1029,7157,6090,1067,4918,4075,843,968,212,72,3666
9/1/2019,VA,Virginia,Washington,51191,15063,9290,5773,12300,44,12256,2763,34,2729,14212,8441,5771,11829,6560,5269,2455,515,198,8661
9/1/2019,VA,Virginia,Waynesboro City,51820,5015,4196,819,4153,18,4135,862,22,840,4672,3853,819,3711,2988,723,948,111,44,2608
9/1/2019,VA,Virginia,Westmoreland,51193,5103,4406,697,4493,23,4470,610,16,594,4641,3944,697,3004,2434,570,787,133,47,2037
9/1/2019,VA,Virginia,Williamsburg City,51830,2741,2256,485,2522,*,*,219,*,*,2530,2045,485,1817,1424,393,257,*,*,1523
9/1/2019,VA,Virginia,Winchester City,51840,5527,4708,819,4767,28,4739,760,21,739,5020,4201,819,3673,3003,670,893,135,44,2601
9/1/2019,VA,Virginia,Wise,51195,10687,5820,4867,7304,24,7280,3383,27,3356,10097,5231,4866,8211,3874,4337,2507,458,182,5064
9/1/2019,VA,Virginia,Wythe,51197,7973,5841,2132,6285,36,6249,1688,17,1671,7528,5397,2131,6162,4306,1856,1690,285,114,4073
9/1/2019,VA,Virginia,York,51199,12297,10496,1801,11307,40,11267,990,34,956,11238,9438,1800,6121,4588,1533,722,155,36,5208
4/1/2020,VA,Virginia,Accomack,51001,9143,7285,1858,7997,60,7937,1146,42,1104,8472,6615,1857,6365,4858,1507,1539,362,81,4383
4/1/2020,VA,Virginia,Albemarle,51003,22024,19125,2899,20522,70,20452,1502,37,1465,19832,16936,2896,15513,13062,2451,1604,281,98,13530
4/1/2020,VA,Virginia,Alexandria City,51510,18331,14817,3514,17047,77,16970,1284,74,1210,14756,11244,3512,9371,6212,3159,2141,305,62,6863
4/1/2020,VA,Virginia,Alleghany,51005,4639,3687,952,3805,23,3782,834,13,821,4385,3433,952,3611,2797,814,838,108,47,2618
4/1/2020,VA,Virginia,Amelia,51007,3147,2202,945,2699,*,*,448,15,433,2898,1953,945,2354,1474,880,471,84,26,1773
4/1/2020,VA,Virginia,Amherst,51009,7951,5957,1994,6706,53,6653,1245,31,1214,7413,5419,1994,6128,4327,1801,1242,202,69,4615
4/1/2020,VA,Virginia,Appomattox,51011,4044,3078,966,3379,21,3358,665,23,642,3792,2826,966,3146,2265,881,698,95,45,2308
4/1/2020,VA,Virginia,Arlington,51013,25106,20753,4353,23585,105,23480,1521,78,1443,19767,15414,4353,12437,8500,3937,3013,378,118,8928
4/1/2020,VA,Virginia,Augusta,51015,18768,15408,3360,16431,69,16362,2337,53,2284,17601,14241,3360,13961,11064,2897,1911,402,130,11518
4/1/2020,VA,Virginia,Bath,51017,1280,1131,149,1125,*,*,155,0,155,1214,1065,149,972,842,130,163,*,*,762
4/1/2020,VA,Virginia,Bedford,51019,20300,15962,4338,17690,92,17598,2610,46,2564,18878,14541,4337,15070,11735,3335,2038,473,139,12420
4/1/2020,VA,Virginia,Bland,51021,1828,1302,526,1466,*,*,362,*,*,1722,1196,526,1364,967,397,233,59,16,1056
4/1/2020,VA,Virginia,Botetourt,51023,8882,6459,2423,7875,49,7826,1007,20,987,8274,5851,2423,6670,4582,2088,724,164,46,5736
4/1/2020,VA,Virginia,Bristol City,51520,4676,2362,2314,3742,*,*,934,12,922,4389,2075,2314,3771,1548,2223,1135,138,44,2454
4/1/2020,VA,Virginia,Brunswick,51025,4110,3098,1012,3471,39,3432,639,17,622,3840,2828,1012,3106,2213,893,1077,122,41,1866
4/1/2020,VA,Virginia,Buchanan,51027,7191,3738,3453,4769,29,4740,2422,19,2403,6939,3486,3453,5973,3313,2660,1644,384,103,3842
4/1/2020,VA,Virginia,Buckingham,51029,3718,2944,774,3082,21,3061,636,17,619,3486,2712,774,2713,2147,566,800,140,40,1733
4/1/2020,VA,Virginia,Buena Vista City,51530,1496,1153,343,1237,*,*,259,*,*,1392,1049,343,1103,808,295,300,63,14,726
4/1/2020,VA,Virginia,Campbell,51031,13323,10129,3194,11245,91,11154,2078,61,2017,12492,9298,3194,10311,7468,2843,2092,378,114,7727
4/1/2020,VA,Virginia,Caroline,51033,6138,4673,1465,5237,44,5193,901,32,869,5520,4055,1465,3898,2609,1289,884,203,35,2776
4/1/2020,VA,Virginia,Carroll,51035,8601,6877,1724,7204,29,7175,1397,17,1380,8166,6442,1724,6520,5076,1444,1642,263,97,4518
4/1/2020,VA,Virginia,Charles City,51036,1987,1425,562,1715,20,1695,272,16,256,1821,1259,562,1421,924,497,266,72,15,1068
4/1/2020,VA,Virginia,Charlotte,51037,3288,2568,720,2734,18,2716,554,15,539,3082,2362,720,2482,1837,645,729,120,32,1601
4/1/2020,VA,Virginia,Charlottesville City,51540,6337,5374,963,5395,29,5366,942,44,898,5687,4725,962,4675,3789,886,1232,145,34,3264
4/1/2020,VA,Virginia,Chesapeake City,51550,39960,29875,10085,34927,311,34616,5033,226,4807,36102,26018,10084,22831,13766,9065,4285,958,199,17389
4/1/2020,VA,Virginia,Chesterfield,51041,63441,46117,17324,56367,264,56103,7074,250,6824,57296,39976,17320,45338,29740,15598,5782,1045,238,38273
4/1/2020,VA,Virginia,Clarke,51043,3428,2898,530,3178,11,3167,250,*,*,3074,2544,530,2179,1776,403,292,65,26,1796
4/1/2020,VA,Virginia,Colonial Heights City,51570,4179,3284,895,3595,12,3583,584,*,*,3833,2938,895,2607,1804,803,518,106,15,1968
4/1/2020,VA,Virginia,Covington City,51580,1581,1245,336,1239,18,1221,342,*,*,1480,1144,336,1219,905,314,331,45,12,831
4/1/2020,VA,Virginia,Craig,51045,1372,969,403,1093,*,*,279,*,*,1280,877,403,1045,675,370,208,45,11,781
4/1/2020,VA,Virginia,Culpeper,51047,9811,8087,1724,8648,33,8615,1163,43,1120,8899,7176,1723,6321,5009,1312,1252,230,58,4781
4/1/2020,VA,Virginia,Cumberland,51049,2404,1762,642,2010,15,1995,394,*,*,2220,1578,642,1795,1228,567,462,88,27,1218
4/1/2020,VA,Virginia,Danville City,51590,11145,7278,3867,8907,91,8816,2238,124,2114,10443,6576,3867,9078,6090,2988,3263,397,155,5263
4/1/2020,VA,Virginia,Dickenson,51051,4930,2370,2560,3306,*,*,1624,*,*,4740,2180,2560,4068,1757,2311,1160,214,64,2630
4/1/2020,VA,Virginia,Dinwiddie,51053,6165,4546,1619,5085,41,5044,1080,39,1041,5673,4054,1619,4345,2819,1526,952,190,45,3158
4/1/2020,VA,Virginia,Emporia City,51595,1350,909,441,1072,20,1052,278,11,267,1271,830,441,1042,658,384,456,74,11,501
4/1/2020,VA,Virginia,Essex,51057,3035,2319,716,2621,15,2606,414,16,398,2792,2076,716,2171,1591,580,482,90,34,1565
4/1/2020,VA,Virginia,Fairfax,51059,156451,124333,32118,148583,625,147958,7868,438,7430,125945,93848,32097,77802,50205,27597,14518,2672,537,60075
4/1/2020,VA,Virginia,Fairfax City,51600,3967,3118,849,3731,15,3716,236,14,222,3319,2470,849,2162,1461,701,394,70,16,1682
4/1/2020,VA,Virginia,Falls Church City,51610,2127,1725,402,2053,*,*,74,*,*,1668,1266,402,1074,724,350,132,*,*,927
4/1/2020,VA,Virginia,Fauquier,51061,13125,11261,1864,12103,81,12022,1022,35,987,11622,9758,1864,7798,6407,1391,976,187,53,6582
4/1/2020,VA,Virginia,Floyd,51063,4259,3233,1026,3732,13,3719,527,*,*,3985,2960,1025,3256,2295,961,637,106,41,2472
4/1/2020,VA,Virginia,Fluvanna,51065,6270,5259,1011,5666,26,5640,604,17,587,5701,4690,1011,4298,3484,814,589,110,27,3572
4/1/2020,VA,Virginia,Franklin,51067,15327,10470,4857,13069,61,13008,2258,36,2222,14368,9511,4857,11969,7603,4366,2100,469,136,9264
4/1/2020,VA,Virginia,Franklin City,51620,2197,1703,494,1797,20,1777,400,21,379,2049,1555,494,1688,1230,458,557,58,15,1058
4/1/2020,VA,Virginia,Frederick,51069,17424,14209,3215,15715,75,15640,1709,47,1662,15816,12603,3213,11282,8681,2601,1474,373,110,9325
4/1/2020,VA,Virginia,Fredericksburg City,51630,4243,3384,859,3548,27,3521,695,25,670,3743,2884,859,2675,1905,770,848,81,29,1717
4/1/2020,VA,Virginia,Galax City,51640,1769,1500,269,1428,*,*,341,*,*,1676,1407,269,1396,1166,230,590,48,23,735
4/1/2020,VA,Virginia,Giles,51071,4630,3421,1209,3721,22,3699,909,17,892,4379,3170,1209,3685,2808,877,837,107,35,2706
4/1/2020,VA,Virginia,Gloucester,51073,8959,7143,1816,7850,53,7797,1109,20,1089,8243,6428,1815,5513,3924,1589,1031,173,52,4257
4/1/2020,VA,Virginia,Goochland,51075,6181,4740,1441,5716,29,5687,465,13,452,5686,4245,1441,4769,3558,1211,424,94,23,4228
4/1/2020,VA,Virginia,Grayson,51077,4639,3518,1121,3866,16,3850,773,*,*,4443,3322,1121,3525,2510,1015,953,186,82,2304
4/1/2020,VA,Virginia,Greene,51079,4094,3453,641,3605,14,3591,489,13,476,3708,3067,641,2775,2215,560,478,81,23,2193
4/1/2020,VA,Virginia,Greensville,51081,2141,1435,706,1742,22,1720,399,14,385,1980,1274,706,1640,1067,573,457,103,19,1061
4/1/2020,VA,Virginia,Halifax,51083,9930,7954,1976,8316,62,8254,1614,56,1558,9299,7323,1976,7587,5825,1762,2173,404,118,4892
4/1/2020,VA,Virginia,Hampton City,51650,25919,17920,7999,21697,238,21459,4222,213,4009,23575,15576,7999,15176,7643,7533,4105,746,157,10168
4/1/2020,VA,Virginia,Hanover,51085,22285,16369,5916,20452,106,20346,1833,46,1787,20323,14408,5915,16709,11758,4951,1535,306,87,14781
4/1/2020,VA,Virginia,Harrisonburg City,51660,5606,4745,861,4786,25,4761,820,21,799,5086,4225,861,4125,3444,681,1020,137,45,2923
4/1/2020,VA,Virginia,Henrico,51087,59000,41089,17911,52199,394,51805,6801,286,6515,53289,35379,17910,44386,28460,15926,6964,1396,338,35688
4/1/2020,VA,Virginia,Henry,51089,14934,9697,5237,12058,88,11970,2876,74,2802,14190,8953,5237,12333,7423,4910,3082,695,201,8355
4/1/2020,VA,Virginia,Highland,51091,810,715,95,739,0,739,71,*,*,761,666,95,581,505,76,62,*,*,495
4/1/2020,VA,Virginia,Hopewell City,51670,4594,3285,1309,3610,31,3579,984,29,955,4252,2943,1309,3072,1820,1252,1048,139,38,1847
4/1/2020,VA,Virginia,Isle of Wight,51093,8702,6593,2109,7738,62,7676,964,35,929,8044,5935,2109,5764,3819,1945,1002,194,63,4505
4/1/2020,VA,Virginia,James City,51095,21681,18022,3659,20460,69,20391,1221,44,1177,20003,16346,3657,13206,10391,2815,950,241,57,11958
4/1/2020,VA,Virginia,King and Queen,51097,1813,1401,412,1555,*,*,258,*,*,1689,1277,412,1302,940,362,275,61,11,955
4/1/2020,VA,Virginia,King George,51099,4156,3581,575,3651,25,3626,505,20,485,3606,3031,575,1892,1395,497,461,71,15,1345
4/1/2020,VA,Virginia,King William,51101,3607,2852,755,3112,25,3087,495,31,464,3328,2573,755,2737,2069,668,430,101,16,2190
4/1/2020,VA,Virginia,Lancaster,51103,4407,3672,735,4094,26,4068,313,15,298,4141,3407,734,3107,2599,508,499,90,13,2505
4/1/2020,VA,Virginia,Lee,51105,6448,3038,3410,4597,17,4580,1851,20,1831,6121,2714,3407,5161,2105,3056,1978,238,63,2882
4/1/2020,VA,Virginia,Lexington City,51678,1362,1163,199,1252,*,*,110,*,*,1233,1035,198,967,796,171,173,28,11,755
4/1/2020,VA,Virginia,Loudoun,51107,40790,32269,8521,38419,188,38231,2371,122,2249,33853,25337,8516,23357,16096,7261,3477,658,147,19075
4/1/2020,VA,Virginia,Louisa,51109,8757,6767,1990,7487,57,7430,1270,39,1231,8020,6030,1990,6064,4329,1735,1155,249,48,4612
4/1/2020,VA,Virginia,Lunenburg,51111,3159,2517,642,2658,18,2640,501,13,488,2926,2284,642,2283,1703,580,730,117,36,1400
4/1/2020,VA,Virginia,Lynchburg City,51680,14715,11087,3628,12203,93,12110,2512,104,2408,13656,10028,3628,11372,8080,3292,3026,430,116,7800
4/1/2020,VA,Virginia,Madison,51113,3359,2758,601,3019,15,3004,340,*,*,3121,2520,601,2366,1884,482,436,81,16,1833
4/1/2020,VA,Virginia,Manassas City,51683,4729,3627,1102,4213,27,4186,516,44,472,3983,2881,1102,2856,1903,953,575,96,25,2160
4/1/2020,VA,Virginia,Manassas Park City,51685,1356,950,406,1186,16,1170,170,13,157,1122,716,406,838,469,369,215,*,*,563
4/1/2020,VA,Virginia,Martinsville City,51690,3832,2519,1313,2936,40,2896,896,37,859,3627,2314,1313,3158,1902,1256,1292,175,48,1643
4/1/2020,VA,Virginia,Mathews,51115,2921,2346,575,2680,12,2668,241,*,*,2746,2171,575,2013,1540,473,295,37,19,1662
4/1/2020,VA,Virginia,Mecklenburg,51117,9409,7229,2180,7947,61,7886,1462,63,1399,8820,6640,2180,7072,5158,1914,1826,378,89,4779
4/1/2020,VA,Virginia,Middlesex,51119,3702,3019,683,3364,16,3348,338,*,*,3470,2787,683,2675,2142,533,464,75,23,2113
4/1/2020,VA,Virginia,Montgomery,51121,14398,11173,3225,12196,59,12137,2202,32,2170,12957,9732,3225,10947,8056,2891,1969,327,96,8555
4/1/2020,VA,Virginia,Nelson,51125,4766,3930,836,4306,19,4287,460,*,*,4397,3562,835,3328,2608,720,582,103,36,2607
4/1/2020,VA,Virginia,New Kent,51127,4917,3864,1053,4447,20,4427,470,11,459,4464,3411,1053,3250,2422,828,321,75,18,2836
4/1/2020,VA,Virginia,Newport News City,51700,29152,20048,9104,24329,242,24087,4823,242,4581,26559,17456,9103,18103,9454,8649,5142,877,184,11900
4/1/2020,VA,Virginia,Norfolk City,51710,33761,23024,10737,27619,314,27305,6142,322,5820,30286,19550,10736,21283,11057,10226,7455,1276,244,12308
4/1/2020,VA,Virginia,Northampton,51131,3794,2903,891,3339,23,3316,455,18,437,3534,2643,891,2881,2108,773,924,83,24,1850
4/1/2020,VA,Virginia,Northumberland,51133,4688,3858,830,4362,14,4348,326,11,315,4387,3557,830,3039,2479,560,439,72,20,2508
4/1/2020,VA,Virginia,Norton City,51720,1141,623,518,803,*,*,338,*,*,1066,548,518,910,445,465,349,*,*,504
4/1/2020,VA,Virginia,Nottoway,51135,3652,2815,837,3028,24,3004,624,16,608,3384,2547,837,2703,1998,705,874,120,39,1670
4/1/2020,VA,Virginia,Orange,51137,8950,7462,1488,7977,57,7920,973,30,943,8156,6668,1488,5636,4531,1105,1010,190,53,4383
4/1/2020,VA,Virginia,Page,51139,6311,5231,1080,5309,19,5290,1002,19,983,5885,4805,1080,4418,3497,921,1079,245,61,3033
4/1/2020,VA,Virginia,Patrick,51141,5551,4023,1528,4671,15,4656,880,*,*,5277,3750,1527,4364,3030,1334,1058,186,61,3059
4/1/2020,VA,Virginia,Petersburg City,51730,7225,4693,2532,5459,99,5360,1766,75,1691,6573,4041,2532,5051,2590,2461,2151,327,57,2516
4/1/2020,VA,Virginia,Pittsylvania,51143,16582,11200,5382,13878,105,13773,2704,70,2634,15573,10191,5382,13192,9026,4166,3035,518,155,9484
4/1/2020,VA,Virginia,Poquoson City,51735,2647,2252,395,2478,*,*,169,*,*,2429,2034,395,1304,956,348,118,24,11,1151
4/1/2020,VA,Virginia,Portsmouth City,51740,18612,12755,5857,14777,200,14577,3835,204,3631,16634,10778,5856,11516,5919,5597,4123,693,110,6590
4/1/2020,VA,Virginia,Powhatan,51145,6381,4902,1479,5819,14,5805,562,12,550,5881,4402,1479,4825,3560,1265,404,109,23,4289
4/1/2020,VA,Virginia,Prince Edward,51147,4730,3662,1068,3887,38,3849,843,31,812,4360,3292,1068,3488,2608,880,1061,152,42,2233
4/1/2020,VA,Virginia,Prince George,51149,6310,5236,1074,5389,37,5352,921,31,890,5829,4756,1073,3683,2721,962,612,123,23,2925
4/1/2020,VA,Virginia,Prince William,51153,51581,39929,11652,46646,324,46322,4935,308,4627,43810,32163,11647,26487,16103,10384,5377,1145,202,19763
4/1/2020,VA,Virginia,Pulaski,51155,9197,7035,2162,7500,31,7469,1697,30,1667,8577,6415,2162,7156,5251,1905,1604,290,81,5181
4/1/2020,VA,Virginia,Radford City,51750,2075,1574,501,1708,*,*,367,*,*,1870,1369,501,1605,1145,460,334,47,22,1202
4/1/2020,VA,Virginia,Rappahannock,51157,1991,1751,240,1867,*,*,124,*,*,1792,1553,239,1259,1087,172,156,36,12,1055
4/1/2020,VA,Virginia,Richmond,51159,1965,1531,434,1723,*,*,242,11,231,1818,1384,434,1384,1078,306,312,67,13,992
4/1/2020,VA,Virginia,Richmond City,51760,34803,21493,13310,28326,279,28047,6477,306,6171,31345,18037,13308,27136,14480,12656,8890,1331,255,16660
4/1/2020,VA,Virginia,Roanoke,51161,24145,17564,6581,21644,112,21532,2501,56,2445,22247,15668,6579,18346,12657,5689,2126,452,116,15652
4/1/2020,VA,Virginia,Roanoke City,51770,21422,13956,7466,16734,173,16561,4688,141,4547,19492,12029,7463,16278,9337,6941,4946,849,174,10309
4/1/2020,VA,Virginia,Rockbridge,51163,6442,5144,1298,5579,12,5567,863,*,*,5969,4671,1298,4595,3483,1112,879,173,54,3489
4/1/2020,VA,Virginia,Rockingham,51165,18375,15482,2893,16342,59,16283,2033,42,1991,16974,14082,2892,13517,11361,2156,1868,504,136,11009
4/1/2020,VA,Virginia,Russell,51167,8008,4484,3524,5745,17,5728,2263,21,2242,7676,4153,3523,6682,3739,2943,1720,334,136,4492
4/1/2020,VA,Virginia,Salem City,51775,6135,4593,1542,5272,31,5241,863,18,845,5653,4111,1542,4636,3246,1390,858,122,34,3622
4/1/2020,VA,Virginia,Scott,51169,6797,2863,3934,5255,16,5239,1542,16,1526,6527,2593,3934,5775,2023,3752,1524,249,106,3896
4/1/2020,VA,Virginia,Shenandoah,51171,10866,8862,2004,9739,40,9699,1127,22,1105,10152,8148,2004,7462,5798,1664,1303,258,80,5821
4/1/2020,VA,Virginia,Smyth,51173,8694,5751,2943,6663,36,6627,2031,26,2005,8240,5297,2943,6942,4190,2752,2116,347,120,4359
4/1/2020,VA,Virginia,Southampton,51175,4038,3218,820,3437,30,3407,601,26,575,3746,2926,820,2978,2249,729,699,118,26,2135
4/1/2020,VA,Virginia,Spotsylvania,51177,22409,18223,4186,19725,133,19592,2684,106,2578,19831,15647,4184,12490,8965,3525,2130,559,120,9681
4/1/2020,VA,Virginia,Stafford,51179,18678,15704,2974,16691,115,16576,1987,86,1901,16340,13368,2972,8687,6157,2530,1537,355,79,6716
4/1/2020,VA,Virginia,Staunton City,51790,6358,5136,1222,5390,21,5369,968,17,951,5971,4749,1222,4788,3721,1067,1099,154,48,3487
4/1/2020,VA,Virginia,Suffolk City,51800,17236,12730,4506,14384,134,14250,2852,114,2738,15790,11284,4506,11028,6884,4144,2900,475,95,7558
4/1/2020,VA,Virginia,Surry,51181,1766,1300,466,1544,14,1530,222,*,*,1630,1164,466,1233,799,434,225,61,12,935
4/1/2020,VA,Virginia,Sussex,51183,2516,1788,728,2075,30,2045,441,*,*,2347,1619,728,1842,1153,689,521,133,19,1169
4/1/2020,VA,Virginia,Tazewell,51185,12009,7424,4585,9114,36,9078,2895,37,2858,11421,6837,4584,9334,5881,3453,2309,467,132,6426
4/1/2020,VA,Virginia,Unknown,51999,*,*,*,*,*,*,*,*,*,*,*,*,*,*,*,*,*,*,*
4/1/2020,VA,Virginia,Virginia Beach City,51810,75332,58858,16474,67109,425,66684,8223,339,7884,68916,52450,16466,41158,26206,14952,7186,1495,366,32111
4/1/2020,VA,Virginia,Warren,51187,8016,6702,1314,7018,24,6994,998,38,960,7278,5964,1314,5090,4029,1061,928,218,63,3881
4/1/2020,VA,Virginia,Washington,51191,15218,8977,6241,12542,50,12492,2676,34,2642,14334,8094,6240,12106,6332,5774,2414,540,186,8966
4/1/2020,VA,Virginia,Waynesboro City,51820,5055,4051,1004,4229,18,4211,826,26,800,4715,3711,1004,3819,2906,913,938,119,42,2720
4/1/2020,VA,Virginia,Westmoreland,51193,5190,4326,864,4615,29,4586,575,17,558,4730,3866,864,3168,2438,730,804,139,43,2182
4/1/2020,VA,Virginia,Williamsburg City,51830,2858,2310,548,2626,*,*,232,*,*,2633,2085,548,1909,1448,461,268,*,*,1596
4/1/2020,VA,Virginia,Winchester City,51840,5604,4618,986,4858,28,4830,746,24,722,5093,4108,985,3782,2947,835,893,140,34,2715
4/1/2020,VA,Virginia,Wise,51195,10650,5152,5498,7438,26,7412,3212,28,3184,10056,4559,5497,8330,3550,4780,2448,472,153,5257
4/1/2020,VA,Virginia,Wythe,51197,7978,5610,2368,6348,38,6310,1630,18,1612,7529,5161,2368,6264,4149,2115,1681,296,95,4192
4/1/2020,VA,Virginia,York,51199,12525,10474,2051,11575,47,11528,950,37,913,11454,9403,2051,6317,4549,1768,710,158,35,5414
8/1/2020,VA,Virginia,Accomack,51001,9218,7305,1913,8052,59,7993,1166,42,1124,8555,6643,1912,6376,4818,1558,1555,349,80,4392
8/1/2020,VA,Virginia,Albemarle,51003,22207,19224,2983,20679,62,20617,1528,38,1490,20068,17088,2980,15713,13177,2536,1619,286,92,13716
8/1/2020,VA,Virginia,Alexandria City,51510,18521,14903,3618,17225,65,17160,1296,73,1223,14974,11358,3616,9468,6204,3264,2159,310,62,6937
8/1/2020,VA,Virginia,Alleghany,51005,4647,3664,983,3796,18,3778,851,14,837,4408,3425,983,3620,2771,849,844,106,48,2622
8/1/2020,VA,Virginia,Amelia,51007,3179,2207,972,2729,*,*,450,13,437,2932,1960,972,2390,1483,907,470,86,28,1806
8/1/2020,VA,Virginia,Amherst,51009,7981,5925,2056,6716,48,6668,1265,32,1233,7450,5394,2056,6160,4296,1864,1276,200,67,4617
8/1/2020,VA,Virginia,Appomattox,51011,4066,3071,995,3385,18,3367,681,24,657,3828,2833,995,3170,2257,913,721,102,47,2300
8/1/2020,VA,Virginia,Arlington,51013,25293,20821,4472,23752,99,23653,1541,70,1471,19968,15496,4472,12473,8411,4062,3008,385,117,8963
8/1/2020,VA,Virginia,Augusta,51015,18854,15395,3459,16509,67,16442,2345,50,2295,17701,14242,3459,14048,11046,3002,1945,395,130,11578
8/1/2020,VA,Virginia,Bath,51017,1277,1119,158,1118,*,*,159,0,159,1216,1058,158,970,831,139,164,35,11,760
8/1/2020,VA,Virginia,Bedford,51019,20465,16011,4454,17800,85,17715,2665,49,2616,19081,14628,4453,15210,11733,3477,2073,476,139,12522
8/1/2020,VA,Virginia,Bland,51021,1822,1289,533,1461,*,*,361,*,*,1720,1187,533,1357,950,407,234,58,14,1051
8/1/2020,VA,Virginia,Botetourt,51023,8920,6477,2443,7896,48,7848,1024,20,1004,8308,5865,2443,6685,4576,2109,732,161,45,5747
8/1/2020,VA,Virginia,Bristol City,51520,4681,2341,2340,3740,*,*,941,12,929,4402,2062,2340,3777,1528,2249,1156,140,42,2439
8/1/2020,VA,Virginia,Brunswick,51025,4119,3032,1087,3474,38,3436,645,17,628,3854,2767,1087,3112,2147,965,1083,124,37,1868
8/1/2020,VA,Virginia,Buchanan,51027,7177,3662,3515,4744,25,4719,2433,17,2416,6944,3429,3515,5988,3262,2726,1682,382,104,3820
8/1/2020,VA,Virginia,Buckingham,51029,3731,2911,820,3086,21,3065,645,18,627,3504,2684,820,2728,2113,615,810,135,40,1743
8/1/2020,VA,Virginia,Buena Vista City,51530,1498,1139,359,1234,*,*,264,*,*,1396,1037,359,1107,794,313,310,59,13,725
8/1/2020,VA,Virginia,Campbell,51031,13346,10066,3280,11242,81,11161,2104,60,2044,12541,9261,3280,10331,7400,2931,2132,367,112,7720
8/1/2020,VA,Virginia,Caroline,51033,6201,4701,1500,5288,43,5245,913,31,882,5603,4103,1500,3926,2596,1330,901,200,34,2791
8/1/2020,VA,Virginia,Carroll,51035,8595,6800,1795,7191,28,7163,1404,16,1388,8189,6394,1795,6532,5007,1525,1630,263,100,4539
8/1/2020,VA,Virginia,Charles City,51036,1995,1421,574,1718,19,1699,277,15,262,1832,1258,574,1424,918,506,266,77,16,1065
8/1/2020,VA,Virginia,Charlotte,51037,3297,2554,743,2733,17,2716,564,16,548,3099,2356,743,2489,1825,664,734,120,33,1602
8/1/2020,VA,Virginia,Charlottesville City,51540,6372,5344,1028,5421,27,5394,951,42,909,5729,4702,1027,4706,3753,953,1228,150,35,3293
8/1/2020,VA,Virginia,Chesapeake City,51550,40355,29965,10390,35235,292,34943,5120,218,4902,36565,26177,10388,23051,13677,9374,4407,957,201,17486
8/1/2020,VA,Virginia,Chesterfield,51041,64057,46368,17689,56889,247,56642,7168,256,6912,58034,40349,17685,45838,29864,15974,5937,1022,251,38628
8/1/2020,VA,Virginia,Clarke,51043,3441,2913,528,3190,*,*,251,*,*,3099,2571,528,2181,1778,403,288,67,26,1800
8/1/2020,VA,Virginia,Colonial Heights City,51570,4175,3262,913,3591,11,3580,584,*,*,3842,2929,913,2613,1792,821,523,103,13,1974
8/1/2020,VA,Virginia,Covington City,51580,1581,1231,350,1234,17,1217,347,*,*,1480,1130,350,1219,891,328,335,46,12,826
8/1/2020,VA,Virginia,Craig,51045,1369,962,407,1093,*,*,276,*,*,1279,872,407,1043,673,370,212,*,*,773
8/1/2020,VA,Virginia,Culpeper,51047,9894,8134,1760,8714,32,8682,1180,39,1141,8975,7216,1759,6368,5015,1353,1271,231,60,4806
8/1/2020,VA,Virginia,Cumberland,51049,2412,1742,670,2015,13,2002,397,*,*,2229,1559,670,1802,1207,595,465,88,23,1226
8/1/2020,VA,Virginia,Danville City,51590,11192,7180,4012,8922,85,8837,2270,125,2145,10517,6505,4012,9123,5988,3135,3336,398,153,5236
8/1/2020,VA,Virginia,Dickenson,51051,4916,2341,2575,3289,*,*,1627,*,*,4732,2157,2575,4041,1716,2325,1156,215,65,2605
8/1/2020,VA,Virginia,Dinwiddie,51053,6176,4503,1673,5094,39,5055,1082,37,1045,5700,4027,1673,4373,2796,1577,963,189,47,3174
8/1/2020,VA,Virginia,Emporia City,51595,1333,875,458,1059,20,1039,274,*,*,1250,792,458,1028,624,404,445,74,12,497
8/1/2020,VA,Virginia,Essex,51057,3048,2306,742,2626,13,2613,422,16,406,2822,2080,742,2183,1575,608,492,90,34,1567
8/1/2020,VA,Virginia,Fairfax,51059,158382,125191,33191,150354,578,149776,8028,430,7598,128283,95113,33170,78989,50316,28673,14663,2682,555,61089
8/1/2020,VA,Virginia,Fairfax City,51600,4002,3131,871,3764,15,3749,238,14,224,3350,2479,871,2193,1470,723,395,71,16,1711
8/1/2020,VA,Virginia,Falls Church City,51610,2129,1721,408,2058,*,*,71,*,*,1680,1272,408,1083,727,356,136,*,*,934
8/1/2020,VA,Virginia,Fauquier,51061,13252,11342,1910,12213,76,12137,1039,35,1004,11759,9849,1910,7875,6434,1441,1018,185,51,6621
8/1/2020,VA,Virginia,Floyd,51063,4278,3224,1054,3748,12,3736,530,*,*,4002,2949,1053,3272,2285,987,646,103,39,2484
8/1/2020,VA,Virginia,Fluvanna,51065,6344,5318,1026,5720,24,5696,624,17,607,5782,4756,1026,4340,3507,833,605,113,28,3594
8/1/2020,VA,Virginia,Franklin,51067,15431,10466,4965,13160,58,13102,2271,33,2238,14493,9528,4965,12053,7577,4476,2109,468,137,9339
8/1/2020,VA,Virginia,Franklin City,51620,2197,1687,510,1790,17,1773,407,22,385,2061,1551,510,1684,1212,472,561,61,13,1049
8/1/2020,VA,Virginia,Frederick,51069,17547,14265,3282,15801,68,15733,1746,48,1698,15942,12662,3280,11378,8706,2672,1500,373,115,9390
8/1/2020,VA,Virginia,Fredericksburg City,51630,4288,3390,898,3594,25,3569,694,25,669,3797,2899,898,2703,1894,809,854,81,29,1739
8/1/2020,VA,Virginia,Galax City,51640,1764,1485,279,1418,*,*,346,*,*,1670,1391,279,1393,1153,240,577,52,22,742
8/1/2020,VA,Virginia,Giles,51071,4639,3396,1243,3727,18,3709,912,16,896,4396,3153,1243,3691,2771,920,827,104,37,2723
8/1/2020,VA,Virginia,Gloucester,51073,9028,7164,1864,7914,48,7866,1114,22,1092,8321,6458,1863,5540,3907,1633,1038,177,55,4270
8/1/2020,VA,Virginia,Goochland,51075,6226,4754,1472,5755,28,5727,471,13,458,5743,4271,1472,4820,3576,1244,433,94,23,4270
8/1/2020,VA,Virginia,Grayson,51077,4630,3484,1146,3851,16,3835,779,*,*,4432,3286,1146,3515,2472,1043,945,187,81,2302
8/1/2020,VA,Virginia,Greene,51079,4143,3476,667,3648,13,3635,495,12,483,3749,3082,667,2802,2214,588,490,79,23,2210
8/1/2020,VA,Virginia,Greensville,51081,2137,1420,717,1730,19,1711,407,14,393,1982,1265,717,1632,1045,587,461,97,19,1055
8/1/2020,VA,Virginia,Halifax,51083,9955,7875,2080,8320,56,8264,1635,55,1580,9336,7256,2080,7611,5740,1871,2191,394,125,4901
8/1/2020,VA,Virginia,Hampton City,51650,26120,17903,8217,21822,226,21596,4298,220,4078,23811,15595,8216,15273,7528,7745,4190,748,153,10182
8/1/2020,VA,Virginia,Hanover,51085,22488,16426,6062,20630,98,20532,1858,48,1810,20566,14505,6061,16927,11834,5093,1564,305,83,14975
8/1/2020,VA,Virginia,Harrisonburg City,51660,5619,4733,886,4797,22,4775,822,20,802,5101,4215,886,4121,3411,710,1014,134,46,2927
8/1/2020,VA,Virginia,Henrico,51087,59419,41171,18248,52514,370,52144,6905,290,6615,53823,35575,18248,44770,28473,16297,7083,1383,344,35960
8/1/2020,VA,Virginia,Henry,51089,14958,9531,5427,12050,84,11966,2908,70,2838,14256,8830,5426,12393,7294,5099,3116,701,204,8372
8/1/2020,VA,Virginia,Highland,51091,818,719,99,745,0,745,73,*,*,769,670,99,585,506,79,63,*,*,497
8/1/2020,VA,Virginia,Hopewell City,51670,4605,3240,1365,3609,28,3581,996,28,968,4279,2914,1365,3084,1778,1306,1075,140,35,1834
8/1/2020,VA,Virginia,Isle of Wight,51093,8767,6611,2156,7789,60,7729,978,33,945,8116,5960,2156,5811,3818,1993,1011,197,64,4539
8/1/2020,VA,Virginia,James City,51095,21775,18044,3731,20536,65,20471,1239,41,1198,20190,16461,3729,13321,10427,2894,974,239,54,12054
8/1/2020,VA,Virginia,King and Queen,51097,1820,1404,416,1560,*,*,260,*,*,1697,1281,416,1300,934,366,281,*,*,947
8/1/2020,VA,Virginia,King George,51099,4202,3593,609,3688,24,3664,514,20,494,3660,3051,609,1908,1377,531,473,70,17,1348
8/1/2020,VA,Virginia,King William,51101,3621,2831,790,3120,22,3098,501,31,470,3352,2562,790,2759,2055,704,436,94,17,2212
8/1/2020,VA,Virginia,Lancaster,51103,4424,3669,755,4104,25,4079,320,15,305,4172,3418,754,3111,2574,537,501,92,11,2507
8/1/2020,VA,Virginia,Lee,51105,6459,2990,3469,4599,15,4584,1860,20,1840,6153,2687,3466,5181,2060,3121,2005,232,62,2882
8/1/2020,VA,Virginia,Lexington City,51678,1357,1145,212,1245,*,*,112,*,*,1244,1033,211,979,795,184,175,29,11,764
8/1/2020,VA,Virginia,Loudoun,51107,41357,32598,8759,38942,177,38765,2415,116,2299,34396,25642,8754,23636,16128,7508,3551,658,148,19279
8/1/2020,VA,Virginia,Louisa,51109,8839,6753,2086,7553,51,7502,1286,36,1250,8106,6020,2086,6138,4309,1829,1186,245,51,4656
8/1/2020,VA,Virginia,Lunenburg,51111,3180,2502,678,2674,17,2657,506,13,493,2951,2273,678,2301,1683,618,747,115,35,1404
8/1/2020,VA,Virginia,Lynchburg City,51680,14779,10979,3800,12234,87,12147,2545,101,2444,13761,9961,3800,11459,7990,3469,3093,424,115,7827
8/1/2020,VA,Virginia,Madison,51113,3394,2772,622,3048,14,3034,346,*,*,3157,2535,622,2383,1881,502,440,81,15,1847
8/1/2020,VA,Virginia,Manassas City,51683,4781,3660,1121,4250,25,4225,531,41,490,4038,2917,1121,2889,1918,971,584,97,23,2185
8/1/2020,VA,Virginia,Manassas Park City,51685,1359,949,410,1190,15,1175,169,14,155,1136,726,410,842,466,376,221,*,*,561
8/1/2020,VA,Virginia,Martinsville City,51690,3838,2466,1372,2935,40,2895,903,35,868,3642,2270,1372,3182,1868,1314,1307,169,46,1660
8/1/2020,VA,Virginia,Mathews,51115,2934,2347,587,2692,11,2681,242,*,*,2765,2178,587,2030,1545,485,291,37,20,1682
8/1/2020,VA,Virginia,Mecklenburg,51117,9430,7181,2249,7950,55,7895,1480,64,1416,8861,6612,2249,7105,5121,1984,1832,369,89,4815
8/1/2020,VA,Virginia,Middlesex,51119,3738,3040,698,3392,15,3377,346,*,*,3514,2816,698,2703,2148,555,465,77,22,2139
8/1/2020,VA,Virginia,Montgomery,51121,14489,11157,3332,12259,55,12204,2230,32,2198,13048,9716,3332,11029,8022,3007,1996,329,96,8608
8/1/2020,VA,Virginia,Nelson,51125,4813,3934,879,4346,15,4331,467,*,*,4461,3583,878,3367,2603,764,590,105,36,2636
8/1/2020,VA,Virginia,New Kent,51127,4972,3896,1076,4501,19,4482,471,11,460,4537,3461,1076,3307,2456,851,339,77,18,2873
8/1/2020,VA,Virginia,Newport News City,51700,29396,19992,9404,24493,227,24266,4903,235,4668,26869,17466,9403,18280,9328,8952,5299,874,181,11926
8/1/2020,VA,Virginia,Norfolk City,51710,34053,22993,11060,27826,296,27530,6227,312,5915,30664,19605,11059,21459,10911,10548,7620,1260,253,12326
8/1/2020,VA,Virginia,Northampton,51131,3780,2855,925,3323,19,3304,457,19,438,3536,2611,925,2868,2063,805,901,80,26,1861
8/1/2020,VA,Virginia,Northumberland,51133,4717,3864,853,4384,13,4371,333,12,321,4421,3568,853,3062,2478,584,440,73,22,2527
8/1/2020,VA,Virginia,Norton City,51720,1141,612,529,801,*,*,340,*,*,1067,538,529,907,431,476,345,*,*,506
8/1/2020,VA,Virginia,Nottoway,51135,3681,2799,882,3045,24,3021,636,16,620,3425,2543,882,2732,1983,749,883,121,41,1687
8/1/2020,VA,Virginia,Orange,51137,9008,7472,1536,8022,55,7967,986,30,956,8228,6692,1536,5662,4511,1151,1012,191,53,4406
8/1/2020,VA,Virginia,Page,51139,6340,5215,1125,5308,17,5291,1032,19,1013,5917,4792,1125,4432,3468,964,1088,243,58,3043
8/1/2020,VA,Virginia,Patrick,51141,5565,3996,1569,4670,15,4655,895,12,883,5298,3730,1568,4364,2989,1375,1063,184,62,3055
8/1/2020,VA,Virginia,Petersburg City,51730,7224,4584,2640,5452,96,5356,1772,75,1697,6588,3948,2640,5053,2485,2568,2187,319,54,2493
8/1/2020,VA,Virginia,Pittsylvania,51143,16647,11124,5523,13912,102,13810,2735,69,2666,15675,10152,5523,13276,8977,4299,3065,523,156,9532
8/1/2020,VA,Virginia,Poquoson City,51735,2671,2269,402,2499,*,*,172,*,*,2454,2052,402,1325,971,354,124,24,12,1165
8/1/2020,VA,Virginia,Portsmouth City,51740,18728,12656,6072,14842,185,14657,3886,202,3684,16795,10724,6071,11616,5805,5811,4236,680,116,6584
8/1/2020,VA,Virginia,Powhatan,51145,6438,4938,1500,5858,12,5846,580,13,567,5941,4441,1500,4873,3583,1290,423,107,25,4318
8/1/2020,VA,Virginia,Prince Edward,51147,4740,3621,1119,3889,34,3855,851,30,821,4378,3259,1119,3502,2563,939,1062,159,44,2237
8/1/2020,VA,Virginia,Prince George,51149,6388,5278,1110,5456,35,5421,932,29,903,5899,4790,1109,3728,2729,999,616,120,26,2966
8/1/2020,VA,Virginia,Prince William,51153,52288,40240,12048,47265,299,46966,5023,305,4718,44544,32501,12043,26775,15985,10790,5497,1136,206,19936
8/1/2020,VA,Virginia,Pulaski,51155,9251,7048,2203,7538,27,7511,1713,29,1684,8650,6447,2203,7210,5262,1948,1620,284,84,5222
8/1/2020,VA,Virginia,Radford City,51750,2088,1579,509,1720,*,*,368,*,*,1894,1385,509,1621,1154,467,339,48,22,1212
8/1/2020,VA,Virginia,Rappahannock,51157,2010,1762,248,1887,*,*,123,*,*,1816,1569,247,1278,1097,181,157,35,12,1074
8/1/2020,VA,Virginia,Richmond,51159,1975,1519,456,1726,*,*,249,12,237,1837,1381,456,1402,1074,328,320,65,13,1004
8/1/2020,VA,Virginia,Richmond City,51760,35016,21297,13719,28455,265,28190,6561,301,6260,31638,17921,13717,27326,14257,13069,9082,1324,263,16657
8/1/2020,VA,Virginia,Roanoke,51161,24269,17566,6703,21734,107,21627,2535,55,2480,22426,15725,6701,18466,12649,5817,2151,456,119,15740
8/1/2020,VA,Virginia,Roanoke City,51770,21457,13734,7723,16716,160,16556,4741,137,4604,19585,11865,7720,16317,9120,7197,4985,860,180,10292
8/1/2020,VA,Virginia,Rockbridge,51163,6494,5151,1343,5615,11,5604,879,*,*,6025,4682,1343,4640,3481,1159,898,170,52,3520
8/1/2020,VA,Virginia,Rockingham,51165,18434,15466,2968,16381,55,16326,2053,42,2011,17057,14089,2968,13582,11338,2244,1887,505,135,11055
8/1/2020,VA,Virginia,Russell,51167,8054,4436,3618,5766,17,5749,2288,20,2268,7743,4126,3617,6726,3697,3029,1754,328,141,4503
8/1/2020,VA,Virginia,Salem City,51775,6138,4567,1571,5263,31,5232,875,16,859,5652,4081,1571,4637,3212,1425,870,121,39,3607
8/1/2020,VA,Virginia,Scott,51169,6812,2842,3970,5257,15,5242,1555,16,1539,6546,2576,3970,5779,1989,3790,1544,246,103,3886
8/1/2020,VA,Virginia,Shenandoah,51171,10888,8867,2021,9749,36,9713,1139,23,1116,10215,8194,2021,7513,5827,1686,1309,255,81,5868
8/1/2020,VA,Virginia,Smyth,51173,8695,5706,2989,6645,32,6613,2050,26,2024,8258,5269,2989,6953,4150,2803,2109,348,125,4371
8/1/2020,VA,Virginia,Southampton,51175,4043,3205,838,3436,28,3408,607,27,580,3765,2927,838,2981,2238,743,702,115,25,2139
8/1/2020,VA,Virginia,Spotsylvania,51177,22660,18322,4338,19933,122,19811,2727,104,2623,20117,15781,4336,12619,8936,3683,2167,554,128,9770
8/1/2020,VA,Virginia,Stafford,51179,18897,15843,3054,16875,111,16764,2022,85,1937,16581,13529,3052,8761,6150,2611,1581,351,80,6749
8/1/2020,VA,Virginia,Staunton City,51790,6363,5102,1261,5396,20,5376,967,17,950,6004,4743,1261,4807,3700,1107,1117,151,50,3489
8/1/2020,VA,Virginia,Suffolk City,51800,17341,12709,4632,14456,124,14332,2885,113,2772,15912,11280,4632,11060,6784,4276,2920,480,102,7558
8/1/2020,VA,Virginia,Surry,51181,1763,1293,470,1539,12,1527,224,*,*,1635,1165,470,1230,790,440,230,59,13,928
8/1/2020,VA,Virginia,Sussex,51183,2545,1789,756,2087,27,2060,458,*,*,2376,1620,756,1856,1140,716,527,133,18,1178
8/1/2020,VA,Virginia,Tazewell,51185,12041,7393,4648,9116,32,9084,2925,36,2889,11462,6816,4646,9347,5814,3533,2353,463,128,6403
8/1/2020,VA,Virginia,Unknown,51999,*,*,*,*,*,*,*,*,*,*,*,*,*,*,*,*,*,*,*
8/1/2020,VA,Virginia,Virginia Beach City,51810,76081,59211,16870,67718,398,67320,8363,348,8015,69752,52890,16862,41518,26161,15357,7373,1486,373,32286
8/1/2020,VA,Virginia,Warren,51187,8120,6767,1353,7099,23,7076,1021,37,984,7392,6039,1353,5166,4066,1100,957,216,65,3928
8/1/2020,VA,Virginia,Washington,51191,15292,8948,6344,12584,43,12541,2708,32,2676,14437,8094,6343,12192,6315,5877,2450,548,188,9006
8/1/2020,VA,Virginia,Waynesboro City,51820,5078,4041,1037,4242,17,4225,836,26,810,4747,3710,1037,3847,2901,946,960,116,44,2727
8/1/2020,VA,Virginia,Westmoreland,51193,5218,4302,916,4636,25,4611,582,17,565,4766,3850,916,3196,2413,783,826,138,43,2189
8/1/2020,VA,Virginia,Williamsburg City,51830,2876,2311,565,2639,*,*,237,*,*,2659,2094,565,1924,1444,480,269,*,*,1615
8/1/2020,VA,Virginia,Winchester City,51840,5633,4615,1018,4880,27,4853,753,23,730,5119,4102,1017,3798,2934,864,907,139,36,2716
8/1/2020,VA,Virginia,Wise,51195,10658,5058,5600,7430,25,7405,3228,25,3203,10098,4499,5599,8358,3466,4892,2479,468,152,5259
8/1/2020,VA,Virginia,Wythe,51197,7997,5551,2446,6348,34,6314,1649,17,1632,7560,5114,2446,6301,4104,2197,1703,287,95,4216
8/1/2020,VA,Virginia,York,51199,12652,10552,2100,11691,46,11645,961,36,925,11599,9499,2100,6363,4542,1821,731,153,36,5443
12/1/2020,VA,Virginia,Accomack,51001,9265,7338,1927,8074,55,8019,1191,43,1148,8589,6663,1926,6407,4831,1576,1581,349,84,4393
12/1/2020,VA,Virginia,Albemarle,51003,22372,19342,3030,20820,56,20764,1552,38,1514,20214,17187,3027,15831,13249,2582,1653,281,89,13808
12/1/2020,VA,Virginia,Alexandria City,51510,18712,15012,3700,17389,58,17331,1323,73,1250,15153,11455,3698,9558,6206,3352,2209,303,62,6984
12/1/2020,VA,Virginia,Alleghany,51005,4643,3646,997,3785,15,3770,858,13,845,4401,3404,997,3607,2744,863,828,102,46,2631
12/1/2020,VA,Virginia,Amelia,51007,3213,2225,988,2748,*,*,465,12,453,2978,1990,988,2406,1482,924,481,87,28,1810
12/1/2020,VA,Virginia,Amherst,51009,8020,5925,2095,6739,44,6695,1281,31,1250,7466,5371,2095,6162,4261,1901,1289,201,73,4599
12/1/2020,VA,Virginia,Appomattox,51011,4076,3068,1008,3382,16,3366,694,23,671,3838,2830,1008,3169,2241,928,733,101,47,2288
12/1/2020,VA,Virginia,Arlington,51013,25491,20921,4570,23928,94,23834,1563,66,1497,20095,15525,4570,12586,8415,4171,3028,383,120,9055
12/1/2020,VA,Virginia,Augusta,51015,18990,15480,3510,16594,61,16533,2396,54,2342,17811,14301,3510,14109,11046,3063,1999,394,132,11584
12/1/2020,VA,Virginia,Bath,51017,1282,1118,164,1124,*,*,158,0,158,1221,1057,164,977,832,145,166,34,11,766
12/1/2020,VA,Virginia,Bedford,51019,20609,16128,4481,17905,76,17829,2704,50,2654,19215,14735,4480,15311,11801,3510,2109,477,141,12584
12/1/2020,VA,Virginia,Bland,51021,1823,1291,532,1458,*,*,365,*,*,1719,1187,532,1347,944,403,227,59,13,1048
12/1/2020,VA,Virginia,Botetourt,51023,8973,6512,2461,7929,42,7887,1044,21,1023,8350,5889,2461,6723,4594,2129,735,159,44,5785
12/1/2020,VA,Virginia,Bristol City,51520,4665,2307,2358,3724,*,*,941,12,929,4384,2026,2358,3775,1506,2269,1168,143,41,2423
12/1/2020,VA,Virginia,Brunswick,51025,4126,3025,1101,3474,35,3439,652,16,636,3866,2765,1101,3109,2128,981,1083,127,38,1861
12/1/2020,VA,Virginia,Buchanan,51027,7148,3624,3524,4693,23,4670,2455,16,2439,6913,3389,3524,5969,3229,2740,1701,382,105,3781
12/1/2020,VA,Virginia,Buckingham,51029,3765,2934,831,3104,21,3083,661,19,642,3522,2691,831,2750,2120,630,821,131,42,1756
12/1/2020,VA,Virginia,Buena Vista City,51530,1509,1142,367,1239,*,*,270,*,*,1408,1041,367,1111,791,320,317,60,14,720
12/1/2020,VA,Virginia,Campbell,51031,13418,10094,3324,11280,76,11204,2138,59,2079,12596,9272,3324,10377,7397,2980,2190,366,120,7701
12/1/2020,VA,Virginia,Caroline,51033,6252,4738,1514,5336,41,5295,916,30,886,5654,4140,1514,3961,2615,1346,914,196,37,2814
12/1/2020,VA,Virginia,Carroll,51035,8615,6797,1818,7179,27,7152,1436,17,1419,8199,6381,1818,6537,4991,1546,1658,258,99,4522
12/1/2020,VA,Virginia,Charles City,51036,2001,1426,575,1727,18,1709,274,12,262,1832,1257,575,1421,913,508,266,80,15,1060
12/1/2020,VA,Virginia,Charlotte,51037,3299,2557,742,2736,16,2720,563,16,547,3098,2356,742,2498,1834,664,740,123,34,1601
12/1/2020,VA,Virginia,Charlottesville City,51540,6426,5366,1060,5464,26,5438,962,40,922,5750,4691,1059,4730,3744,986,1250,149,36,3295
12/1/2020,VA,Virginia,Chesapeake City,51550,40787,30192,10595,35579,271,35308,5208,213,4995,36919,26326,10593,23224,13628,9596,4474,952,204,17594
12/1/2020,VA,Virginia,Chesterfield,51041,64732,46812,17920,57446,236,57210,7286,255,7031,58581,40665,17916,46236,30010,16226,6076,1022,250,38888
12/1/2020,VA,Virginia,Clarke,51043,3470,2928,542,3216,*,*,254,*,*,3119,2577,542,2203,1781,422,299,72,27,1805
12/1/2020,VA,Virginia,Colonial Heights City,51570,4176,3266,910,3585,*,*,591,*,*,3839,2929,910,2609,1789,820,537,101,15,1956
12/1/2020,VA,Virginia,Covington City,51580,1576,1231,345,1222,15,1207,354,*,*,1479,1134,345,1215,892,323,343,48,15,809
12/1/2020,VA,Virginia,Craig,51045,1381,969,412,1099,*,*,282,*,*,1286,874,412,1042,667,375,206,*,*,775
12/1/2020,VA,Virginia,Culpeper,51047,9985,8214,1771,8791,29,8762,1194,37,1157,9046,7276,1770,6405,5049,1356,1293,233,63,4816
12/1/2020,VA,Virginia,Cumberland,51049,2417,1745,672,2012,12,2000,405,*,*,2237,1565,672,1809,1212,597,472,92,24,1221
12/1/2020,VA,Virginia,Danville City,51590,11170,7125,4045,8874,82,8792,2296,125,2171,10494,6449,4045,9101,5923,3178,3357,393,154,5197
12/1/2020,VA,Virginia,Dickenson,51051,4906,2322,2584,3257,*,*,1649,*,*,4720,2136,2584,4025,1689,2336,1159,214,62,2590
12/1/2020,VA,Virginia,Dinwiddie,51053,6199,4486,1713,5113,32,5081,1086,36,1050,5732,4019,1713,4401,2783,1618,989,190,51,3171
12/1/2020,VA,Virginia,Emporia City,51595,1324,865,459,1051,18,1033,273,*,*,1242,783,459,1024,617,407,442,71,12,499
12/1/2020,VA,Virginia,Essex,51057,3063,2317,746,2638,12,2626,425,16,409,2840,2094,746,2199,1586,613,501,86,37,1575
12/1/2020,VA,Virginia,Fairfax,51059,160656,126394,34262,152417,545,151872,8239,424,7815,130084,95840,34244,80349,50651,29698,14966,2678,582,62123
12/1/2020,VA,Virginia,Fairfax City,51600,4041,3144,897,3794,13,3781,247,14,233,3384,2487,897,2224,1482,742,406,69,17,1732
12/1/2020,VA,Virginia,Falls Church City,51610,2165,1750,415,2091,*,*,74,*,*,1706,1291,415,1102,737,365,142,*,*,945
12/1/2020,VA,Virginia,Fauquier,51061,13362,11408,1954,12311,74,12237,1051,33,1018,11859,9905,1954,7941,6462,1479,1020,192,53,6676
12/1/2020,VA,Virginia,Floyd,51063,4269,3214,1055,3731,*,*,538,*,*,3989,2935,1054,3265,2273,992,644,101,39,2481
12/1/2020,VA,Virginia,Fluvanna,51065,6390,5353,1037,5747,21,5726,643,18,625,5829,4792,1037,4370,3527,843,619,110,29,3612
12/1/2020,VA,Virginia,Franklin,51067,15506,10505,5001,13202,56,13146,2304,33,2271,14581,9580,5001,12082,7568,4514,2147,459,146,9330
12/1/2020,VA,Virginia,Franklin City,51620,2199,1688,511,1787,16,1771,412,23,389,2065,1554,511,1681,1208,473,566,63,14,1038
12/1/2020,VA,Virginia,Frederick,51069,17655,14336,3319,15881,64,15817,1774,50,1724,16048,12731,3317,11438,8729,2709,1531,375,120,9412
12/1/2020,VA,Virginia,Fredericksburg City,51630,4298,3380,918,3600,23,3577,698,26,672,3815,2897,918,2704,1873,831,858,85,27,1734
12/1/2020,VA,Virginia,Galax City,51640,1762,1473,289,1416,*,*,346,*,*,1673,1384,289,1393,1143,250,586,51,21,735
12/1/2020,VA,Virginia,Giles,51071,4616,3375,1241,3701,17,3684,915,15,900,4369,3128,1241,3661,2737,924,822,101,37,2701
12/1/2020,VA,Virginia,Gloucester,51073,9107,7210,1897,7971,44,7927,1136,23,1113,8406,6510,1896,5581,3912,1669,1047,181,56,4297
12/1/2020,VA,Virginia,Goochland,51075,6312,4826,1486,5833,28,5805,479,13,466,5808,4322,1486,4880,3618,1262,439,95,24,4322
12/1/2020,VA,Virginia,Grayson,51077,4634,3481,1153,3848,15,3833,786,*,*,4444,3291,1153,3516,2464,1052,944,181,79,2312
12/1/2020,VA,Virginia,Greene,51079,4187,3502,685,3679,13,3666,508,12,496,3807,3122,685,2835,2229,606,502,83,22,2228
12/1/2020,VA,Virginia,Greensville,51081,2134,1408,726,1720,17,1703,414,15,399,1981,1255,726,1629,1032,597,469,93,17,1050
12/1/2020,VA,Virginia,Halifax,51083,9942,7827,2115,8288,50,8238,1654,52,1602,9311,7196,2115,7569,5660,1909,2153,397,123,4896
12/1/2020,VA,Virginia,Hampton City,51650,26287,17931,8356,21937,210,21727,4350,208,4142,23956,15601,8355,15371,7483,7888,4276,732,159,10204
12/1/2020,VA,Virginia,Hanover,51085,22666,16532,6134,20785,92,20693,1881,49,1832,20703,14571,6132,17007,11844,5163,1584,299,84,15040
12/1/2020,VA,Virginia,Harrisonburg City,51660,5642,4739,903,4806,20,4786,836,19,817,5132,4229,903,4149,3419,730,1035,135,44,2935
12/1/2020,VA,Virginia,Henrico,51087,59789,41266,18523,52767,341,52426,7022,299,6723,54162,35639,18523,45069,28471,16598,7204,1366,356,36143
12/1/2020,VA,Virginia,Henry,51089,14928,9469,5459,11996,74,11922,2932,69,2863,14232,8774,5458,12362,7227,5135,3123,700,206,8333
12/1/2020,VA,Virginia,Highland,51091,822,721,101,748,0,748,74,0,74,775,674,101,592,511,81,64,*,*,501
12/1/2020,VA,Virginia,Hopewell City,51670,4601,3216,1385,3592,25,3567,1009,28,981,4271,2886,1385,3082,1757,1325,1092,143,32,1815
12/1/2020,VA,Virginia,Isle of Wight,51093,8853,6679,2174,7853,53,7800,1000,32,968,8195,6021,2174,5845,3835,2010,1037,195,56,4557
12/1/2020,VA,Virginia,James City,51095,21896,18116,3780,20631,56,20575,1265,40,1225,20313,16535,3778,13404,10452,2952,1001,232,57,12114
12/1/2020,VA,Virginia,King and Queen,51097,1828,1406,422,1568,*,*,260,*,*,1698,1276,422,1300,928,372,280,*,*,945
12/1/2020,VA,Virginia,King George,51099,4243,3609,634,3709,21,3688,534,19,515,3682,3048,634,1929,1374,555,483,70,20,1356
12/1/2020,VA,Virginia,King William,51101,3660,2849,811,3150,22,3128,510,31,479,3392,2581,811,2777,2049,728,443,96,17,2221
12/1/2020,VA,Virginia,Lancaster,51103,4408,3638,770,4086,22,4064,322,16,306,4164,3395,769,3105,2550,555,500,90,12,2503
12/1/2020,VA,Virginia,Lee,51105,6411,2920,3491,4537,15,4522,1874,17,1857,6107,2619,3488,5144,1995,3149,1986,230,60,2868
12/1/2020,VA,Virginia,Lexington City,51678,1366,1145,221,1251,*,*,115,*,*,1261,1041,220,996,803,193,177,*,*,780
12/1/2020,VA,Virginia,Loudoun,51107,41943,32994,8949,39468,172,39296,2475,120,2355,34856,25911,8945,23985,16288,7697,3655,654,159,19517
12/1/2020,VA,Virginia,Louisa,51109,8921,6807,2114,7620,51,7569,1301,37,1264,8174,6060,2114,6180,4321,1859,1202,248,52,4678
12/1/2020,VA,Virginia,Lunenburg,51111,3204,2520,684,2690,15,2675,514,11,503,2972,2288,684,2310,1687,623,765,110,37,1398
12/1/2020,VA,Virginia,Lynchburg City,51680,14839,10977,3862,12244,79,12165,2595,102,2493,13798,9936,3862,11476,7946,3530,3127,423,122,7804
12/1/2020,VA,Virginia,Madison,51113,3430,2799,631,3081,11,3070,349,*,*,3189,2558,631,2398,1886,512,441,82,15,1860
12/1/2020,VA,Virginia,Manassas City,51683,4875,3720,1155,4334,23,4311,541,40,501,4090,2935,1155,2923,1918,1005,597,97,25,2204
12/1/2020,VA,Virginia,Manassas Park City,51685,1369,949,420,1202,13,1189,167,12,155,1147,727,420,837,451,386,222,*,*,552
12/1/2020,VA,Virginia,Martinsville City,51690,3824,2441,1383,2916,39,2877,908,33,875,3613,2230,1383,3155,1829,1326,1294,169,47,1645
12/1/2020,VA,Virginia,Mathews,51115,2950,2350,600,2708,11,2697,242,*,*,2784,2184,600,2053,1558,495,290,35,20,1708
12/1/2020,VA,Virginia,Mecklenburg,51117,9453,7179,2274,7959,53,7906,1494,64,1430,8880,6606,2274,7119,5104,2015,1863,361,87,4808
12/1/2020,VA,Virginia,Middlesex,51119,3737,3028,709,3389,15,3374,348,*,*,3515,2806,709,2703,2134,569,465,74,23,2141
12/1/2020,VA,Virginia,Montgomery,51121,14525,11150,3375,12281,49,12232,2244,31,2213,13069,9694,3375,11026,7972,3054,2000,329,95,8602
12/1/2020,VA,Virginia,Nelson,51125,4847,3967,880,4373,15,4358,474,*,*,4502,3623,879,3370,2603,767,597,106,34,2633
12/1/2020,VA,Virginia,New Kent,51127,5055,3952,1103,4574,19,4555,481,12,469,4609,3506,1103,3334,2457,877,344,76,19,2895
12/1/2020,VA,Virginia,Newport News City,51700,29635,20081,9554,24632,208,24424,5003,237,4766,27104,17551,9553,18353,9239,9114,5419,852,191,11891
12/1/2020,VA,Virginia,Norfolk City,51710,34301,23028,11273,27976,278,27698,6325,306,6019,30838,19566,11272,21590,10819,10771,7767,1265,254,12304
12/1/2020,VA,Virginia,Northampton,51131,3813,2882,931,3348,18,3330,465,19,446,3559,2628,931,2875,2063,812,906,82,25,1862
12/1/2020,VA,Virginia,Northumberland,51133,4728,3877,851,4392,11,4381,336,*,*,4431,3580,851,3049,2468,581,444,76,22,2507
12/1/2020,VA,Virginia,Norton City,51720,1136,597,539,793,*,*,343,*,*,1066,527,539,915,428,487,344,*,*,516
12/1/2020,VA,Virginia,Nottoway,51135,3687,2792,895,3037,22,3015,650,17,633,3419,2524,895,2730,1968,762,895,121,43,1671
12/1/2020,VA,Virginia,Orange,51137,9034,7475,1559,8038,49,7989,996,29,967,8256,6697,1559,5688,4524,1164,1022,191,53,4422
12/1/2020,VA,Virginia,Page,51139,6357,5229,1128,5313,15,5298,1044,19,1025,5925,4797,1128,4431,3463,968,1101,240,58,3032
12/1/2020,VA,Virginia,Patrick,51141,5540,3948,1592,4633,11,4622,907,*,*,5292,3701,1591,4355,2957,1398,1065,186,60,3044
12/1/2020,VA,Virginia,Petersburg City,51730,7249,4566,2683,5468,89,5379,1781,76,1705,6603,3920,2683,5059,2447,2612,2215,321,53,2470
12/1/2020,VA,Virginia,Pittsylvania,51143,16681,11103,5578,13914,94,13820,2767,68,2699,15701,10123,5578,13281,8942,4339,3092,520,159,9510
12/1/2020,VA,Virginia,Poquoson City,51735,2673,2272,401,2499,*,*,174,*,*,2453,2052,401,1322,969,353,125,*,*,1163
12/1/2020,VA,Virginia,Portsmouth City,51740,18779,12568,6211,14846,175,14671,3933,194,3739,16836,10626,6210,11693,5742,5951,4310,678,119,6586
12/1/2020,VA,Virginia,Powhatan,51145,6484,4975,1509,5903,11,5892,581,12,569,5983,4474,1509,4894,3596,1298,424,102,26,4342
12/1/2020,VA,Virginia,Prince Edward,51147,4754,3595,1159,3895,33,3862,859,29,830,4404,3246,1158,3523,2543,980,1075,162,43,2243
12/1/2020,VA,Virginia,Prince George,51149,6456,5327,1129,5510,36,5474,946,30,916,5975,4847,1128,3782,2760,1022,630,122,28,3002
12/1/2020,VA,Virginia,Prince William,51153,53036,40658,12378,47891,284,47607,5145,311,4834,45163,32789,12374,27119,15982,11137,5612,1140,216,20151
12/1/2020,VA,Virginia,Pulaski,51155,9244,7012,2232,7502,24,7478,1742,32,1710,8643,6411,2232,7187,5209,1978,1635,275,87,5190
12/1/2020,VA,Virginia,Radford City,51750,2094,1583,511,1722,*,*,372,*,*,1890,1379,511,1632,1162,470,342,45,21,1224
12/1/2020,VA,Virginia,Rappahannock,51157,2045,1790,255,1916,*,*,129,*,*,1850,1596,254,1293,1105,188,162,34,15,1082
12/1/2020,VA,Virginia,Richmond,51159,1978,1514,464,1730,*,*,248,11,237,1838,1374,464,1398,1059,339,327,64,12,995
12/1/2020,VA,Virginia,Richmond City,51760,35165,21275,13890,28538,252,28286,6627,296,6331,31754,17866,13888,27408,14166,13242,9265,1295,262,16586
12/1/2020,VA,Virginia,Roanoke,51161,24353,17592,6761,21772,96,21676,2581,58,2523,22494,15735,6759,18468,12575,5893,2153,451,123,15741
12/1/2020,VA,Virginia,Roanoke City,51770,21448,13637,7811,16667,148,16519,4781,135,4646,19595,11787,7808,16316,9021,7295,5029,857,183,10247
12/1/2020,VA,Virginia,Rockbridge,51163,6525,5171,1354,5633,*,*,892,*,*,6074,4720,1354,4667,3496,1171,902,169,51,3545
12/1/2020,VA,Virginia,Rockingham,51165,18572,15591,2981,16481,50,16431,2091,42,2049,17214,14233,2981,13678,11416,2262,1917,495,137,11129
12/1/2020,VA,Virginia,Russell,51167,8041,4378,3663,5737,15,5722,2304,18,2286,7732,4070,3662,6724,3647,3077,1767,327,142,4488
12/1/2020,VA,Virginia,Salem City,51775,6096,4516,1580,5218,27,5191,878,15,863,5599,4019,1580,4588,3156,1432,853,120,41,3574
12/1/2020,VA,Virginia,Scott,51169,6791,2814,3977,5226,14,5212,1565,15,1550,6523,2546,3977,5751,1952,3799,1543,247,105,3856
12/1/2020,VA,Virginia,Shenandoah,51171,10953,8895,2058,9793,31,9762,1160,20,1140,10280,8222,2058,7578,5852,1726,1324,250,80,5924
12/1/2020,VA,Virginia,Smyth,51173,8704,5677,3027,6639,28,6611,2065,25,2040,8269,5242,3027,6948,4103,2845,2109,350,129,4360
12/1/2020,VA,Virginia,Southampton,51175,4077,3224,853,3465,26,3439,612,26,586,3783,2930,853,2990,2231,759,711,119,27,2133
12/1/2020,VA,Virginia,Spotsylvania,51177,22914,18492,4422,20137,111,20026,2777,101,2676,20312,15891,4421,12695,8925,3770,2209,549,126,9811
12/1/2020,VA,Virginia,Stafford,51179,19171,16051,3120,17105,104,17001,2066,87,1979,16813,13695,3118,8816,6143,2673,1623,349,81,6763
12/1/2020,VA,Virginia,Staunton City,51790,6341,5069,1272,5368,20,5348,973,16,957,5964,4692,1272,4772,3651,1121,1104,152,49,3467
12/1/2020,VA,Virginia,Suffolk City,51800,17502,12783,4719,14568,115,14453,2934,114,2820,16044,11325,4719,11115,6749,4366,2931,481,102,7601
12/1/2020,VA,Virginia,Surry,51181,1760,1282,478,1530,11,1519,230,*,*,1630,1152,478,1223,774,449,229,56,13,925
12/1/2020,VA,Virginia,Sussex,51183,2550,1795,755,2090,24,2066,460,*,*,2381,1626,755,1848,1134,714,527,136,19,1166
12/1/2020,VA,Virginia,Tazewell,51185,12003,7345,4658,9054,27,9027,2949,35,2914,11424,6768,4656,9317,5747,3570,2376,460,133,6348
12/1/2020,VA,Virginia,Unknown,51999,*,*,*,*,*,*,*,*,*,*,*,*,*,*,*,*,*,*,*
12/1/2020,VA,Virginia,Virginia Beach City,51810,76770,59635,17135,68250,363,67887,8520,347,8173,70340,53213,17127,41858,26230,15628,7539,1482,378,32459
12/1/2020,VA,Virginia,Warren,51187,8222,6865,1357,7187,21,7166,1035,35,1000,7479,6122,1357,5212,4104,1108,980,214,66,3952
12/1/2020,VA,Virginia,Washington,51191,15292,8922,6370,12569,39,12530,2723,33,2690,14434,8065,6369,12179,6271,5908,2467,559,185,8968
12/1/2020,VA,Virginia,Waynesboro City,51820,5107,4039,1068,4255,16,4239,852,24,828,4792,3724,1068,3865,2888,977,967,114,45,2739
12/1/2020,VA,Virginia,Westmoreland,51193,5244,4316,928,4657,22,4635,587,17,570,4780,3852,928,3207,2412,795,850,139,41,2177
12/1/2020,VA,Virginia,Williamsburg City,51830,2882,2318,564,2638,*,*,244,*,*,2662,2098,564,1925,1445,480,275,*,*,1607
12/1/2020,VA,Virginia,Winchester City,51840,5643,4617,1026,4878,26,4852,765,22,743,5141,4116,1025,3805,2931,874,919,136,37,2713
12/1/2020,VA,Virginia,Wise,51195,10651,5012,5639,7381,21,7360,3270,22,3248,10085,4447,5638,8336,3395,4941,2482,468,153,5233
12/1/2020,VA,Virginia,Wythe,51197,7985,5519,2466,6322,29,6293,1663,15,1648,7552,5086,2466,6278,4058,2220,1697,283,92,4206
12/1/2020,VA,Virginia,York,51199,12815,10671,2144,11836,38,11798,979,39,940,11737,9593,2144,6427,4561,1866,740,156,36,5495
2/1/2020,VA,Virginia,Accomack,51001,9137,7278,1859,8000,63,7937,1137,43,1094,8470,6612,1858,6348,4845,1503,1512,361,95,4380
2/1/2020,VA,Virginia,Albemarle,51003,21954,19072,2882,20469,77,20392,1485,38,1447,19763,16884,2879,15479,13048,2431,1576,286,107,13510
2/1/2020,VA,Virginia,Alexandria City,51510,18263,14765,3498,16976,77,16899,1287,74,1213,14720,11224,3496,9351,6210,3141,2124,302,67,6858
2/1/2020,VA,Virginia,Alleghany,51005,4631,3692,939,3800,24,3776,831,13,818,4380,3441,939,3613,2816,797,828,111,50,2624
2/1/2020,VA,Virginia,Amelia,51007,3139,2211,928,2696,*,*,443,16,427,2888,1960,928,2345,1485,860,467,86,36,1756
2/1/2020,VA,Virginia,Amherst,51009,7935,5961,1974,6704,54,6650,1231,31,1200,7391,5417,1974,6103,4325,1778,1225,201,78,4599
2/1/2020,VA,Virginia,Appomattox,51011,4030,3081,949,3371,21,3350,659,22,637,3783,2834,949,3139,2273,866,692,95,50,2302
2/1/2020,VA,Virginia,Arlington,51013,24936,20655,4281,23442,114,23328,1494,77,1417,19662,15381,4281,12366,8498,3868,2967,383,130,8886
2/1/2020,VA,Virginia,Augusta,51015,18726,15372,3354,16403,69,16334,2323,54,2269,17565,14211,3354,13929,11044,2885,1896,406,146,11481
2/1/2020,VA,Virginia,Bath,51017,1280,1129,151,1127,*,*,153,0,153,1213,1062,151,965,833,132,158,38,15,754
2/1/2020,VA,Virginia,Bedford,51019,20229,15915,4314,17646,92,17554,2583,45,2538,18809,14496,4313,15014,11710,3304,2019,486,150,12359
2/1/2020,VA,Virginia,Bland,51021,1826,1308,518,1465,*,*,361,*,*,1718,1200,518,1361,972,389,229,60,20,1052
2/1/2020,VA,Virginia,Botetourt,51023,8867,6447,2420,7865,48,7817,1002,21,981,8262,5842,2420,6661,4573,2088,719,165,52,5725
2/1/2020,VA,Virginia,Bristol City,51520,4681,2385,2296,3751,*,*,930,13,917,4391,2095,2296,3773,1569,2204,1126,146,50,2451
2/1/2020,VA,Virginia,Brunswick,51025,4109,3118,991,3476,40,3436,633,17,616,3840,2849,991,3099,2228,871,1073,125,48,1853
2/1/2020,VA,Virginia,Buchanan,51027,7220,3764,3456,4799,29,4770,2421,19,2402,6961,3505,3456,6001,3351,2650,1637,391,115,3858
2/1/2020,VA,Virginia,Buckingham,51029,3712,2958,754,3084,21,3063,628,17,611,3479,2725,754,2706,2170,536,787,140,44,1735
2/1/2020,VA,Virginia,Buena Vista City,51530,1501,1155,346,1246,*,*,255,*,*,1393,1047,346,1107,812,295,297,59,18,733
2/1/2020,VA,Virginia,Campbell,51031,13285,10134,3151,11225,94,11131,2060,60,2000,12461,9310,3151,10274,7471,2803,2075,379,130,7690
2/1/2020,VA,Virginia,Caroline,51033,6126,4672,1454,5227,45,5182,899,34,865,5521,4067,1454,3888,2609,1279,866,212,39,2771
2/1/2020,VA,Virginia,Carroll,51035,8605,6909,1696,7216,32,7184,1389,18,1371,8163,6467,1696,6517,5109,1408,1628,268,102,4519
2/1/2020,VA,Virginia,Charles City,51036,1978,1423,555,1711,20,1691,267,14,253,1815,1260,555,1416,925,491,261,72,17,1066
2/1/2020,VA,Virginia,Charlotte,51037,3287,2575,712,2733,18,2715,554,16,538,3084,2372,712,2479,1844,635,728,123,41,1587
2/1/2020,VA,Virginia,Charlottesville City,51540,6333,5387,946,5388,31,5357,945,44,901,5691,4746,945,4676,3808,868,1225,146,38,3267
2/1/2020,VA,Virginia,Chesapeake City,51550,39807,29762,10045,34804,324,34480,5003,226,4777,36013,25969,10044,22804,13783,9021,4230,972,228,17374
2/1/2020,VA,Virginia,Chesterfield,51041,63125,45868,17257,56105,271,55834,7020,249,6771,57034,39781,17253,45088,29567,15521,5666,1069,271,38082
2/1/2020,VA,Virginia,Clarke,51043,3424,2893,531,3176,12,3164,248,*,*,3084,2553,531,2179,1777,402,293,67,26,1793
2/1/2020,VA,Virginia,Colonial Heights City,51570,4170,3283,887,3589,12,3577,581,*,*,3822,2935,887,2606,1814,792,511,110,18,1967
2/1/2020,VA,Virginia,Covington City,51580,1580,1246,334,1238,18,1220,342,*,*,1481,1147,334,1218,906,312,326,43,15,834
2/1/2020,VA,Virginia,Craig,51045,1370,972,398,1094,*,*,276,*,*,1279,881,398,1047,679,368,215,45,13,774
2/1/2020,VA,Virginia,Culpeper,51047,9763,8054,1709,8608,34,8574,1155,43,1112,8866,7158,1708,6308,5013,1295,1235,234,61,4778
2/1/2020,VA,Virginia,Cumberland,51049,2402,1771,631,2012,16,1996,390,*,*,2223,1592,631,1795,1237,558,451,93,31,1220
2/1/2020,VA,Virginia,Danville City,51590,11110,7330,3780,8889,94,8795,2221,125,2096,10424,6644,3780,9059,6156,2903,3238,394,169,5258
2/1/2020,VA,Virginia,Dickenson,51051,4925,2392,2533,3303,*,*,1622,*,*,4739,2206,2533,4066,1780,2286,1151,220,74,2621
2/1/2020,VA,Virginia,Dinwiddie,51053,6146,4537,1609,5067,44,5023,1079,39,1040,5663,4054,1609,4337,2822,1515,954,194,49,3140
2/1/2020,VA,Virginia,Emporia City,51595,1345,919,426,1068,21,1047,277,11,266,1266,840,426,1034,669,365,450,72,11,501
2/1/2020,VA,Virginia,Essex,51057,3020,2307,713,2610,16,2594,410,16,394,2777,2064,713,2164,1587,577,476,88,38,1562
2/1/2020,VA,Virginia,Fairfax,51059,155357,123595,31762,147536,643,146893,7821,439,7382,125296,93557,31739,77249,50021,27228,14306,2681,579,59683
2/1/2020,VA,Virginia,Fairfax City,51600,3936,3089,847,3701,15,3686,235,14,221,3307,2461,846,2152,1454,698,392,71,18,1671
2/1/2020,VA,Virginia,Falls Church City,51610,2116,1712,404,2043,*,*,73,*,*,1667,1263,404,1080,729,351,134,*,*,932
2/1/2020,VA,Virginia,Fauquier,51061,13069,11221,1848,12052,82,11970,1017,35,982,11592,9744,1848,7783,6407,1376,981,183,63,6556
2/1/2020,VA,Virginia,Floyd,51063,4260,3238,1022,3739,13,3726,521,*,*,3985,2964,1021,3259,2302,957,633,107,44,2475
2/1/2020,VA,Virginia,Fluvanna,51065,6256,5262,994,5654,28,5626,602,19,583,5699,4705,994,4287,3491,796,577,113,31,3566
2/1/2020,VA,Virginia,Franklin,51067,15327,10495,4832,13074,62,13012,2253,35,2218,14363,9531,4832,11946,7611,4335,2074,466,150,9256
2/1/2020,VA,Virginia,Franklin City,51620,2192,1705,487,1793,21,1772,399,21,378,2047,1560,487,1683,1234,449,553,60,17,1053
2/1/2020,VA,Virginia,Frederick,51069,17365,14161,3204,15664,77,15587,1701,46,1655,15781,12579,3202,11270,8688,2582,1453,376,127,9314
2/1/2020,VA,Virginia,Fredericksburg City,51630,4235,3400,835,3540,27,3513,695,26,669,3745,2910,835,2674,1928,746,843,81,35,1715
2/1/2020,VA,Virginia,Galax City,51640,1765,1519,246,1427,*,*,338,*,*,1673,1427,246,1392,1186,206,585,47,25,735
2/1/2020,VA,Virginia,Giles,51071,4629,3419,1210,3727,22,3705,902,16,886,4373,3163,1210,3682,2805,877,831,110,36,2705
2/1/2020,VA,Virginia,Gloucester,51073,8917,7112,1805,7820,53,7767,1097,20,1077,8214,6410,1804,5496,3924,1572,1025,176,56,4239
2/1/2020,VA,Virginia,Goochland,51075,6142,4702,1440,5676,29,5647,466,15,451,5659,4219,1440,4745,3532,1213,427,99,28,4191
2/1/2020,VA,Virginia,Grayson,51077,4629,3523,1106,3859,17,3842,770,*,*,4434,3328,1106,3520,2521,999,952,183,89,2296
2/1/2020,VA,Virginia,Greene,51079,4079,3438,641,3594,14,3580,485,12,473,3703,3062,641,2768,2213,555,476,81,30,2181
2/1/2020,VA,Virginia,Greensville,51081,2131,1441,690,1737,23,1714,394,13,381,1974,1284,690,1631,1078,553,446,103,25,1057
2/1/2020,VA,Virginia,Halifax,51083,9909,7963,1946,8307,65,8242,1602,56,1546,9291,7345,1946,7564,5833,1731,2151,413,136,4864
2/1/2020,VA,Virginia,Hampton City,51650,25846,17916,7930,21647,245,21402,4199,209,3990,23499,15569,7930,15106,7649,7457,4046,756,174,10130
2/1/2020,VA,Virginia,Hanover,51085,22205,16328,5877,20374,110,20264,1831,48,1783,20267,14391,5876,16630,11713,4917,1524,310,97,14699
2/1/2020,VA,Virginia,Harrisonburg City,51660,5601,4762,839,4791,27,4764,810,21,789,5087,4248,839,4119,3462,657,1016,136,48,2919
2/1/2020,VA,Virginia,Henrico,51087,58817,41013,17804,52062,404,51658,6755,283,6472,53219,35416,17803,44256,28452,15804,6894,1397,373,35592
2/1/2020,VA,Virginia,Henry,51089,14953,9769,5184,12085,92,11993,2868,74,2794,14223,9039,5184,12351,7500,4851,3055,705,232,8359
2/1/2020,VA,Virginia,Highland,51091,806,708,98,736,0,736,70,*,*,759,661,98,581,502,79,58,*,*,496
2/1/2020,VA,Virginia,Hopewell City,51670,4594,3300,1294,3614,33,3581,980,28,952,4254,2960,1294,3068,1830,1238,1035,137,41,1855
2/1/2020,VA,Virginia,Isle of Wight,51093,8652,6555,2097,7698,62,7636,954,34,920,8003,5906,2097,5745,3815,1930,998,197,72,4478
2/1/2020,VA,Virginia,James City,51095,21604,17960,3644,20389,72,20317,1215,46,1169,19944,16302,3642,13158,10359,2799,934,247,63,11914
2/1/2020,VA,Virginia,King and Queen,51097,1805,1400,405,1551,11,1540,254,*,*,1681,1276,405,1297,942,355,269,*,*,957
2/1/2020,VA,Virginia,King George,51099,4134,3568,566,3633,25,3608,501,21,480,3590,3024,566,1881,1396,485,457,69,17,1338
2/1/2020,VA,Virginia,King William,51101,3582,2832,750,3096,26,3070,486,31,455,3313,2563,750,2720,2060,660,420,104,15,2181
2/1/2020,VA,Virginia,Lancaster,51103,4415,3689,726,4097,26,4071,318,16,302,4158,3433,725,3108,2612,496,503,91,17,2497
2/1/2020,VA,Virginia,Lee,51105,6433,3057,3376,4589,17,4572,1844,21,1823,6116,2743,3373,5155,2127,3028,1967,242,72,2874
2/1/2020,VA,Virginia,Lexington City,51678,1363,1161,202,1255,*,*,108,*,*,1232,1031,201,966,795,171,174,27,12,753
2/1/2020,VA,Virginia,Loudoun,51107,40530,32071,8459,38174,192,37982,2356,120,2236,33703,25249,8454,23229,16031,7198,3431,652,158,18988
2/1/2020,VA,Virginia,Louisa,51109,8685,6724,1961,7434,58,7376,1251,39,1212,7962,6001,1961,6032,4325,1707,1129,254,63,4586
2/1/2020,VA,Virginia,Lunenburg,51111,3154,2521,633,2657,18,2639,497,13,484,2923,2290,633,2269,1699,570,716,117,40,1396
2/1/2020,VA,Virginia,Lynchburg City,51680,14686,11147,3539,12190,95,12095,2496,105,2391,13634,10095,3539,11338,8138,3200,2995,437,134,7772
2/1/2020,VA,Virginia,Madison,51113,3348,2756,592,3008,16,2992,340,11,329,3103,2511,592,2349,1874,475,424,84,16,1825
2/1/2020,VA,Virginia,Manassas City,51683,4692,3612,1080,4186,28,4158,506,41,465,3956,2876,1080,2824,1897,927,564,94,30,2136
2/1/2020,VA,Virginia,Manassas Park City,51685,1346,951,395,1175,16,1159,171,13,158,1118,723,395,824,466,358,209,*,*,555
2/1/2020,VA,Virginia,Martinsville City,51690,3823,2542,1281,2931,40,2891,892,37,855,3612,2331,1281,3136,1913,1223,1277,175,51,1633
2/1/2020,VA,Virginia,Mathews,51115,2916,2349,567,2679,12,2667,237,*,*,2745,2178,567,2005,1539,466,292,36,18,1659
2/1/2020,VA,Virginia,Mecklenburg,51117,9397,7264,2133,7944,62,7882,1453,65,1388,8812,6679,2133,7045,5181,1864,1800,378,92,4775
2/1/2020,VA,Virginia,Middlesex,51119,3690,3017,673,3351,16,3335,339,*,*,3460,2787,673,2673,2151,522,463,77,25,2108
2/1/2020,VA,Virginia,Montgomery,51121,14372,11186,3186,12191,60,12131,2181,31,2150,12950,9764,3186,10916,8065,2851,1947,332,117,8520
2/1/2020,VA,Virginia,Nelson,51125,4758,3933,825,4301,21,4280,457,*,*,4389,3565,824,3314,2606,708,582,104,38,2590
2/1/2020,VA,Virginia,New Kent,51127,4881,3837,1044,4414,21,4393,467,11,456,4434,3390,1044,3229,2411,818,319,73,24,2813
2/1/2020,VA,Virginia,Newport News City,51700,29052,20014,9038,24270,251,24019,4782,239,4543,26516,17479,9037,18057,9484,8573,5062,884,202,11909
2/1/2020,VA,Virginia,Norfolk City,51710,33604,22970,10634,27505,319,27186,6099,324,5775,30190,19557,10633,21210,11089,10121,7362,1283,290,12275
2/1/2020,VA,Virginia,Northampton,51131,3798,2925,873,3349,24,3325,449,18,431,3530,2657,873,2883,2127,756,926,83,27,1847
2/1/2020,VA,Virginia,Northumberland,51133,4679,3844,835,4357,14,4343,322,12,310,4378,3543,835,3037,2475,562,431,73,27,2506
2/1/2020,VA,Virginia,Norton City,51720,1138,629,509,799,*,*,339,*,*,1060,551,509,901,446,455,348,48,11,494
2/1/2020,VA,Virginia,Nottoway,51135,3657,2834,823,3040,26,3014,617,15,602,3395,2572,823,2706,2015,691,876,125,42,1663
2/1/2020,VA,Virginia,Orange,51137,8918,7438,1480,7953,60,7893,965,28,937,8129,6649,1480,5620,4528,1092,992,188,57,4383
2/1/2020,VA,Virginia,Page,51139,6305,5244,1061,5310,24,5286,995,20,975,5886,4825,1061,4404,3506,898,1076,249,67,3012
2/1/2020,VA,Virginia,Patrick,51141,5540,4030,1510,4667,15,4652,873,*,*,5263,3754,1509,4343,3030,1313,1039,189,70,3045
2/1/2020,VA,Virginia,Petersburg City,51730,7199,4722,2477,5446,102,5344,1753,74,1679,6563,4086,2477,5033,2629,2404,2110,334,69,2520
2/1/2020,VA,Virginia,Pittsylvania,51143,16569,11243,5326,13872,106,13766,2697,71,2626,15565,10239,5326,13169,9062,4107,3024,520,177,9448
2/1/2020,VA,Virginia,Poquoson City,51735,2640,2249,391,2468,*,*,172,*,*,2425,2034,391,1295,951,344,118,*,*,1143
2/1/2020,VA,Virginia,Portsmouth City,51740,18589,12763,5826,14773,209,14564,3816,204,3612,16626,10801,5825,11506,5942,5564,4063,702,140,6601
2/1/2020,VA,Virginia,Powhatan,51145,6386,4902,1484,5823,15,5808,563,14,549,5876,4392,1484,4817,3546,1271,404,109,26,4278
2/1/2020,VA,Virginia,Prince Edward,51147,4715,3679,1036,3871,38,3833,844,34,810,4361,3325,1036,3481,2640,841,1063,151,50,2217
2/1/2020,VA,Virginia,Prince George,51149,6292,5226,1066,5376,39,5337,916,30,886,5819,4754,1065,3672,2723,949,608,123,28,2913
2/1/2020,VA,Virginia,Prince William,51153,51232,39710,11522,46342,334,46008,4890,302,4588,43572,32055,11517,26319,16074,10245,5277,1147,232,19663
2/1/2020,VA,Virginia,Pulaski,51155,9197,7036,2161,7514,33,7481,1683,31,1652,8573,6412,2161,7157,5257,1900,1598,288,96,5175
2/1/2020,VA,Virginia,Radford City,51750,2073,1580,493,1708,*,*,365,*,*,1876,1383,493,1610,1160,450,332,47,23,1208
2/1/2020,VA,Virginia,Rappahannock,51157,1976,1741,235,1852,*,*,124,*,*,1780,1546,234,1254,1087,167,149,39,11,1055
2/1/2020,VA,Virginia,Richmond,51159,1952,1525,427,1714,*,*,238,*,*,1817,1390,427,1380,1082,298,307,70,15,988
2/1/2020,VA,Virginia,Richmond City,51760,34751,21552,13199,28290,290,28000,6461,306,6155,31335,18138,13197,27098,14566,12532,8797,1362,300,16639
2/1/2020,VA,Virginia,Roanoke,51161,24045,17494,6551,21568,120,21448,2477,57,2420,22163,15614,6549,18283,12622,5661,2094,448,137,15604
2/1/2020,VA,Virginia,Roanoke City,51770,21388,13993,7395,16707,179,16528,4681,140,4541,19467,12075,7392,16238,9373,6865,4905,850,193,10290
2/1/2020,VA,Virginia,Rockbridge,51163,6442,5157,1285,5584,13,5571,858,*,*,5975,4690,1285,4597,3500,1097,872,173,59,3493
2/1/2020,VA,Virginia,Rockingham,51165,18309,15432,2877,16287,63,16224,2022,42,1980,16934,14058,2876,13474,11350,2124,1849,499,144,10982
2/1/2020,VA,Virginia,Russell,51167,8006,4516,3490,5757,17,5740,2249,22,2227,7676,4187,3489,6677,3771,2906,1697,339,153,4488
2/1/2020,VA,Virginia,Salem City,51775,6131,4599,1532,5274,32,5242,857,18,839,5655,4123,1532,4629,3249,1380,855,119,39,3616
2/1/2020,VA,Virginia,Scott,51169,6815,2879,3936,5280,16,5264,1535,16,1519,6536,2600,3936,5786,2029,3757,1516,251,111,3908
2/1/2020,VA,Virginia,Shenandoah,51171,10828,8848,1980,9708,41,9667,1120,22,1098,10113,8133,1980,7433,5795,1638,1295,265,86,5787
2/1/2020,VA,Virginia,Smyth,51173,8695,5782,2913,6681,37,6644,2014,26,1988,8248,5335,2913,6949,4236,2713,2099,362,130,4358
2/1/2020,VA,Virginia,Southampton,51175,4017,3208,809,3425,32,3393,592,26,566,3724,2915,809,2969,2249,720,684,122,31,2132
2/1/2020,VA,Virginia,Spotsylvania,51177,22291,18144,4147,19638,137,19501,2653,105,2548,19776,15631,4145,12443,8963,3480,2098,565,134,9646
2/1/2020,VA,Virginia,Stafford,51179,18568,15632,2936,16589,119,16470,1979,86,1893,16264,13330,2934,8647,6156,2491,1501,357,80,6709
2/1/2020,VA,Virginia,Staunton City,51790,6366,5170,1196,5398,22,5376,968,18,950,5987,4791,1196,4803,3768,1035,1106,152,55,3490
2/1/2020,VA,Virginia,Suffolk City,51800,17144,12699,4445,14316,139,14177,2828,112,2716,15723,11278,4445,10966,6890,4076,2860,479,120,7507
2/1/2020,VA,Virginia,Surry,51181,1765,1303,462,1543,14,1529,222,*,*,1626,1164,462,1230,800,430,222,59,12,937
2/1/2020,VA,Virginia,Sussex,51183,2519,1793,726,2084,31,2053,435,*,*,2348,1622,726,1836,1152,684,521,134,23,1158
2/1/2020,VA,Virginia,Tazewell,51185,12026,7451,4575,9148,38,9110,2878,39,2839,11448,6874,4574,9343,5922,3421,2293,472,151,6427
2/1/2020,VA,Virginia,Unknown,51999,*,*,*,*,*,*,*,*,*,*,*,*,*,*,*,*,*,*,*
2/1/2020,VA,Virginia,Virginia Beach City,51810,74948,58584,16364,66818,437,66381,8130,339,7791,68606,52250,16356,40960,26130,14830,7056,1510,404,31990
2/1/2020,VA,Virginia,Warren,51187,7991,6698,1293,7002,25,6977,989,37,952,7265,5972,1293,5065,4026,1039,917,219,68,3861
2/1/2020,VA,Virginia,Washington,51191,15187,8975,6212,12531,53,12478,2656,34,2622,14325,8114,6211,12087,6353,5734,2390,550,210,8937
2/1/2020,VA,Virginia,Waynesboro City,51820,5059,4076,983,4235,20,4215,824,26,798,4719,3736,983,3814,2926,888,923,122,44,2725
2/1/2020,VA,Virginia,Westmoreland,51193,5174,4318,856,4604,29,4575,570,17,553,4723,3867,856,3144,2423,721,793,138,47,2166
2/1/2020,VA,Virginia,Williamsburg City,51830,2861,2317,544,2630,*,*,231,*,*,2633,2089,544,1908,1452,456,263,*,*,1598
2/1/2020,VA,Virginia,Winchester City,51840,5592,4610,982,4850,28,4822,742,22,720,5090,4109,981,3771,2943,828,887,141,41,2702
2/1/2020,VA,Virginia,Wise,51195,10661,5193,5468,7468,28,7440,3193,28,3165,10066,4599,5467,8341,3589,4752,2441,484,169,5247
2/1/2020,VA,Virginia,Wythe,51197,7984,5626,2358,6360,40,6320,1624,18,1606,7546,5188,2358,6267,4167,2100,1665,294,108,4200
2/1/2020,VA,Virginia,York,51199,12463,10421,2042,11523,47,11476,940,37,903,11426,9384,2042,6307,4550,1757,698,158,36,5415
1/1/2020,VA,Virginia,Accomack,51001,9124,7280,1844,7997,62,7935,1127,42,1085,8451,6608,1843,6334,4849,1485,1502,363,95,4374
1/1/2020,VA,Virginia,Albemarle,51003,21938,19050,2888,20456,78,20378,1482,38,1444,19742,16857,2885,15466,13032,2434,1574,288,108,13496
1/1/2020,VA,Virginia,Alexandria City,51510,18236,14737,3499,16952,78,16874,1284,77,1207,14724,11227,3497,9349,6209,3140,2120,304,65,6860
1/1/2020,VA,Virginia,Alleghany,51005,4633,3697,936,3809,24,3785,824,13,811,4388,3452,936,3617,2824,793,822,111,50,2634
1/1/2020,VA,Virginia,Amelia,51007,3129,2206,923,2688,11,2677,441,16,425,2888,1965,923,2333,1482,851,463,87,37,1746
1/1/2020,VA,Virginia,Amherst,51009,7932,5961,1971,6706,56,6650,1226,31,1195,7385,5414,1971,6098,4328,1770,1215,204,76,4603
1/1/2020,VA,Virginia,Appomattox,51011,4022,3075,947,3364,22,3342,658,22,636,3780,2833,947,3132,2268,864,683,95,50,2304
1/1/2020,VA,Virginia,Arlington,51013,24898,20632,4266,23409,116,23293,1489,78,1411,19659,15394,4265,12370,8517,3853,2963,385,131,8891
1/1/2020,VA,Virginia,Augusta,51015,18688,15348,3340,16380,69,16311,2308,54,2254,17538,14198,3340,13910,11044,2866,1875,403,142,11490
1/1/2020,VA,Virginia,Bath,51017,1285,1133,152,1131,*,*,154,0,154,1221,1069,152,973,840,133,157,39,15,762
1/1/2020,VA,Virginia,Bedford,51019,20186,15873,4313,17620,93,17527,2566,45,2521,18774,14465,4309,14984,11694,3290,2010,488,151,12335
1/1/2020,VA,Virginia,Bland,51021,1824,1307,517,1464,*,*,360,*,*,1720,1203,517,1364,976,388,229,59,21,1055
1/1/2020,VA,Virginia,Botetourt,51023,8857,6440,2417,7854,49,7805,1003,20,983,8253,5836,2417,6654,4570,2084,713,166,54,5721
1/1/2020,VA,Virginia,Bristol City,51520,4698,2401,2297,3764,11,3753,934,13,921,4407,2111,2296,3792,1587,2205,1132,146,51,2463
1/1/2020,VA,Virginia,Brunswick,51025,4098,3118,980,3470,40,3430,628,17,611,3831,2851,980,3084,2229,855,1065,127,48,1844
1/1/2020,VA,Virginia,Buchanan,51027,7224,3778,3446,4806,30,4776,2418,19,2399,6964,3518,3446,6005,3371,2634,1629,392,115,3869
1/1/2020,VA,Virginia,Buckingham,51029,3704,2957,747,3082,21,3061,622,17,605,3472,2725,747,2707,2182,525,784,133,44,1746
1/1/2020,VA,Virginia,Buena Vista City,51530,1496,1151,345,1242,*,*,254,*,*,1390,1045,345,1108,813,295,297,59,18,734
1/1/2020,VA,Virginia,Campbell,51031,13266,10119,3147,11216,96,11120,2050,60,1990,12442,9295,3147,10270,7472,2798,2066,386,132,7686
1/1/2020,VA,Virginia,Caroline,51033,6112,4663,1449,5214,45,5169,898,35,863,5512,4063,1449,3882,2610,1272,858,209,41,2774
1/1/2020,VA,Virginia,Carroll,51035,8607,6901,1706,7228,33,7195,1379,17,1362,8165,6459,1706,6528,5112,1416,1630,265,104,4529
1/1/2020,VA,Virginia,Charles City,51036,1975,1423,552,1709,20,1689,266,14,252,1814,1262,552,1417,929,488,260,73,19,1065
1/1/2020,VA,Virginia,Charlotte,51037,3291,2584,707,2739,18,2721,552,15,537,3088,2381,707,2487,1857,630,727,125,41,1594
1/1/2020,VA,Virginia,Charlottesville City,51540,6331,5401,930,5384,31,5353,947,44,903,5690,4761,929,4672,3823,849,1219,150,39,3264
1/1/2020,VA,Virginia,Chesapeake City,51550,39739,29709,10030,34765,332,34433,4974,227,4747,35972,25946,10026,22799,13808,8991,4218,973,223,17385
1/1/2020,VA,Virginia,Chesterfield,51041,62961,45735,17226,55975,271,55704,6986,249,6737,56883,39664,17219,45005,29518,15487,5612,1087,273,38033
1/1/2020,VA,Virginia,Clarke,51043,3424,2893,531,3177,13,3164,247,*,*,3088,2557,531,2184,1783,401,290,67,25,1802
1/1/2020,VA,Virginia,Colonial Heights City,51570,4171,3288,883,3594,12,3582,577,*,*,3822,2939,883,2610,1821,789,513,111,18,1968
1/1/2020,VA,Virginia,Covington City,51580,1577,1242,335,1236,18,1218,341,*,*,1479,1144,335,1215,903,312,322,43,15,835
1/1/2020,VA,Virginia,Craig,51045,1372,975,397,1096,*,*,276,*,*,1283,886,397,1047,680,367,215,45,14,773
1/1/2020,VA,Virginia,Culpeper,51047,9736,8025,1711,8587,34,8553,1149,43,1106,8840,7130,1710,6293,5000,1293,1229,233,63,4768
1/1/2020,VA,Virginia,Cumberland,51049,2404,1772,632,2016,17,1999,388,*,*,2228,1596,632,1794,1238,556,449,92,31,1222
1/1/2020,VA,Virginia,Danville City,51590,11110,7351,3759,8899,96,8803,2211,124,2087,10429,6670,3759,9074,6193,2881,3235,400,170,5269
1/1/2020,VA,Virginia,Dickenson,51051,4924,2398,2526,3308,*,*,1616,*,*,4732,2207,2525,4071,1792,2279,1147,221,73,2630
1/1/2020,VA,Virginia,Dinwiddie,51053,6132,4540,1592,5054,44,5010,1078,39,1039,5656,4064,1592,4333,2832,1501,949,195,49,3140
1/1/2020,VA,Virginia,Emporia City,51595,1344,916,428,1068,22,1046,276,11,265,1264,836,428,1032,665,367,447,75,11,499
1/1/2020,VA,Virginia,Essex,51057,3025,2310,715,2618,18,2600,407,17,390,2783,2068,715,2163,1592,571,476,88,39,1560
1/1/2020,VA,Virginia,Fairfax,51059,154917,123232,31685,147122,650,146472,7795,439,7356,125024,93369,31655,77104,49947,27157,14213,2676,581,59634
1/1/2020,VA,Virginia,Fairfax City,51600,3931,3083,848,3696,16,3680,235,13,222,3302,2456,846,2153,1455,698,400,71,18,1664
1/1/2020,VA,Virginia,Falls Church City,51610,2105,1703,402,2032,*,*,73,*,*,1658,1256,402,1072,724,348,133,*,*,924
1/1/2020,VA,Virginia,Fauquier,51061,13032,11195,1837,12016,83,11933,1016,36,980,11570,9733,1837,7764,6398,1366,977,181,63,6543
1/1/2020,VA,Virginia,Floyd,51063,4260,3247,1013,3738,13,3725,522,*,*,3983,2971,1012,3257,2309,948,630,108,45,2474
1/1/2020,VA,Virginia,Fluvanna,51065,6241,5251,990,5639,28,5611,602,19,583,5687,4697,990,4276,3484,792,575,114,30,3557
1/1/2020,VA,Virginia,Franklin,51067,15294,10466,4828,13047,64,12983,2247,36,2211,14337,9509,4828,11922,7593,4329,2063,469,148,9242
1/1/2020,VA,Virginia,Franklin City,51620,2192,1717,475,1794,21,1773,398,21,377,2052,1577,475,1687,1251,436,555,60,18,1054
1/1/2020,VA,Virginia,Frederick,51069,17343,14165,3178,15647,79,15568,1696,47,1649,15774,12598,3176,11266,8708,2558,1443,382,127,9314
1/1/2020,VA,Virginia,Fredericksburg City,51630,4236,3410,826,3539,28,3511,697,26,671,3755,2929,826,2680,1944,736,839,81,37,1723
1/1/2020,VA,Virginia,Galax City,51640,1765,1524,241,1426,*,*,339,*,*,1672,1431,241,1392,1191,201,585,46,24,737
1/1/2020,VA,Virginia,Giles,51071,4644,3437,1207,3743,24,3719,901,16,885,4390,3183,1207,3698,2824,874,829,109,36,2724
1/1/2020,VA,Virginia,Gloucester,51073,8909,7104,1805,7817,53,7764,1092,20,1072,8219,6415,1804,5493,3922,1571,1017,177,56,4243
1/1/2020,VA,Virginia,Goochland,51075,6128,4691,1437,5668,29,5639,460,12,448,5647,4211,1436,4733,3525,1208,424,99,28,4182
1/1/2020,VA,Virginia,Grayson,51077,4630,3521,1109,3862,18,3844,768,*,*,4436,3327,1109,3523,2522,1001,946,182,89,2306
1/1/2020,VA,Virginia,Greene,51079,4082,3442,640,3599,14,3585,483,12,471,3703,3063,640,2769,2216,553,472,81,30,2186
1/1/2020,VA,Virginia,Greensville,51081,2127,1442,685,1735,25,1710,392,14,378,1973,1289,684,1634,1087,547,447,101,26,1060
1/1/2020,VA,Virginia,Halifax,51083,9912,7973,1939,8316,67,8249,1596,55,1541,9293,7354,1939,7572,5850,1722,2145,415,136,4876
1/1/2020,VA,Virginia,Hampton City,51650,25815,17893,7922,21631,249,21382,4184,211,3973,23481,15559,7922,15096,7652,7444,4015,757,175,10149
1/1/2020,VA,Virginia,Hanover,51085,22177,16305,5872,20357,111,20246,1820,48,1772,20228,14358,5870,16605,11700,4905,1506,311,95,14693
1/1/2020,VA,Virginia,Harrisonburg City,51660,5607,4774,833,4799,28,4771,808,21,787,5094,4261,833,4122,3474,648,1014,135,49,2924
1/1/2020,VA,Virginia,Henrico,51087,58769,40997,17772,52041,408,51633,6728,282,6446,53213,35443,17770,44230,28468,15762,6841,1400,379,35610
1/1/2020,VA,Virginia,Henry,51089,14955,9785,5170,12091,94,11997,2864,74,2790,14221,9051,5170,12346,7513,4833,3039,708,230,8369
1/1/2020,VA,Virginia,Highland,51091,805,707,98,735,0,735,70,*,*,758,660,98,580,502,78,58,*,*,495
1/1/2020,VA,Virginia,Hopewell City,51670,4590,3306,1284,3614,34,3580,976,29,947,4255,2971,1284,3076,1847,1229,1029,137,43,1867
1/1/2020,VA,Virginia,Isle of Wight,51093,8643,6548,2095,7692,62,7630,951,35,916,7997,5903,2094,5744,3818,1926,993,198,73,4480
1/1/2020,VA,Virginia,James City,51095,21588,17941,3647,20377,72,20305,1211,47,1164,19936,16291,3645,13130,10328,2802,925,245,64,11896
1/1/2020,VA,Virginia,King and Queen,51097,1805,1401,404,1552,11,1541,253,*,*,1681,1277,404,1297,943,354,270,*,*,956
1/1/2020,VA,Virginia,King George,51099,4124,3560,564,3628,27,3601,496,21,475,3586,3022,564,1875,1392,483,456,66,18,1335
1/1/2020,VA,Virginia,King William,51101,3584,2830,754,3095,26,3069,489,31,458,3315,2561,754,2725,2061,664,422,103,16,2184
1/1/2020,VA,Virginia,Lancaster,51103,4421,3699,722,4103,26,4077,318,16,302,4165,3444,721,3114,2627,487,502,93,17,2502
1/1/2020,VA,Virginia,Lee,51105,6443,3076,3367,4603,17,4586,1840,21,1819,6121,2757,3364,5175,2148,3027,1970,242,71,2892
1/1/2020,VA,Virginia,Lexington City,51678,1371,1169,202,1263,*,*,108,*,*,1241,1040,201,970,799,171,177,28,12,753
1/1/2020,VA,Virginia,Loudoun,51107,40410,31977,8433,38068,192,37876,2342,119,2223,33651,25225,8426,23190,16021,7169,3416,655,158,18961
1/1/2020,VA,Virginia,Louisa,51109,8662,6701,1961,7415,59,7356,1247,40,1207,7939,5978,1961,6022,4313,1709,1126,256,63,4577
1/1/2020,VA,Virginia,Lunenburg,51111,3153,2534,619,2657,18,2639,496,13,483,2923,2304,619,2269,1713,556,717,116,41,1395
1/1/2020,VA,Virginia,Lynchburg City,51680,14672,11159,3513,12180,98,12082,2492,105,2387,13624,10111,3513,11342,8174,3168,2977,441,133,7791
1/1/2020,VA,Virginia,Madison,51113,3349,2752,597,3010,16,2994,339,11,328,3108,2511,597,2357,1877,480,422,87,16,1832
1/1/2020,VA,Virginia,Manassas City,51683,4685,3609,1076,4183,28,4155,502,41,461,3957,2881,1076,2833,1910,923,567,97,29,2140
1/1/2020,VA,Virginia,Manassas Park City,51685,1338,949,389,1171,16,1155,167,13,154,1112,723,389,822,468,354,204,*,*,557
1/1/2020,VA,Virginia,Martinsville City,51690,3830,2564,1266,2937,40,2897,893,38,855,3622,2356,1266,3142,1933,1209,1278,174,51,1639
1/1/2020,VA,Virginia,Mathews,51115,2917,2354,563,2679,12,2667,238,*,*,2749,2186,563,2005,1543,462,293,36,20,1656
1/1/2020,VA,Virginia,Mecklenburg,51117,9384,7278,2106,7932,63,7869,1452,66,1386,8799,6693,2106,7039,5203,1836,1804,379,93,4763
1/1/2020,VA,Virginia,Middlesex,51119,3693,3017,676,3353,16,3337,340,*,*,3465,2789,676,2673,2150,523,464,78,25,2106
1/1/2020,VA,Virginia,Montgomery,51121,14362,11174,3188,12182,60,12122,2180,31,2149,12937,9750,3187,10906,8054,2852,1936,335,118,8517
1/1/2020,VA,Virginia,Nelson,51125,4740,3919,821,4284,21,4263,456,*,*,4369,3549,820,3302,2598,704,572,103,38,2589
1/1/2020,VA,Virginia,New Kent,51127,4869,3829,1040,4404,21,4383,465,11,454,4418,3379,1039,3210,2395,815,318,69,24,2799
1/1/2020,VA,Virginia,Newport News City,51700,29005,19969,9036,24240,253,23987,4765,237,4528,26494,17461,9033,18040,9474,8566,5022,889,199,11930
1/1/2020,VA,Virginia,Norfolk City,51710,33541,22961,10580,27466,326,27140,6075,326,5749,30133,19557,10576,21172,11112,10060,7317,1290,291,12274
1/1/2020,VA,Virginia,Northampton,51131,3792,2928,864,3343,25,3318,449,18,431,3528,2664,864,2879,2132,747,924,83,28,1844
1/1/2020,VA,Virginia,Northumberland,51133,4675,3848,827,4354,15,4339,321,12,309,4372,3545,827,3038,2488,550,427,72,28,2511
1/1/2020,VA,Virginia,Norton City,51720,1139,631,508,799,*,*,340,*,*,1060,552,508,900,446,454,348,49,11,492
1/1/2020,VA,Virginia,Nottoway,51135,3660,2842,818,3049,27,3022,611,15,596,3398,2580,818,2709,2029,680,867,127,41,1674
1/1/2020,VA,Virginia,Orange,51137,8913,7426,1487,7958,61,7897,955,27,928,8122,6635,1487,5614,4522,1092,974,188,59,4393
1/1/2020,VA,Virginia,Page,51139,6294,5227,1067,5304,25,5279,990,19,971,5877,4810,1067,4403,3499,904,1066,250,70,3017
1/1/2020,VA,Virginia,Patrick,51141,5526,4026,1500,4657,15,4642,869,*,*,5249,3750,1499,4329,3022,1307,1032,191,71,3035
1/1/2020,VA,Virginia,Petersburg City,51730,7207,4757,2450,5462,104,5358,1745,74,1671,6573,4123,2450,5034,2658,2376,2099,341,70,2524
1/1/2020,VA,Virginia,Pittsylvania,51143,16570,11262,5308,13886,106,13780,2684,71,2613,15582,10274,5308,13178,9091,4087,3024,521,178,9455
1/1/2020,VA,Virginia,Poquoson City,51735,2637,2249,388,2464,*,*,173,*,*,2422,2034,388,1296,957,339,117,*,*,1144
1/1/2020,VA,Virginia,Portsmouth City,51740,18584,12769,5815,14776,210,14566,3808,204,3604,16624,10811,5813,11518,5972,5546,4043,707,140,6628
1/1/2020,VA,Virginia,Powhatan,51145,6359,4874,1485,5799,15,5784,560,14,546,5851,4366,1485,4791,3521,1270,401,111,26,4253
1/1/2020,VA,Virginia,Prince Edward,51147,4725,3707,1018,3880,38,3842,845,34,811,4370,3352,1018,3491,2669,822,1064,152,51,2224
1/1/2020,VA,Virginia,Prince George,51149,6274,5208,1066,5361,39,5322,913,30,883,5804,4739,1065,3660,2711,949,600,124,28,2908
1/1/2020,VA,Virginia,Prince William,51153,51058,39578,11480,46173,335,45838,4885,304,4581,43445,31973,11472,26274,16072,10202,5227,1158,229,19660
1/1/2020,VA,Virginia,Pulaski,51155,9195,7026,2169,7510,33,7477,1685,31,1654,8570,6401,2169,7159,5255,1904,1586,289,100,5184
1/1/2020,VA,Virginia,Radford City,51750,2080,1592,488,1716,*,*,364,*,*,1880,1392,488,1616,1170,446,336,46,22,1212
1/1/2020,VA,Virginia,Rappahannock,51157,1970,1737,233,1848,*,*,122,*,*,1775,1543,232,1255,1090,165,147,*,*,1060
1/1/2020,VA,Virginia,Richmond,51159,1960,1530,430,1723,*,*,237,*,*,1824,1394,430,1386,1088,298,306,69,15,996
1/1/2020,VA,Virginia,Richmond City,51760,34703,21593,13110,28255,292,27963,6448,305,6143,31311,18203,13108,27067,14623,12444,8729,1367,298,16673
1/1/2020,VA,Virginia,Roanoke,51161,24027,17480,6547,21559,125,21434,2468,58,2410,22170,15625,6545,18283,12633,5650,2086,451,137,15609
1/1/2020,VA,Virginia,Roanoke City,51770,21380,14022,7358,16706,180,16526,4674,141,4533,19468,12113,7355,16238,9410,6828,4865,852,193,10328
1/1/2020,VA,Virginia,Rockbridge,51163,6439,5154,1285,5580,13,5567,859,*,*,5975,4690,1285,4596,3501,1095,864,173,57,3502
1/1/2020,VA,Virginia,Rockingham,51165,18307,15439,2868,16289,63,16226,2018,41,1977,16935,14069,2866,13471,11370,2101,1840,500,147,10984
1/1/2020,VA,Virginia,Russell,51167,8003,4525,3478,5759,17,5742,2244,22,2222,7671,4194,3477,6678,3788,2890,1683,343,149,4503
1/1/2020,VA,Virginia,Salem City,51775,6142,4614,1528,5283,33,5250,859,18,841,5673,4145,1528,4643,3268,1375,854,120,39,3630
1/1/2020,VA,Virginia,Scott,51169,6825,2896,3929,5294,16,5278,1531,16,1515,6546,2617,3929,5811,2057,3754,1515,255,112,3929
1/1/2020,VA,Virginia,Shenandoah,51171,10824,8850,1974,9707,42,9665,1117,22,1095,10119,8145,1974,7427,5798,1629,1282,268,84,5793
1/1/2020,VA,Virginia,Smyth,51173,8702,5800,2902,6693,40,6653,2009,26,1983,8258,5356,2902,6966,4266,2700,2091,368,127,4380
1/1/2020,VA,Virginia,Southampton,51175,4020,3220,800,3427,34,3393,593,26,567,3729,2929,800,2971,2265,706,683,122,31,2135
1/1/2020,VA,Virginia,Spotsylvania,51177,22229,18092,4137,19585,138,19447,2644,101,2543,19725,15592,4133,12426,8959,3467,2082,557,136,9651
1/1/2020,VA,Virginia,Stafford,51179,18533,15609,2924,16559,121,16438,1974,86,1888,16240,13318,2922,8644,6168,2476,1484,361,80,6719
1/1/2020,VA,Virginia,Staunton City,51790,6365,5174,1191,5397,22,5375,968,18,950,5988,4797,1191,4801,3773,1028,1102,152,55,3492
1/1/2020,VA,Virginia,Suffolk City,51800,17117,12685,4432,14303,143,14160,2814,112,2702,15686,11256,4430,10963,6902,4061,2843,478,122,7520
1/1/2020,VA,Virginia,Surry,51181,1759,1306,453,1539,14,1525,220,*,*,1624,1171,453,1224,802,422,221,58,12,933
1/1/2020,VA,Virginia,Sussex,51183,2519,1799,720,2084,33,2051,435,*,*,2353,1633,720,1838,1159,679,523,137,23,1155
1/1/2020,VA,Virginia,Tazewell,51185,12028,7468,4560,9165,38,9127,2863,39,2824,11446,6887,4559,9344,5941,3403,2284,479,154,6427
1/1/2020,VA,Virginia,Unknown,51999,*,*,*,*,*,*,*,*,*,*,*,*,*,*,*,*,*,*,*
1/1/2020,VA,Virginia,Virginia Beach City,51810,74811,58476,16335,66716,447,66269,8095,336,7759,68511,52189,16322,40917,26121,14796,7007,1509,400,32001
1/1/2020,VA,Virginia,Warren,51187,7980,6685,1295,6997,28,6969,983,38,945,7256,5961,1295,5062,4025,1037,915,220,67,3860
1/1/2020,VA,Virginia,Washington,51191,15180,8989,6191,12531,54,12477,2649,35,2614,14315,8126,6189,12068,6356,5712,2373,549,208,8938
1/1/2020,VA,Virginia,Waynesboro City,51820,5062,4097,965,4240,20,4220,822,25,797,4726,3761,965,3822,2953,869,922,124,47,2729
1/1/2020,VA,Virginia,Westmoreland,51193,5174,4323,851,4604,29,4575,570,18,552,4722,3871,851,3151,2434,717,794,141,46,2170
1/1/2020,VA,Virginia,Williamsburg City,51830,2864,2321,543,2633,*,*,231,*,*,2637,2094,543,1913,1458,455,262,*,*,1604
1/1/2020,VA,Virginia,Winchester City,51840,5597,4612,985,4856,29,4827,741,22,719,5098,4114,984,3778,2949,829,884,139,41,2714
1/1/2020,VA,Virginia,Wise,51195,10672,5208,5464,7480,30,7450,3192,28,3164,10076,4613,5463,8388,3628,4760,2434,490,169,5295
1/1/2020,VA,Virginia,Wythe,51197,7988,5629,2359,6374,40,6334,1614,17,1597,7554,5195,2359,6278,4181,2097,1660,292,109,4217
1/1/2020,VA,Virginia,York,51199,12426,10391,2035,11491,47,11444,935,38,897,11387,9353,2034,6290,4545,1745,694,158,35,5403
7/1/2020,VA,Virginia,Accomack,51001,9190,7296,1894,8030,59,7971,1160,43,1117,8537,6644,1893,6382,4841,1541,1556,351,80,4395
7/1/2020,VA,Virginia,Albemarle,51003,22176,19215,2961,20654,67,20587,1522,36,1486,20043,17085,2958,15677,13161,2516,1622,282,94,13679
7/1/2020,VA,Virginia,Alexandria City,51510,18458,14863,3595,17163,67,17096,1295,73,1222,14930,11337,3593,9446,6207,3239,2149,305,62,6930
7/1/2020,VA,Virginia,Alleghany,51005,4644,3672,972,3799,19,3780,845,13,832,4406,3434,972,3616,2777,839,841,107,48,2620
7/1/2020,VA,Virginia,Amelia,51007,3169,2200,969,2720,*,*,449,13,436,2924,1955,969,2382,1479,903,472,85,28,1797
7/1/2020,VA,Virginia,Amherst,51009,7974,5933,2041,6715,49,6666,1259,32,1227,7444,5403,2041,6156,4306,1850,1268,202,67,4619
7/1/2020,VA,Virginia,Appomattox,51011,4064,3076,988,3385,20,3365,679,24,655,3828,2840,988,3164,2259,905,719,102,45,2298
7/1/2020,VA,Virginia,Arlington,51013,25208,20786,4422,23669,99,23570,1539,72,1467,19899,15477,4422,12441,8430,4011,3006,384,119,8932
7/1/2020,VA,Virginia,Augusta,51015,18823,15394,3429,16482,67,16415,2341,52,2289,17676,14247,3429,14040,11065,2975,1939,397,132,11572
7/1/2020,VA,Virginia,Bath,51017,1276,1118,158,1119,*,*,157,0,157,1213,1055,158,969,830,139,162,35,11,761
7/1/2020,VA,Virginia,Bedford,51019,20435,16012,4423,17787,85,17702,2648,49,2599,19046,14624,4422,15202,11763,3439,2072,475,138,12517
7/1/2020,VA,Virginia,Bland,51021,1825,1294,531,1463,*,*,362,*,*,1722,1191,531,1359,954,405,232,58,16,1053
7/1/2020,VA,Virginia,Botetourt,51023,8914,6480,2434,7894,48,7846,1020,19,1001,8305,5871,2434,6686,4585,2101,734,160,45,5747
7/1/2020,VA,Virginia,Bristol City,51520,4689,2349,2340,3748,*,*,941,12,929,4412,2072,2340,3789,1540,2249,1153,141,45,2450
7/1/2020,VA,Virginia,Brunswick,51025,4114,3053,1061,3473,39,3434,641,17,624,3849,2788,1061,3107,2166,941,1077,123,37,1870
7/1/2020,VA,Virginia,Buchanan,51027,7169,3672,3497,4744,25,4719,2425,17,2408,6935,3438,3497,5980,3275,2705,1666,383,104,3827
7/1/2020,VA,Virginia,Buckingham,51029,3727,2916,811,3084,21,3063,643,18,625,3495,2684,811,2725,2118,607,811,137,40,1737
7/1/2020,VA,Virginia,Buena Vista City,51530,1497,1138,359,1234,*,*,263,*,*,1396,1037,359,1106,793,313,309,61,14,722
7/1/2020,VA,Virginia,Campbell,51031,13333,10077,3256,11233,84,11149,2100,60,2040,12522,9266,3256,10321,7412,2909,2118,372,112,7719
7/1/2020,VA,Virginia,Caroline,51033,6181,4692,1489,5274,44,5230,907,31,876,5578,4089,1489,3905,2588,1317,894,199,34,2778
7/1/2020,VA,Virginia,Carroll,51035,8600,6820,1780,7199,28,7171,1401,17,1384,8196,6416,1780,6537,5026,1511,1634,263,99,4541
7/1/2020,VA,Virginia,Charles City,51036,1990,1418,572,1712,19,1693,278,15,263,1827,1255,572,1425,921,504,267,75,15,1068
7/1/2020,VA,Virginia,Charlotte,51037,3293,2559,734,2731,17,2714,562,16,546,3095,2361,734,2490,1831,659,734,118,33,1605
7/1/2020,VA,Virginia,Charlottesville City,51540,6370,5359,1011,5418,28,5390,952,43,909,5724,4714,1010,4703,3767,936,1236,147,34,3286
7/1/2020,VA,Virginia,Chesapeake City,51550,40240,29932,10308,35137,297,34840,5103,221,4882,36459,26153,10306,23013,13722,9291,4375,953,201,17484
7/1/2020,VA,Virginia,Chesterfield,51041,63877,46263,17614,56735,248,56487,7142,252,6890,57896,40286,17610,45763,29871,15892,5899,1024,245,38595
7/1/2020,VA,Virginia,Clarke,51043,3440,2910,530,3189,*,*,251,*,*,3094,2564,530,2186,1781,405,289,67,26,1804
7/1/2020,VA,Virginia,Colonial Heights City,51570,4173,3265,908,3588,11,3577,585,*,*,3835,2927,908,2611,1794,817,522,104,13,1972
7/1/2020,VA,Virginia,Covington City,51580,1580,1230,350,1234,17,1217,346,*,*,1480,1130,350,1221,893,328,335,44,11,831
7/1/2020,VA,Virginia,Craig,51045,1365,957,408,1090,*,*,275,*,*,1277,869,408,1046,674,372,211,*,*,777
7/1/2020,VA,Virginia,Culpeper,51047,9848,8093,1755,8675,32,8643,1173,39,1134,8941,7187,1754,6351,5002,1349,1265,231,59,4796
7/1/2020,VA,Virginia,Cumberland,51049,2405,1745,660,2008,13,1995,397,*,*,2224,1564,660,1798,1213,585,463,87,23,1225
7/1/2020,VA,Virginia,Danville City,51590,11189,7218,3971,8928,85,8843,2261,125,2136,10507,6536,3971,9112,6021,3091,3313,399,155,5245
7/1/2020,VA,Virginia,Dickenson,51051,4920,2339,2581,3297,*,*,1623,*,*,4741,2160,2581,4059,1728,2331,1156,215,64,2624
7/1/2020,VA,Virginia,Dinwiddie,51053,6164,4507,1657,5086,39,5047,1078,37,1041,5686,4029,1657,4366,2804,1562,960,188,47,3171
7/1/2020,VA,Virginia,Emporia City,51595,1331,880,451,1058,20,1038,273,*,*,1250,799,451,1028,631,397,445,73,11,499
7/1/2020,VA,Virginia,Essex,51057,3045,2311,734,2624,13,2611,421,17,404,2813,2079,734,2179,1579,600,487,90,34,1568
7/1/2020,VA,Virginia,Fairfax,51059,157807,124969,32838,149814,589,149225,7993,427,7566,127799,94982,32817,78637,50326,28311,14598,2682,551,60806
7/1/2020,VA,Virginia,Fairfax City,51600,3984,3114,870,3745,15,3730,239,15,224,3341,2471,870,2185,1464,721,391,70,16,1708
7/1/2020,VA,Virginia,Falls Church City,51610,2125,1720,405,2054,*,*,71,*,*,1670,1265,405,1078,725,353,135,*,*,930
7/1/2020,VA,Virginia,Fauquier,51061,13227,11333,1894,12187,78,12109,1040,35,1005,11744,9850,1894,7858,6433,1425,1005,191,52,6610
7/1/2020,VA,Virginia,Floyd,51063,4273,3220,1053,3739,12,3727,534,*,*,3996,2944,1052,3270,2284,986,644,104,39,2483
7/1/2020,VA,Virginia,Fluvanna,51065,6322,5307,1015,5700,24,5676,622,17,605,5765,4750,1015,4323,3502,821,600,113,27,3583
7/1/2020,VA,Virginia,Franklin,51067,15409,10458,4951,13146,58,13088,2263,34,2229,14477,9526,4951,12047,7587,4460,2104,466,135,9342
7/1/2020,VA,Virginia,Franklin City,51620,2200,1689,511,1794,18,1776,406,22,384,2065,1554,511,1688,1213,475,562,59,13,1054
7/1/2020,VA,Virginia,Frederick,51069,17522,14270,3252,15785,70,15715,1737,48,1689,15926,12676,3250,11366,8726,2640,1496,374,114,9382
7/1/2020,VA,Virginia,Fredericksburg City,51630,4280,3393,887,3587,25,3562,693,25,668,3788,2901,887,2698,1900,798,853,80,29,1736
7/1/2020,VA,Virginia,Galax City,51640,1759,1483,276,1415,*,*,344,*,*,1667,1391,276,1391,1154,237,576,50,22,743
7/1/2020,VA,Virginia,Giles,51071,4634,3394,1240,3725,18,3707,909,16,893,4390,3150,1240,3687,2774,913,826,106,36,2719
7/1/2020,VA,Virginia,Gloucester,51073,9012,7162,1850,7901,48,7853,1111,21,1090,8305,6456,1849,5531,3913,1618,1037,179,54,4261
7/1/2020,VA,Virginia,Goochland,51075,6219,4750,1469,5750,28,5722,469,13,456,5734,4265,1469,4815,3575,1240,434,93,23,4265
7/1/2020,VA,Virginia,Grayson,51077,4626,3487,1139,3847,16,3831,779,*,*,4431,3292,1139,3512,2477,1035,943,188,81,2300
7/1/2020,VA,Virginia,Greene,51079,4133,3468,665,3640,13,3627,493,12,481,3745,3080,665,2804,2218,586,488,79,23,2214
7/1/2020,VA,Virginia,Greensville,51081,2139,1424,715,1731,19,1712,408,14,394,1983,1268,715,1634,1049,585,459,99,19,1057
7/1/2020,VA,Virginia,Halifax,51083,9938,7884,2054,8313,56,8257,1625,55,1570,9323,7269,2054,7614,5769,1845,2181,400,119,4914
7/1/2020,VA,Virginia,Hampton City,51650,26073,17916,8157,21795,228,21567,4278,219,4059,23779,15622,8157,15260,7570,7690,4165,751,152,10192
7/1/2020,VA,Virginia,Hanover,51085,22428,16406,6022,20572,103,20469,1856,47,1809,20502,14481,6021,16855,11800,5055,1560,303,83,14909
7/1/2020,VA,Virginia,Harrisonburg City,51660,5607,4734,873,4787,22,4765,820,20,800,5097,4224,873,4123,3425,698,1008,134,46,2935
7/1/2020,VA,Virginia,Henrico,51087,59283,41131,18152,52409,375,52034,6874,287,6587,53697,35545,18152,44684,28492,16192,7042,1389,341,35912
7/1/2020,VA,Virginia,Henry,51089,14966,9575,5391,12063,86,11977,2903,74,2829,14254,8864,5390,12403,7337,5066,3125,697,205,8376
7/1/2020,VA,Virginia,Highland,51091,814,715,99,742,0,742,72,*,*,764,665,99,581,502,79,62,*,*,494
7/1/2020,VA,Virginia,Hopewell City,51670,4607,3261,1346,3615,29,3586,992,29,963,4280,2934,1346,3090,1803,1287,1070,140,35,1845
7/1/2020,VA,Virginia,Isle of Wight,51093,8749,6603,2146,7772,61,7711,977,35,942,8096,5950,2146,5802,3819,1983,1008,195,64,4535
7/1/2020,VA,Virginia,James City,51095,21748,18034,3714,20513,65,20448,1235,42,1193,20146,16434,3712,13295,10419,2876,965,240,55,12035
7/1/2020,VA,Virginia,King and Queen,51097,1816,1402,414,1556,*,*,260,*,*,1694,1280,414,1299,936,363,281,63,11,944
7/1/2020,VA,Virginia,King George,51099,4196,3594,602,3687,24,3663,509,20,489,3652,3050,602,1908,1384,524,470,71,14,1353
7/1/2020,VA,Virginia,King William,51101,3616,2837,779,3117,22,3095,499,31,468,3342,2563,779,2750,2057,693,434,95,17,2204
7/1/2020,VA,Virginia,Lancaster,51103,4418,3665,753,4098,25,4073,320,15,305,4168,3416,752,3110,2578,532,503,92,11,2504
7/1/2020,VA,Virginia,Lee,51105,6454,3002,3452,4595,15,4580,1859,20,1839,6144,2695,3449,5175,2071,3104,2005,234,60,2876
7/1/2020,VA,Virginia,Lexington City,51678,1358,1149,209,1245,*,*,113,*,*,1245,1037,208,978,797,181,176,28,11,763
7/1/2020,VA,Virginia,Loudoun,51107,41192,32508,8684,38785,180,38605,2407,119,2288,34252,25573,8679,23558,16124,7434,3544,657,147,19210
7/1/2020,VA,Virginia,Louisa,51109,8818,6750,2068,7536,53,7483,1282,37,1245,8085,6017,2068,6131,4320,1811,1184,247,51,4649
7/1/2020,VA,Virginia,Lunenburg,51111,3170,2508,662,2667,17,2650,503,13,490,2939,2277,662,2294,1693,601,742,116,35,1401
7/1/2020,VA,Virginia,Lynchburg City,51680,14766,11019,3747,12226,88,12138,2540,101,2439,13745,9998,3747,11465,8049,3416,3078,426,117,7844
7/1/2020,VA,Virginia,Madison,51113,3380,2770,610,3038,15,3023,342,*,*,3144,2534,610,2374,1883,491,440,81,16,1837
7/1/2020,VA,Virginia,Manassas City,51683,4762,3642,1120,4235,25,4210,527,41,486,4022,2902,1120,2872,1902,970,575,96,23,2178
7/1/2020,VA,Virginia,Manassas Park City,51685,1354,946,408,1186,16,1170,168,13,155,1131,723,408,842,468,374,220,*,*,562
7/1/2020,VA,Virginia,Martinsville City,51690,3844,2474,1370,2940,40,2900,904,35,869,3650,2280,1370,3187,1874,1313,1308,170,46,1663
7/1/2020,VA,Virginia,Mathews,51115,2930,2352,578,2690,11,2679,240,*,*,2761,2183,578,2022,1546,476,292,37,20,1673
7/1/2020,VA,Virginia,Mecklenburg,51117,9425,7207,2218,7946,56,7890,1479,64,1415,8850,6632,2218,7097,5142,1955,1827,373,89,4808
7/1/2020,VA,Virginia,Middlesex,51119,3724,3036,688,3383,15,3368,341,*,*,3500,2812,688,2696,2151,545,460,76,23,2137
7/1/2020,VA,Virginia,Montgomery,51121,14475,11172,3303,12252,56,12196,2223,32,2191,13038,9735,3303,11018,8042,2976,1993,329,95,8601
7/1/2020,VA,Virginia,Nelson,51125,4798,3937,861,4332,15,4317,466,*,*,4445,3585,860,3357,2610,747,588,105,36,2628
7/1/2020,VA,Virginia,New Kent,51127,4951,3880,1071,4480,19,4461,471,11,460,4522,3451,1071,3295,2450,845,332,78,18,2867
7/1/2020,VA,Virginia,Newport News City,51700,29322,20004,9318,24437,234,24203,4885,238,4647,26795,17478,9317,18224,9360,8864,5251,869,183,11921
7/1/2020,VA,Virginia,Norfolk City,51710,33983,22996,10987,27781,300,27481,6202,313,5889,30598,19612,10986,21425,10950,10475,7581,1264,252,12328
7/1/2020,VA,Virginia,Northampton,51131,3773,2852,921,3313,19,3294,460,19,441,3533,2612,921,2870,2067,803,906,81,26,1857
7/1/2020,VA,Virginia,Northumberland,51133,4712,3866,846,4380,14,4366,332,12,320,4418,3572,846,3060,2482,578,442,74,22,2522
7/1/2020,VA,Virginia,Norton City,51720,1141,615,526,803,*,*,338,*,*,1067,541,526,909,436,473,347,*,*,506
7/1/2020,VA,Virginia,Nottoway,51135,3677,2802,875,3043,24,3019,634,16,618,3422,2547,875,2731,1989,742,879,122,41,1689
7/1/2020,VA,Virginia,Orange,51137,8999,7474,1525,8019,55,7964,980,30,950,8216,6691,1525,5661,4520,1141,1012,191,52,4406
7/1/2020,VA,Virginia,Page,51139,6328,5219,1109,5302,18,5284,1026,19,1007,5908,4799,1109,4426,3475,951,1082,245,58,3041
7/1/2020,VA,Virginia,Patrick,51141,5567,4010,1557,4672,15,4657,895,12,883,5302,3746,1556,4376,3013,1363,1063,187,62,3064
7/1/2020,VA,Virginia,Petersburg City,51730,7233,4630,2603,5467,98,5369,1766,73,1693,6594,3991,2603,5058,2528,2530,2174,322,54,2508
7/1/2020,VA,Virginia,Pittsylvania,51143,16633,11150,5483,13902,103,13799,2731,68,2663,15661,10178,5483,13261,8997,4264,3064,526,156,9515
7/1/2020,VA,Virginia,Poquoson City,51735,2660,2257,403,2488,*,*,172,*,*,2448,2045,403,1319,964,355,120,24,12,1163
7/1/2020,VA,Virginia,Portsmouth City,51740,18663,12640,6023,14796,191,14605,3867,199,3668,16754,10732,6022,11613,5850,5763,4216,686,116,6595
7/1/2020,VA,Virginia,Powhatan,51145,6426,4930,1496,5851,13,5838,575,13,562,5928,4432,1496,4867,3582,1285,419,107,23,4318
7/1/2020,VA,Virginia,Prince Edward,51147,4740,3633,1107,3890,35,3855,850,30,820,4371,3264,1107,3499,2574,925,1066,158,44,2231
7/1/2020,VA,Virginia,Prince George,51149,6377,5276,1101,5442,36,5406,935,29,906,5889,4789,1100,3720,2729,991,617,121,25,2957
7/1/2020,VA,Virginia,Prince William,51153,52103,40180,11923,47102,302,46800,5001,304,4697,44395,32477,11918,26719,16059,10660,5462,1140,206,19911
7/1/2020,VA,Virginia,Pulaski,51155,9245,7046,2199,7533,28,7505,1712,29,1683,8633,6434,2199,7205,5262,1943,1619,283,83,5220
7/1/2020,VA,Virginia,Radford City,51750,2085,1576,509,1716,*,*,369,*,*,1892,1383,509,1623,1156,467,341,48,21,1213
7/1/2020,VA,Virginia,Rappahannock,51157,2013,1763,250,1889,*,*,124,*,*,1818,1569,249,1277,1095,182,157,35,12,1073
7/1/2020,VA,Virginia,Richmond,51159,1974,1524,450,1727,*,*,247,12,235,1833,1383,450,1398,1076,322,318,65,12,1003
7/1/2020,VA,Virginia,Richmond City,51760,34946,21345,13601,28403,269,28134,6543,302,6241,31578,17979,13599,27299,14349,12950,9033,1318,258,16690
7/1/2020,VA,Virginia,Roanoke,51161,24221,17538,6683,21694,109,21585,2527,54,2473,22395,15714,6681,18446,12653,5793,2145,455,119,15727
7/1/2020,VA,Virginia,Roanoke City,51770,21435,13769,7666,16709,167,16542,4726,138,4588,19563,11900,7663,16318,9179,7139,4972,854,182,10310
7/1/2020,VA,Virginia,Rockbridge,51163,6482,5146,1336,5606,12,5594,876,*,*,6009,4673,1336,4629,3479,1150,895,173,54,3507
7/1/2020,VA,Virginia,Rockingham,51165,18414,15454,2960,16367,56,16311,2047,42,2005,17043,14083,2960,13572,11344,2228,1881,499,136,11056
7/1/2020,VA,Virginia,Russell,51167,8037,4445,3592,5756,17,5739,2281,22,2259,7718,4127,3591,6713,3710,3003,1753,328,138,4494
7/1/2020,VA,Virginia,Salem City,51775,6134,4570,1564,5260,31,5229,874,16,858,5647,4083,1564,4637,3221,1416,867,122,38,3610
7/1/2020,VA,Virginia,Scott,51169,6811,2845,3966,5264,15,5249,1547,15,1532,6546,2580,3966,5794,2007,3787,1534,250,103,3907
7/1/2020,VA,Virginia,Shenandoah,51171,10877,8864,2013,9745,38,9707,1132,23,1109,10199,8186,2013,7484,5807,1677,1294,257,83,5850
7/1/2020,VA,Virginia,Smyth,51173,8700,5726,2974,6654,32,6622,2046,25,2021,8257,5283,2974,6952,4164,2788,2111,346,123,4372
7/1/2020,VA,Virginia,Southampton,51175,4039,3215,824,3433,29,3404,606,27,579,3758,2934,824,2980,2247,733,701,117,25,2137
7/1/2020,VA,Virginia,Spotsylvania,51177,22585,18280,4305,19871,128,19743,2714,105,2609,20042,15739,4303,12580,8933,3647,2154,552,126,9748
7/1/2020,VA,Virginia,Stafford,51179,18846,15813,3033,16830,111,16719,2016,85,1931,16543,13512,3031,8763,6177,2586,1575,352,80,6756
7/1/2020,VA,Virginia,Staunton City,51790,6352,5109,1243,5385,20,5365,967,17,950,5990,4747,1243,4797,3707,1090,1118,149,50,3480
7/1/2020,VA,Virginia,Suffolk City,51800,17309,12720,4589,14432,124,14308,2877,112,2765,15899,11310,4589,11053,6819,4234,2916,478,99,7560
7/1/2020,VA,Virginia,Surry,51181,1758,1290,468,1534,13,1521,224,*,*,1633,1165,468,1227,789,438,229,57,12,929
7/1/2020,VA,Virginia,Sussex,51183,2532,1790,742,2079,28,2051,453,*,*,2366,1624,742,1849,1147,702,527,133,18,1171
7/1/2020,VA,Virginia,Tazewell,51185,12046,7416,4630,9127,33,9094,2919,36,2883,11464,6835,4629,9359,5849,3510,2338,461,128,6432
7/1/2020,VA,Virginia,Unknown,51999,*,*,*,*,*,*,*,*,*,*,*,*,*,*,*,*,*,*,*
7/1/2020,VA,Virginia,Virginia Beach City,51810,75893,59103,16790,67556,409,67147,8337,344,7993,69600,52818,16782,41461,26189,15272,7353,1486,368,32254
7/1/2020,VA,Virginia,Warren,51187,8095,6744,1351,7077,23,7054,1018,37,981,7375,6024,1351,5148,4050,1098,949,218,66,3915
7/1/2020,VA,Virginia,Washington,51191,15280,8961,6319,12578,45,12533,2702,33,2669,14418,8100,6318,12176,6323,5853,2451,543,185,8997
7/1/2020,VA,Virginia,Waynesboro City,51820,5068,4040,1028,4236,17,4219,832,26,806,4736,3708,1028,3838,2899,939,951,116,45,2726
7/1/2020,VA,Virginia,Westmoreland,51193,5216,4325,891,4633,27,4606,583,17,566,4764,3873,891,3191,2433,758,822,138,43,2188
7/1/2020,VA,Virginia,Williamsburg City,51830,2869,2306,563,2636,*,*,233,*,*,2649,2086,563,1923,1444,479,268,*,*,1615
7/1/2020,VA,Virginia,Winchester City,51840,5636,4624,1012,4883,27,4856,753,23,730,5123,4112,1011,3806,2944,862,902,138,37,2729
7/1/2020,VA,Virginia,Wise,51195,10661,5078,5583,7433,25,7408,3228,26,3202,10097,4515,5582,8359,3486,4873,2476,468,155,5260
7/1/2020,VA,Virginia,Wythe,51197,7995,5569,2426,6350,36,6314,1645,18,1627,7556,5130,2426,6300,4122,2178,1704,290,96,4210
7/1/2020,VA,Virginia,York,51199,12628,10539,2089,11669,46,11623,959,37,922,11568,9479,2089,6348,4540,1808,724,153,35,5436
6/1/2020,VA,Virginia,Accomack,51001,9177,7310,1867,8023,59,7964,1154,42,1112,8494,6628,1866,6378,4860,1518,1551,355,80,4392
6/1/2020,VA,Virginia,Albemarle,51003,22122,19190,2932,20608,67,20541,1514,36,1478,19936,17007,2929,15604,13118,2486,1603,277,98,13626
6/1/2020,VA,Virginia,Alexandria City,51510,18393,14848,3545,17103,69,17034,1290,74,1216,14774,11231,3543,9405,6212,3193,2147,305,62,6891
6/1/2020,VA,Virginia,Alleghany,51005,4635,3675,960,3796,21,3775,839,13,826,4388,3428,960,3611,2785,826,836,106,48,2621
6/1/2020,VA,Virginia,Amelia,51007,3168,2211,957,2720,*,*,448,14,434,2918,1961,957,2370,1480,890,469,84,28,1789
6/1/2020,VA,Virginia,Amherst,51009,7957,5934,2023,6703,50,6653,1254,32,1222,7418,5395,2023,6147,4314,1833,1262,203,67,4615
6/1/2020,VA,Virginia,Appomattox,51011,4060,3078,982,3386,20,3366,674,23,651,3806,2824,982,3161,2263,898,709,102,45,2305
6/1/2020,VA,Virginia,Arlington,51013,25137,20772,4365,23606,99,23507,1531,72,1459,19739,15374,4365,12400,8448,3952,2989,385,119,8907
6/1/2020,VA,Virginia,Augusta,51015,18813,15405,3408,16473,67,16406,2340,53,2287,17639,14231,3408,14020,11070,2950,1927,398,130,11565
6/1/2020,VA,Virginia,Bath,51017,1274,1121,153,1117,*,*,157,0,157,1208,1055,153,962,828,134,162,35,11,754
6/1/2020,VA,Virginia,Bedford,51019,20383,15982,4401,17741,90,17651,2642,49,2593,18954,14554,4400,15146,11738,3408,2070,476,137,12463
6/1/2020,VA,Virginia,Bland,51021,1826,1295,531,1463,*,*,363,*,*,1718,1187,531,1358,954,404,228,58,17,1055
6/1/2020,VA,Virginia,Botetourt,51023,8901,6479,2422,7889,48,7841,1012,19,993,8290,5868,2422,6673,4583,2090,732,157,44,5740
6/1/2020,VA,Virginia,Bristol City,51520,4680,2354,2326,3743,*,*,937,11,926,4390,2064,2326,3785,1549,2236,1151,139,44,2451
6/1/2020,VA,Virginia,Brunswick,51025,4115,3075,1040,3471,39,3432,644,17,627,3844,2804,1040,3111,2191,920,1081,123,37,1870
6/1/2020,VA,Virginia,Buchanan,51027,7173,3691,3482,4753,27,4726,2420,17,2403,6932,3450,3482,5977,3287,2690,1660,381,103,3833
6/1/2020,VA,Virginia,Buckingham,51029,3724,2928,796,3084,21,3063,640,18,622,3490,2694,796,2722,2132,590,806,136,41,1739
6/1/2020,VA,Virginia,Buena Vista City,51530,1500,1145,355,1238,*,*,262,*,*,1395,1040,355,1106,799,307,305,61,14,726
6/1/2020,VA,Virginia,Campbell,51031,13316,10086,3230,11228,86,11142,2088,61,2027,12494,9264,3230,10315,7432,2883,2107,373,111,7724
6/1/2020,VA,Virginia,Caroline,51033,6159,4686,1473,5254,43,5211,905,33,872,5526,4053,1473,3893,2593,1300,885,199,35,2774
6/1/2020,VA,Virginia,Carroll,51035,8602,6851,1751,7203,28,7175,1399,18,1381,8174,6423,1751,6537,5057,1480,1646,262,99,4530
6/1/2020,VA,Virginia,Charles City,51036,1987,1421,566,1712,19,1693,275,15,260,1817,1251,566,1418,919,499,264,73,15,1066
6/1/2020,VA,Virginia,Charlotte,51037,3293,2565,728,2733,17,2716,560,16,544,3085,2357,728,2481,1828,653,727,122,34,1598
6/1/2020,VA,Virginia,Charlottesville City,51540,6350,5368,982,5404,29,5375,946,43,903,5690,4709,981,4679,3771,908,1232,146,34,3267
6/1/2020,VA,Virginia,Chesapeake City,51550,40100,29905,10195,35023,299,34724,5077,226,4851,36208,26014,10194,22922,13740,9182,4340,956,197,17429
6/1/2020,VA,Virginia,Chesterfield,51041,63716,46238,17478,56607,252,56355,7109,252,6857,57588,40114,17474,45614,29861,15753,5856,1037,245,38476
6/1/2020,VA,Virginia,Clarke,51043,3436,2908,528,3185,11,3174,251,*,*,3079,2551,528,2184,1782,402,290,66,26,1802
6/1/2020,VA,Virginia,Colonial Heights City,51570,4173,3270,903,3590,11,3579,583,*,*,3829,2926,903,2612,1799,813,524,105,13,1970
6/1/2020,VA,Virginia,Covington City,51580,1581,1234,347,1238,17,1221,343,*,*,1478,1131,347,1218,894,324,333,45,11,829
6/1/2020,VA,Virginia,Craig,51045,1368,965,403,1092,*,*,276,*,*,1277,874,403,1045,675,370,210,*,*,777
6/1/2020,VA,Virginia,Culpeper,51047,9837,8086,1751,8665,33,8632,1172,42,1130,8910,7160,1750,6347,5005,1342,1255,230,59,4803
6/1/2020,VA,Virginia,Cumberland,51049,2403,1748,655,2008,13,1995,395,*,*,2219,1564,655,1795,1214,581,462,88,24,1221
6/1/2020,VA,Virginia,Danville City,51590,11162,7244,3918,8913,88,8825,2249,124,2125,10463,6545,3918,9094,6057,3037,3288,397,154,5255
6/1/2020,VA,Virginia,Dickenson,51051,4925,2352,2573,3301,*,*,1624,*,*,4739,2166,2573,4062,1738,2324,1153,215,65,2629
6/1/2020,VA,Virginia,Dinwiddie,51053,6162,4518,1644,5088,41,5047,1074,38,1036,5669,4025,1644,4358,2809,1549,952,189,46,3171
6/1/2020,VA,Virginia,Emporia City,51595,1336,893,443,1063,20,1043,273,*,*,1253,810,443,1031,643,388,449,72,11,499
6/1/2020,VA,Virginia,Essex,51057,3043,2317,726,2626,14,2612,417,16,401,2799,2073,726,2176,1584,592,484,90,34,1568
6/1/2020,VA,Virginia,Fairfax,51059,157226,124750,32476,149275,606,148669,7951,436,7515,126428,93973,32455,78209,50258,27951,14530,2666,542,60471
6/1/2020,VA,Virginia,Fairfax City,51600,3974,3115,859,3736,15,3721,238,15,223,3315,2456,859,2174,1463,711,391,70,16,1697
6/1/2020,VA,Virginia,Falls Church City,51610,2124,1718,406,2053,*,*,71,*,*,1657,1251,406,1076,722,354,132,*,*,931
6/1/2020,VA,Virginia,Fauquier,51061,13188,11312,1876,12155,79,12076,1033,35,998,11658,9782,1876,7833,6426,1407,985,189,55,6604
6/1/2020,VA,Virginia,Floyd,51063,4270,3229,1041,3739,12,3727,531,*,*,3988,2948,1040,3267,2292,975,641,103,39,2484
6/1/2020,VA,Virginia,Fluvanna,51065,6306,5293,1013,5688,25,5663,618,17,601,5735,4722,1013,4313,3495,818,596,111,29,3577
6/1/2020,VA,Virginia,Franklin,51067,15382,10466,4916,13116,61,13055,2266,36,2230,14431,9515,4916,12019,7596,4423,2108,463,135,9313
6/1/2020,VA,Virginia,Franklin City,51620,2201,1696,505,1795,18,1777,406,22,384,2055,1550,505,1685,1216,469,560,58,13,1054
6/1/2020,VA,Virginia,Frederick,51069,17478,14252,3226,15751,73,15678,1727,48,1679,15852,12628,3224,11326,8710,2616,1488,374,112,9352
6/1/2020,VA,Virginia,Fredericksburg City,51630,4268,3387,881,3576,25,3551,692,24,668,3768,2887,881,2692,1901,791,854,80,29,1729
6/1/2020,VA,Virginia,Galax City,51640,1767,1496,271,1426,*,*,341,*,*,1670,1399,271,1394,1162,232,581,49,22,742
6/1/2020,VA,Virginia,Giles,51071,4637,3415,1222,3725,18,3707,912,16,896,4388,3166,1222,3686,2794,892,831,107,36,2712
6/1/2020,VA,Virginia,Gloucester,51073,8993,7169,1824,7884,51,7833,1109,21,1088,8270,6447,1823,5523,3928,1595,1039,175,51,4258
6/1/2020,VA,Virginia,Goochland,51075,6201,4743,1458,5735,28,5707,466,13,453,5707,4249,1458,4796,3566,1230,426,92,23,4255
6/1/2020,VA,Virginia,Grayson,51077,4642,3505,1137,3870,16,3854,772,*,*,4445,3308,1137,3524,2491,1033,947,189,81,2307
6/1/2020,VA,Virginia,Greene,51079,4118,3461,657,3627,14,3613,491,12,479,3726,3069,657,2795,2217,578,485,79,23,2208
6/1/2020,VA,Virginia,Greensville,51081,2133,1429,704,1728,20,1708,405,14,391,1974,1270,704,1627,1056,571,454,102,19,1052
6/1/2020,VA,Virginia,Halifax,51083,9932,7910,2022,8310,56,8254,1622,58,1564,9304,7282,2022,7602,5789,1813,2179,399,116,4908
6/1/2020,VA,Virginia,Hampton City,51650,26003,17912,8091,21738,231,21507,4265,219,4046,23644,15554,8090,15235,7609,7626,4140,749,155,10191
6/1/2020,VA,Virginia,Hanover,51085,22364,16381,5983,20508,104,20404,1856,47,1809,20386,14404,5982,16797,11780,5017,1551,306,83,14857
6/1/2020,VA,Virginia,Harrisonburg City,51660,5602,4735,867,4783,24,4759,819,21,798,5080,4213,867,4119,3429,690,1008,136,44,2931
6/1/2020,VA,Virginia,Henrico,51087,59149,41121,18028,52302,383,51919,6847,287,6560,53405,35377,18028,44516,28456,16060,7000,1385,344,35787
6/1/2020,VA,Virginia,Henry,51089,14962,9645,5317,12069,87,11982,2893,74,2819,14219,8903,5316,12373,7381,4992,3119,696,205,8353
6/1/2020,VA,Virginia,Highland,51091,810,714,96,739,0,739,71,*,*,759,663,96,579,502,77,62,*,*,492
6/1/2020,VA,Virginia,Hopewell City,51670,4603,3273,1330,3614,30,3584,989,29,960,4265,2935,1330,3085,1813,1272,1065,139,34,1847
6/1/2020,VA,Virginia,Isle of Wight,51093,8733,6604,2129,7758,61,7697,975,35,940,8070,5941,2129,5774,3809,1965,1000,194,63,4517
6/1/2020,VA,Virginia,James City,51095,21719,18032,3687,20490,67,20423,1229,41,1188,20052,16367,3685,13251,10402,2849,958,241,56,11996
6/1/2020,VA,Virginia,King and Queen,51097,1811,1398,413,1552,*,*,259,*,*,1687,1274,413,1302,940,362,279,61,11,951
6/1/2020,VA,Virginia,King George,51099,4170,3588,582,3660,25,3635,510,20,490,3615,3033,582,1892,1387,505,467,73,14,1338
6/1/2020,VA,Virginia,King William,51101,3612,2839,773,3118,22,3096,494,31,463,3326,2553,773,2744,2058,686,430,98,16,2200
6/1/2020,VA,Virginia,Lancaster,51103,4412,3668,744,4094,25,4069,318,15,303,4145,3402,743,3105,2585,520,501,90,11,2503
6/1/2020,VA,Virginia,Lee,51105,6454,3025,3429,4593,15,4578,1861,21,1840,6133,2707,3426,5168,2086,3082,1998,235,60,2875
6/1/2020,VA,Virginia,Lexington City,51678,1357,1151,206,1244,*,*,113,*,*,1229,1024,205,966,788,178,176,28,11,751
6/1/2020,VA,Virginia,Loudoun,51107,41012,32422,8590,38616,183,38433,2396,118,2278,33934,25349,8585,23463,16127,7336,3516,653,146,19148
6/1/2020,VA,Virginia,Louisa,51109,8788,6747,2041,7509,56,7453,1279,37,1242,8046,6005,2041,6098,4312,1786,1178,246,50,4624
6/1/2020,VA,Virginia,Lunenburg,51111,3170,2515,655,2668,17,2651,502,13,489,2936,2281,655,2297,1703,594,740,116,36,1405
6/1/2020,VA,Virginia,Lynchburg City,51680,14739,11048,3691,12208,88,12120,2531,103,2428,13690,9999,3691,11424,8065,3359,3062,429,117,7816
6/1/2020,VA,Virginia,Madison,51113,3363,2759,604,3023,15,3008,340,*,*,3122,2518,604,2361,1876,485,435,79,16,1831
6/1/2020,VA,Virginia,Manassas City,51683,4738,3625,1113,4211,26,4185,527,42,485,3988,2875,1113,2860,1895,965,570,96,24,2170
6/1/2020,VA,Virginia,Manassas Park City,51685,1356,946,410,1188,16,1172,168,13,155,1120,710,410,842,467,375,218,*,*,565
6/1/2020,VA,Virginia,Martinsville City,51690,3842,2493,1349,2938,40,2898,904,37,867,3639,2290,1349,3170,1878,1292,1301,171,47,1651
6/1/2020,VA,Virginia,Mathews,51115,2931,2352,579,2691,12,2679,240,*,*,2752,2173,579,2019,1543,476,292,37,20,1670
6/1/2020,VA,Virginia,Mecklenburg,51117,9414,7214,2200,7940,57,7883,1474,64,1410,8823,6623,2200,7079,5140,1939,1818,375,89,4797
6/1/2020,VA,Virginia,Middlesex,51119,3711,3029,682,3373,15,3358,338,*,*,3476,2794,682,2682,2144,538,457,76,24,2125
6/1/2020,VA,Virginia,Montgomery,51121,14436,11165,3271,12222,56,12166,2214,32,2182,12987,9716,3271,10988,8047,2941,1990,328,94,8576
6/1/2020,VA,Virginia,Nelson,51125,4789,3940,849,4324,16,4308,465,*,*,4425,3577,848,3351,2616,735,585,102,37,2627
6/1/2020,VA,Virginia,New Kent,51127,4947,3885,1062,4474,19,4455,473,11,462,4503,3441,1062,3287,2451,836,327,77,18,2865
6/1/2020,VA,Virginia,Newport News City,51700,29240,20018,9222,24377,237,24140,4863,239,4624,26630,17410,9220,18158,9386,8772,5201,868,183,11906
6/1/2020,VA,Virginia,Norfolk City,51710,33909,23040,10869,27728,307,27421,6181,316,5865,30411,19543,10868,21376,11017,10359,7544,1266,248,12318
6/1/2020,VA,Virginia,Northampton,51131,3778,2874,904,3319,20,3299,459,18,441,3523,2619,904,2866,2081,785,907,82,25,1852
6/1/2020,VA,Virginia,Northumberland,51133,4706,3863,843,4374,14,4360,332,12,320,4404,3561,843,3049,2477,572,441,71,20,2517
6/1/2020,VA,Virginia,Norton City,51720,1137,615,522,799,*,*,338,*,*,1062,540,522,904,436,468,346,*,*,502
6/1/2020,VA,Virginia,Nottoway,51135,3668,2813,855,3035,24,3011,633,16,617,3403,2548,855,2720,1995,725,880,122,41,1677
6/1/2020,VA,Virginia,Orange,51137,8979,7468,1511,8000,56,7944,979,30,949,8173,6662,1511,5656,4527,1129,1015,190,51,4400
6/1/2020,VA,Virginia,Page,51139,6305,5214,1091,5292,18,5274,1013,19,994,5878,4787,1091,4406,3475,931,1070,245,57,3034
6/1/2020,VA,Virginia,Patrick,51141,5566,4023,1543,4671,15,4656,895,12,883,5293,3751,1542,4370,3021,1349,1062,188,62,3058
6/1/2020,VA,Virginia,Petersburg City,51730,7229,4652,2577,5460,99,5361,1769,73,1696,6575,3998,2577,5059,2555,2504,2170,327,53,2509
6/1/2020,VA,Virginia,Pittsylvania,51143,16619,11175,5444,13892,103,13789,2727,69,2658,15610,10166,5444,13229,9002,4227,3059,521,154,9495
6/1/2020,VA,Virginia,Poquoson City,51735,2650,2253,397,2481,*,*,169,*,*,2436,2039,397,1309,959,350,118,24,11,1156
6/1/2020,VA,Virginia,Portsmouth City,51740,18641,12703,5938,14776,193,14583,3865,203,3662,16658,10721,5937,11575,5895,5680,4199,686,114,6576
6/1/2020,VA,Virginia,Powhatan,51145,6403,4919,1484,5833,13,5820,570,13,557,5902,4418,1484,4848,3575,1273,409,109,23,4307
6/1/2020,VA,Virginia,Prince Edward,51147,4739,3653,1086,3888,36,3852,851,30,821,4356,3270,1086,3484,2581,903,1064,155,45,2220
6/1/2020,VA,Virginia,Prince George,51149,6358,5271,1087,5432,36,5396,926,31,895,5861,4775,1086,3712,2734,978,616,122,23,2951
6/1/2020,VA,Virginia,Prince William,51153,51925,40137,11788,46943,307,46636,4982,305,4677,44021,32238,11783,26621,16099,10522,5435,1141,203,19842
6/1/2020,VA,Virginia,Pulaski,51155,9233,7051,2182,7528,30,7498,1705,29,1676,8611,6429,2182,7201,5275,1926,1609,288,81,5223
6/1/2020,VA,Virginia,Radford City,51750,2083,1580,503,1715,*,*,368,*,*,1884,1381,503,1617,1155,462,340,48,21,1208
6/1/2020,VA,Virginia,Rappahannock,51157,2002,1757,245,1878,*,*,124,*,*,1801,1557,244,1263,1086,177,154,35,12,1062
6/1/2020,VA,Virginia,Richmond,51159,1970,1530,440,1724,*,*,246,12,234,1824,1384,440,1389,1077,312,316,65,12,996
6/1/2020,VA,Virginia,Richmond City,51760,34886,21421,13465,28370,271,28099,6516,304,6212,31412,17949,13463,27204,14387,12817,8968,1321,259,16656
6/1/2020,VA,Virginia,Roanoke,51161,24197,17563,6634,21679,110,21569,2518,56,2462,22307,15675,6632,18391,12643,5748,2136,452,114,15689
6/1/2020,VA,Virginia,Roanoke City,51770,21427,13832,7595,16711,169,16542,4716,139,4577,19503,11911,7592,16305,9235,7070,4967,849,177,10312
6/1/2020,VA,Virginia,Rockbridge,51163,6472,5146,1326,5599,12,5587,873,*,*,5986,4660,1326,4612,3472,1140,888,172,55,3497
6/1/2020,VA,Virginia,Rockingham,51165,18400,15462,2938,16357,56,16301,2043,42,2001,17001,14064,2937,13545,11340,2205,1873,496,133,11043
6/1/2020,VA,Virginia,Russell,51167,8028,4456,3572,5753,17,5736,2275,21,2254,7695,4124,3571,6696,3709,2987,1740,331,139,4486
6/1/2020,VA,Virginia,Salem City,51775,6126,4572,1554,5260,31,5229,866,16,850,5637,4083,1554,4630,3224,1406,865,121,36,3608
6/1/2020,VA,Virginia,Scott,51169,6807,2848,3959,5262,16,5246,1545,16,1529,6538,2579,3959,5791,2012,3779,1531,251,104,3905
6/1/2020,VA,Virginia,Shenandoah,51171,10863,8867,1996,9730,38,9692,1133,23,1110,10153,8157,1996,7472,5812,1660,1297,257,80,5838
6/1/2020,VA,Virginia,Smyth,51173,8694,5734,2960,6650,34,6616,2044,26,2018,8238,5278,2960,6940,4168,2772,2114,345,122,4359
6/1/2020,VA,Virginia,Southampton,51175,4032,3209,823,3427,29,3398,605,27,578,3740,2917,823,2968,2237,731,697,119,25,2127
6/1/2020,VA,Virginia,Spotsylvania,51177,22503,18241,4262,19808,127,19681,2695,105,2590,19903,15643,4260,12536,8931,3605,2144,557,123,9712
6/1/2020,VA,Virginia,Stafford,51179,18767,15762,3005,16763,112,16651,2004,85,1919,16402,13399,3003,8730,6171,2559,1564,355,81,6730
6/1/2020,VA,Virginia,Staunton City,51790,6351,5120,1231,5387,20,5367,964,17,947,5974,4743,1231,4797,3720,1077,1114,151,51,3481
6/1/2020,VA,Virginia,Suffolk City,51800,17274,12723,4551,14405,129,14276,2869,112,2757,15823,11272,4551,11027,6834,4193,2898,479,100,7550
6/1/2020,VA,Virginia,Surry,51181,1754,1286,468,1529,14,1515,225,*,*,1619,1151,468,1224,787,437,226,59,12,927
6/1/2020,VA,Virginia,Sussex,51183,2525,1789,736,2076,29,2047,449,*,*,2354,1618,736,1840,1144,696,525,132,19,1164
6/1/2020,VA,Virginia,Tazewell,51185,12020,7416,4604,9116,33,9083,2904,35,2869,11419,6816,4603,9335,5851,3484,2325,463,127,6420
6/1/2020,VA,Virginia,Unknown,51999,*,*,*,*,*,*,*,*,*,*,*,*,*,*,*,*,*,*,*
6/1/2020,VA,Virginia,Virginia Beach City,51810,75667,59041,16626,67364,414,66950,8303,343,7960,69181,52563,16618,41326,26219,15107,7299,1487,365,32175
6/1/2020,VA,Virginia,Warren,51187,8057,6711,1346,7046,23,7023,1011,38,973,7314,5968,1346,5124,4032,1092,941,220,64,3899
6/1/2020,VA,Virginia,Washington,51191,15259,8972,6287,12567,47,12520,2692,33,2659,14373,8087,6286,12138,6319,5819,2428,540,185,8985
6/1/2020,VA,Virginia,Waynesboro City,51820,5064,4043,1021,4234,17,4217,830,26,804,4721,3700,1021,3826,2894,932,948,117,43,2718
6/1/2020,VA,Virginia,Westmoreland,51193,5212,4324,888,4630,28,4602,582,17,565,4746,3858,888,3187,2432,755,821,138,42,2186
6/1/2020,VA,Virginia,Williamsburg City,51830,2868,2308,560,2636,*,*,232,*,*,2644,2084,560,1922,1447,475,271,*,*,1610
6/1/2020,VA,Virginia,Winchester City,51840,5622,4623,999,4876,27,4849,746,23,723,5104,4106,998,3786,2938,848,896,138,37,2715
6/1/2020,VA,Virginia,Wise,51195,10654,5108,5546,7431,25,7406,3223,26,3197,10067,4522,5545,8333,3500,4833,2469,467,155,5242
6/1/2020,VA,Virginia,Wythe,51197,7985,5583,2402,6351,37,6314,1634,18,1616,7538,5136,2402,6284,4131,2153,1694,290,94,4206
6/1/2020,VA,Virginia,York,51199,12570,10502,2068,11617,46,11571,953,36,917,11490,9422,2068,6338,4552,1786,717,153,35,5433
3/1/2020,VA,Virginia,Accomack,51001,9135,7282,1853,7996,63,7933,1139,43,1096,8465,6613,1852,6356,4857,1499,1529,361,94,4372
3/1/2020,VA,Virginia,Albemarle,51003,21999,19112,2887,20506,76,20430,1493,39,1454,19797,16913,2884,15493,13052,2441,1596,280,105,13512
3/1/2020,VA,Virginia,Alexandria City,51510,18289,14787,3502,17006,77,16929,1283,74,1209,14735,11235,3500,9357,6213,3144,2128,306,67,6856
3/1/2020,VA,Virginia,Alleghany,51005,4630,3686,944,3800,23,3777,830,13,817,4378,3434,944,3610,2804,806,835,108,49,2618
3/1/2020,VA,Virginia,Amelia,51007,3136,2199,937,2692,*,*,444,15,429,2888,1951,937,2348,1478,870,469,85,33,1761
3/1/2020,VA,Virginia,Amherst,51009,7947,5962,1985,6706,53,6653,1241,31,1210,7402,5417,1985,6121,4329,1792,1231,201,76,4613
3/1/2020,VA,Virginia,Appomattox,51011,4043,3084,959,3381,21,3360,662,23,639,3792,2833,959,3145,2271,874,697,95,49,2304
3/1/2020,VA,Virginia,Arlington,51013,25014,20691,4323,23508,107,23401,1506,78,1428,19704,15381,4323,12386,8482,3904,2990,381,128,8887
3/1/2020,VA,Virginia,Augusta,51015,18751,15387,3364,16426,70,16356,2325,54,2271,17591,14227,3364,13944,11047,2897,1908,405,146,11485
3/1/2020,VA,Virginia,Bath,51017,1284,1136,148,1130,*,*,154,0,154,1219,1071,148,972,843,129,159,37,14,762
3/1/2020,VA,Virginia,Bedford,51019,20275,15938,4337,17677,92,17585,2598,45,2553,18845,14509,4336,15042,11712,3330,2032,482,153,12375
3/1/2020,VA,Virginia,Bland,51021,1834,1313,521,1469,*,*,365,*,*,1726,1205,521,1365,974,391,235,60,19,1051
3/1/2020,VA,Virginia,Botetourt,51023,8872,6452,2420,7868,48,7820,1004,21,983,8262,5842,2420,6665,4581,2084,722,164,52,5727
3/1/2020,VA,Virginia,Bristol City,51520,4674,2358,2316,3744,*,*,930,12,918,4386,2070,2316,3767,1544,2223,1131,143,49,2444
3/1/2020,VA,Virginia,Brunswick,51025,4112,3109,1003,3474,40,3434,638,17,621,3844,2841,1003,3106,2220,886,1078,124,49,1855
3/1/2020,VA,Virginia,Buchanan,51027,7209,3752,3457,4785,29,4756,2424,19,2405,6954,3497,3457,5991,3331,2660,1644,388,111,3848
3/1/2020,VA,Virginia,Buckingham,51029,3715,2948,767,3082,21,3061,633,17,616,3483,2716,767,2709,2154,555,793,141,45,1730
3/1/2020,VA,Virginia,Buena Vista City,51530,1502,1155,347,1244,*,*,258,*,*,1397,1050,347,1106,809,297,301,61,17,727
3/1/2020,VA,Virginia,Campbell,51031,13313,10139,3174,11246,93,11153,2067,60,2007,12485,9311,3174,10296,7471,2825,2086,382,129,7699
3/1/2020,VA,Virginia,Caroline,51033,6133,4669,1464,5235,45,5190,898,32,866,5524,4060,1464,3888,2599,1289,873,209,39,2767
3/1/2020,VA,Virginia,Carroll,51035,8602,6891,1711,7216,30,7186,1386,18,1368,8164,6453,1711,6520,5089,1431,1635,265,102,4518
3/1/2020,VA,Virginia,Charles City,51036,1988,1431,557,1719,21,1698,269,15,254,1819,1262,557,1420,928,492,264,71,17,1068
3/1/2020,VA,Virginia,Charlotte,51037,3294,2576,718,2738,18,2720,556,16,540,3090,2372,718,2481,1839,642,730,121,41,1589
3/1/2020,VA,Virginia,Charlottesville City,51540,6337,5378,959,5392,31,5361,945,44,901,5690,4732,958,4679,3797,882,1233,146,39,3261
3/1/2020,VA,Virginia,Chesapeake City,51550,39866,29794,10072,34847,319,34528,5019,225,4794,36056,25985,10071,22810,13761,9049,4259,965,225,17361
3/1/2020,VA,Virginia,Chesterfield,51041,63304,46012,17292,56256,266,55990,7048,250,6798,57173,39885,17288,45186,29625,15561,5722,1057,269,38138
3/1/2020,VA,Virginia,Clarke,51043,3423,2897,526,3172,11,3161,251,*,*,3074,2548,526,2177,1777,400,293,65,26,1793
3/1/2020,VA,Virginia,Colonial Heights City,51570,4172,3280,892,3590,12,3578,582,*,*,3826,2934,892,2604,1805,799,514,109,17,1964
3/1/2020,VA,Virginia,Covington City,51580,1579,1244,335,1237,18,1219,342,*,*,1477,1142,335,1216,903,313,329,43,13,831
3/1/2020,VA,Virginia,Craig,51045,1367,967,400,1089,*,*,278,*,*,1276,876,400,1044,676,368,211,45,12,776
3/1/2020,VA,Virginia,Culpeper,51047,9799,8080,1719,8635,34,8601,1164,43,1121,8889,7171,1718,6321,5012,1309,1248,231,61,4781
3/1/2020,VA,Virginia,Cumberland,51049,2408,1767,641,2015,15,2000,393,*,*,2226,1585,641,1800,1232,568,460,92,31,1217
3/1/2020,VA,Virginia,Danville City,51590,11130,7304,3826,8900,93,8807,2230,124,2106,10435,6609,3826,9072,6125,2947,3253,397,168,5254
3/1/2020,VA,Virginia,Dickenson,51051,4927,2377,2550,3302,*,*,1625,*,*,4738,2188,2550,4067,1766,2301,1160,220,74,2613
3/1/2020,VA,Virginia,Dinwiddie,51053,6164,4546,1618,5083,43,5040,1081,40,1041,5675,4057,1618,4348,2824,1524,955,193,49,3151
3/1/2020,VA,Virginia,Emporia City,51595,1352,918,434,1074,21,1053,278,11,267,1271,837,434,1044,669,375,455,74,12,503
3/1/2020,VA,Virginia,Essex,51057,3027,2316,711,2614,16,2598,413,16,397,2784,2073,711,2168,1591,577,481,89,38,1560
3/1/2020,VA,Virginia,Fairfax,51059,155946,123998,31948,148100,634,147466,7846,438,7408,125603,93679,31924,77513,50100,27413,14427,2686,579,59821
3/1/2020,VA,Virginia,Fairfax City,51600,3943,3097,846,3708,15,3693,235,14,221,3311,2466,845,2151,1454,697,392,70,18,1671
3/1/2020,VA,Virginia,Falls Church City,51610,2122,1718,404,2049,*,*,73,*,*,1666,1262,404,1078,726,352,135,*,*,929
3/1/2020,VA,Virginia,Fauquier,51061,13106,11254,1852,12086,83,12003,1020,35,985,11607,9755,1852,7789,6411,1378,980,183,64,6562
3/1/2020,VA,Virginia,Floyd,51063,4267,3248,1019,3740,13,3727,527,*,*,3987,2969,1018,3261,2308,953,636,109,45,2471
3/1/2020,VA,Virginia,Fluvanna,51065,6275,5270,1005,5671,28,5643,604,19,585,5713,4708,1005,4297,3490,807,588,114,31,3564
3/1/2020,VA,Virginia,Franklin,51067,15340,10502,4838,13084,62,13022,2256,37,2219,14375,9537,4838,11953,7611,4342,2079,472,149,9253
3/1/2020,VA,Virginia,Franklin City,51620,2192,1701,491,1791,20,1771,401,21,380,2046,1555,491,1684,1229,455,555,60,16,1053
3/1/2020,VA,Virginia,Frederick,51069,17410,14199,3211,15705,76,15629,1705,47,1658,15811,12602,3209,11276,8682,2594,1470,376,126,9304
3/1/2020,VA,Virginia,Fredericksburg City,51630,4248,3398,850,3549,27,3522,699,25,674,3745,2895,850,2673,1912,761,849,80,33,1711
3/1/2020,VA,Virginia,Galax City,51640,1764,1505,259,1425,*,*,339,*,*,1672,1413,259,1389,1170,219,584,47,25,733
3/1/2020,VA,Virginia,Giles,51071,4623,3415,1208,3718,22,3696,905,16,889,4369,3161,1208,3675,2798,877,836,110,36,2693
3/1/2020,VA,Virginia,Gloucester,51073,8937,7130,1807,7835,53,7782,1102,20,1082,8230,6424,1806,5498,3922,1576,1034,171,56,4237
3/1/2020,VA,Virginia,Goochland,51075,6164,4721,1443,5698,29,5669,466,13,453,5666,4223,1443,4750,3537,1213,425,98,28,4199
3/1/2020,VA,Virginia,Grayson,51077,4629,3517,1112,3858,17,3841,771,*,*,4435,3323,1112,3523,2517,1006,953,184,90,2296
3/1/2020,VA,Virginia,Greene,51079,4093,3452,641,3607,14,3593,486,12,474,3712,3071,641,2774,2218,556,479,81,29,2185
3/1/2020,VA,Virginia,Greensville,51081,2139,1439,700,1742,23,1719,397,13,384,1981,1281,700,1638,1072,566,453,101,24,1060
3/1/2020,VA,Virginia,Halifax,51083,9920,7969,1951,8309,62,8247,1611,57,1554,9292,7341,1951,7574,5837,1737,2172,404,137,4861
3/1/2020,VA,Virginia,Hampton City,51650,25896,17929,7967,21683,243,21440,4213,211,4002,23549,15582,7967,15136,7640,7496,4083,753,174,10126
3/1/2020,VA,Virginia,Hanover,51085,22255,16354,5901,20423,108,20315,1832,46,1786,20299,14399,5900,16664,11729,4935,1523,310,98,14733
3/1/2020,VA,Virginia,Harrisonburg City,51660,5603,4759,844,4789,26,4763,814,21,793,5082,4238,844,4119,3455,664,1017,138,47,2917
3/1/2020,VA,Virginia,Henrico,51087,58946,41079,17867,52166,397,51769,6780,283,6497,53268,35402,17866,44323,28448,15875,6937,1402,371,35613
3/1/2020,VA,Virginia,Henry,51089,14942,9732,5210,12070,89,11981,2872,74,2798,14206,8996,5210,12329,7447,4882,3068,701,233,8327
3/1/2020,VA,Virginia,Highland,51091,809,713,96,739,0,739,70,*,*,760,664,96,583,506,77,58,*,*,500
3/1/2020,VA,Virginia,Hopewell City,51670,4597,3295,1302,3612,32,3580,985,29,956,4256,2954,1302,3068,1823,1245,1040,139,43,1846
3/1/2020,VA,Virginia,Isle of Wight,51093,8671,6569,2102,7714,61,7653,957,35,922,8021,5919,2102,5745,3808,1937,999,194,70,4482
3/1/2020,VA,Virginia,James City,51095,21641,17990,3651,20425,71,20354,1216,43,1173,19972,16323,3649,13182,10377,2805,943,245,63,11931
3/1/2020,VA,Virginia,King and Queen,51097,1810,1400,410,1554,*,*,256,*,*,1684,1274,410,1299,939,360,271,*,*,957
3/1/2020,VA,Virginia,King George,51099,4151,3582,569,3648,25,3623,503,21,482,3605,3036,569,1883,1394,489,462,69,16,1336
3/1/2020,VA,Virginia,King William,51101,3600,2846,754,3108,26,3082,492,30,462,3324,2570,754,2734,2068,666,427,103,15,2189
3/1/2020,VA,Virginia,Lancaster,51103,4412,3683,729,4095,26,4069,317,16,301,4152,3424,728,3109,2609,500,502,93,15,2499
3/1/2020,VA,Virginia,Lee,51105,6438,3051,3387,4589,17,4572,1849,20,1829,6114,2730,3384,5151,2119,3032,1970,241,70,2870
3/1/2020,VA,Virginia,Lexington City,51678,1363,1165,198,1254,*,*,109,*,*,1232,1035,197,968,798,170,174,28,12,754
3/1/2020,VA,Virginia,Loudoun,51107,40666,32172,8494,38306,190,38116,2360,121,2239,33774,25285,8489,23297,16065,7232,3456,656,156,19029
3/1/2020,VA,Virginia,Louisa,51109,8718,6741,1977,7459,58,7401,1259,39,1220,7985,6008,1977,6045,4322,1723,1144,252,62,4587
3/1/2020,VA,Virginia,Lunenburg,51111,3158,2522,636,2658,18,2640,500,13,487,2929,2293,636,2277,1703,574,725,119,39,1394
3/1/2020,VA,Virginia,Lynchburg City,51680,14703,11102,3601,12195,93,12102,2508,104,2404,13650,10049,3601,11363,8102,3261,3010,434,134,7785
3/1/2020,VA,Virginia,Madison,51113,3349,2754,595,3009,15,2994,340,11,329,3110,2515,595,2359,1883,476,433,83,16,1827
3/1/2020,VA,Virginia,Manassas City,51683,4717,3626,1091,4204,27,4177,513,42,471,3973,2882,1091,2842,1904,938,569,94,30,2149
3/1/2020,VA,Virginia,Manassas Park City,51685,1347,944,403,1177,16,1161,170,12,158,1120,717,403,829,463,366,212,*,*,556
3/1/2020,VA,Virginia,Martinsville City,51690,3832,2539,1293,2936,40,2896,896,37,859,3623,2330,1293,3143,1909,1234,1287,174,51,1631
3/1/2020,VA,Virginia,Mathews,51115,2916,2345,571,2677,12,2665,239,*,*,2740,2169,571,2005,1535,470,292,37,18,1658
3/1/2020,VA,Virginia,Mecklenburg,51117,9406,7246,2160,7945,62,7883,1461,64,1397,8816,6656,2160,7066,5174,1892,1817,377,93,4779
3/1/2020,VA,Virginia,Middlesex,51119,3697,3018,679,3360,16,3344,337,*,*,3466,2787,679,2672,2145,527,465,76,25,2106
3/1/2020,VA,Virginia,Montgomery,51121,14391,11182,3209,12201,60,12141,2190,31,2159,12960,9751,3209,10932,8059,2873,1958,330,114,8530
3/1/2020,VA,Virginia,Nelson,51125,4759,3925,834,4299,21,4278,460,*,*,4390,3557,833,3315,2598,717,578,105,39,2593
3/1/2020,VA,Virginia,New Kent,51127,4900,3851,1049,4431,20,4411,469,11,458,4448,3399,1049,3239,2417,822,321,74,23,2821
3/1/2020,VA,Virginia,Newport News City,51700,29125,20032,9093,24317,249,24068,4808,239,4569,26551,17459,9092,18076,9441,8635,5108,879,199,11890
3/1/2020,VA,Virginia,Norfolk City,51710,33687,22986,10701,27566,317,27249,6121,322,5799,30235,19535,10700,21224,11034,10190,7405,1283,286,12250
3/1/2020,VA,Virginia,Northampton,51131,3797,2909,888,3346,23,3323,451,18,433,3534,2646,888,2881,2111,770,924,83,24,1850
3/1/2020,VA,Virginia,Northumberland,51133,4689,3855,834,4364,14,4350,325,12,313,4385,3551,834,3046,2484,562,438,74,27,2507
3/1/2020,VA,Virginia,Norton City,51720,1139,623,516,801,*,*,338,*,*,1061,545,516,901,439,462,344,48,11,498
3/1/2020,VA,Virginia,Nottoway,51135,3648,2816,832,3030,26,3004,618,15,603,3383,2551,832,2701,2002,699,877,124,42,1658
3/1/2020,VA,Virginia,Orange,51137,8938,7457,1481,7969,58,7911,969,29,940,8150,6669,1481,5630,4534,1096,999,191,57,4383
3/1/2020,VA,Virginia,Page,51139,6305,5227,1078,5306,22,5284,999,20,979,5882,4804,1078,4407,3491,916,1078,248,66,3015
3/1/2020,VA,Virginia,Patrick,51141,5547,4023,1524,4669,15,4654,878,*,*,5270,3747,1523,4351,3024,1327,1048,189,68,3046
3/1/2020,VA,Virginia,Petersburg City,51730,7215,4710,2505,5454,101,5353,1761,75,1686,6565,4060,2505,5044,2610,2434,2129,332,65,2518
3/1/2020,VA,Virginia,Pittsylvania,51143,16577,11217,5360,13878,106,13772,2699,71,2628,15574,10214,5360,13179,9038,4141,3033,523,172,9451
3/1/2020,VA,Virginia,Poquoson City,51735,2645,2249,396,2475,*,*,170,*,*,2429,2033,396,1298,949,349,118,*,*,1147
3/1/2020,VA,Virginia,Portsmouth City,51740,18609,12765,5844,14783,208,14575,3826,205,3621,16642,10799,5843,11510,5927,5583,4097,692,138,6583
3/1/2020,VA,Virginia,Powhatan,51145,6384,4900,1484,5821,15,5806,563,13,550,5877,4393,1484,4811,3540,1271,406,108,26,4271
3/1/2020,VA,Virginia,Prince Edward,51147,4733,3682,1051,3888,38,3850,845,32,813,4370,3319,1051,3494,2632,862,1066,153,49,2226
3/1/2020,VA,Virginia,Prince George,51149,6303,5231,1072,5384,38,5346,919,31,888,5822,4751,1071,3675,2718,957,614,123,27,2911
3/1/2020,VA,Virginia,Prince William,51153,51407,39816,11591,46500,332,46168,4907,304,4603,43680,32094,11586,26393,16076,10317,5326,1150,227,19690
3/1/2020,VA,Virginia,Pulaski,51155,9193,7021,2172,7503,32,7471,1690,30,1660,8577,6405,2172,7161,5248,1913,1601,286,99,5175
3/1/2020,VA,Virginia,Radford City,51750,2071,1577,494,1704,*,*,367,*,*,1869,1375,494,1607,1154,453,332,47,23,1205
3/1/2020,VA,Virginia,Rappahannock,51157,1985,1747,238,1861,*,*,124,*,*,1785,1548,237,1255,1084,171,152,38,11,1054
3/1/2020,VA,Virginia,Richmond,51159,1957,1527,430,1716,*,*,241,11,230,1818,1388,430,1382,1081,301,310,68,15,989
3/1/2020,VA,Virginia,Richmond City,51760,34799,21538,13261,28331,285,28046,6468,306,6162,31361,18102,13259,27124,14522,12602,8862,1349,295,16618
3/1/2020,VA,Virginia,Roanoke,51161,24081,17528,6553,21596,115,21481,2485,56,2429,22193,15642,6551,18295,12632,5663,2112,452,132,15599
3/1/2020,VA,Virginia,Roanoke City,51770,21425,13991,7434,16736,176,16560,4689,140,4549,19483,12052,7431,16256,9351,6905,4926,848,193,10289
3/1/2020,VA,Virginia,Rockbridge,51163,6439,5149,1290,5579,12,5567,860,*,*,5966,4676,1290,4593,3490,1103,879,170,58,3486
3/1/2020,VA,Virginia,Rockingham,51165,18341,15456,2885,16312,61,16251,2029,42,1987,16965,14081,2884,13502,11365,2137,1861,503,145,10993
3/1/2020,VA,Virginia,Russell,51167,8016,4509,3507,5758,17,5741,2258,22,2236,7687,4181,3506,6685,3760,2925,1713,338,151,4483
3/1/2020,VA,Virginia,Salem City,51775,6134,4591,1543,5274,32,5242,860,18,842,5661,4118,1543,4630,3240,1390,856,121,39,3614
3/1/2020,VA,Virginia,Scott,51169,6803,2870,3933,5266,16,5250,1537,16,1521,6528,2595,3933,5773,2022,3751,1518,251,111,3893
3/1/2020,VA,Virginia,Shenandoah,51171,10837,8841,1996,9718,40,9678,1119,22,1097,10122,8126,1996,7442,5788,1654,1296,263,84,5799
3/1/2020,VA,Virginia,Smyth,51173,8699,5774,2925,6679,37,6642,2020,26,1994,8250,5325,2925,6951,4222,2729,2111,357,130,4353
3/1/2020,VA,Virginia,Southampton,51175,4027,3209,818,3429,30,3399,598,26,572,3736,2918,818,2975,2248,727,695,123,29,2128
3/1/2020,VA,Virginia,Spotsylvania,51177,22360,18189,4171,19692,137,19555,2668,106,2562,19799,15630,4169,12458,8952,3506,2113,562,129,9654
3/1/2020,VA,Virginia,Stafford,51179,18626,15681,2945,16641,116,16525,1985,88,1897,16303,13360,2943,8657,6158,2499,1520,358,85,6694
3/1/2020,VA,Virginia,Staunton City,51790,6361,5147,1214,5394,22,5372,967,17,950,5975,4761,1214,4798,3742,1056,1105,153,53,3487
3/1/2020,VA,Virginia,Suffolk City,51800,17195,12726,4469,14353,136,14217,2842,112,2730,15756,11287,4469,11000,6897,4103,2883,475,119,7523
3/1/2020,VA,Virginia,Surry,51181,1764,1299,465,1542,14,1528,222,*,*,1624,1159,465,1226,793,433,222,61,11,932
3/1/2020,VA,Virginia,Sussex,51183,2517,1787,730,2081,31,2050,436,*,*,2345,1615,730,1840,1151,689,523,134,23,1160
3/1/2020,VA,Virginia,Tazewell,51185,12017,7427,4590,9134,36,9098,2883,37,2846,11433,6844,4589,9348,5898,3450,2305,471,151,6421
3/1/2020,VA,Virginia,Unknown,51999,*,*,*,*,*,*,*,*,*,*,*,*,*,*,*,*,*,*,*
3/1/2020,VA,Virginia,Virginia Beach City,51810,75154,58729,16425,66979,429,66550,8175,339,7836,68777,52360,16417,41063,26161,14902,7137,1501,401,32024
3/1/2020,VA,Virginia,Warren,51187,8004,6699,1305,7008,24,6984,996,37,959,7267,5962,1305,5074,4022,1052,916,221,69,3868
3/1/2020,VA,Virginia,Washington,51191,15205,8975,6230,12539,52,12487,2666,33,2633,14333,8104,6229,12093,6332,5761,2401,545,210,8937
3/1/2020,VA,Virginia,Waynesboro City,51820,5049,4048,1001,4226,19,4207,823,26,797,4712,3711,1001,3812,2902,910,931,119,44,2718
3/1/2020,VA,Virginia,Westmoreland,51193,5181,4315,866,4610,29,4581,571,17,554,4729,3863,866,3155,2424,731,801,138,46,2170
3/1/2020,VA,Virginia,Williamsburg City,51830,2859,2315,544,2627,*,*,232,*,*,2631,2087,544,1909,1453,456,265,39,11,1594
3/1/2020,VA,Virginia,Winchester City,51840,5601,4611,990,4854,28,4826,747,24,723,5093,4104,989,3777,2942,835,893,140,42,2702
3/1/2020,VA,Virginia,Wise,51195,10660,5168,5492,7457,26,7431,3203,28,3175,10066,4575,5491,8335,3570,4765,2446,483,168,5238
3/1/2020,VA,Virginia,Wythe,51197,7977,5611,2366,6350,39,6311,1627,18,1609,7539,5173,2366,6260,4148,2112,1675,296,107,4182
3/1/2020,VA,Virginia,York,51199,12501,10457,2044,11556,47,11509,945,37,908,11446,9402,2044,6317,4557,1760,701,160,38,5418
5/1/2020,VA,Virginia,Accomack,51001,9169,7307,1862,8019,59,7960,1150,42,1108,8492,6631,1861,6373,4860,1513,1543,358,80,4392
5/1/2020,VA,Virginia,Albemarle,51003,22073,19159,2914,20569,68,20501,1504,37,1467,19869,16958,2911,15550,13083,2467,1606,282,98,13564
5/1/2020,VA,Virginia,Alexandria City,51510,18346,14820,3526,17062,72,16990,1284,74,1210,14752,11228,3524,9380,6207,3173,2144,305,61,6870
5/1/2020,VA,Virginia,Alleghany,51005,4633,3680,953,3798,21,3777,835,13,822,4385,3432,953,3608,2789,819,839,105,47,2617
5/1/2020,VA,Virginia,Amelia,51007,3156,2204,952,2709,*,*,447,15,432,2904,1952,952,2360,1475,885,469,84,26,1781
5/1/2020,VA,Virginia,Amherst,51009,7952,5946,2006,6705,51,6654,1247,32,1215,7418,5412,2006,6139,4325,1814,1244,201,68,4626
5/1/2020,VA,Virginia,Appomattox,51011,4058,3084,974,3387,20,3367,671,23,648,3803,2829,974,3153,2263,890,705,99,45,2304
5/1/2020,VA,Virginia,Arlington,51013,25097,20744,4353,23571,103,23468,1526,73,1453,19735,15382,4353,12393,8453,3940,2993,377,118,8905
5/1/2020,VA,Virginia,Augusta,51015,18784,15410,3374,16447,68,16379,2337,53,2284,17614,14240,3374,13984,11070,2914,1927,399,132,11526
5/1/2020,VA,Virginia,Bath,51017,1277,1125,152,1121,*,*,156,0,156,1209,1057,152,967,833,134,162,37,11,757
5/1/2020,VA,Virginia,Bedford,51019,20350,15976,4374,17726,91,17635,2624,47,2577,18919,14546,4373,15112,11741,3371,2054,473,136,12449
5/1/2020,VA,Virginia,Bland,51021,1829,1301,528,1468,*,*,361,*,*,1721,1193,528,1367,966,401,232,59,17,1059
5/1/2020,VA,Virginia,Botetourt,51023,8889,6472,2417,7882,49,7833,1007,20,987,8279,5862,2417,6665,4580,2085,725,160,45,5735
5/1/2020,VA,Virginia,Bristol City,51520,4673,2353,2320,3740,*,*,933,12,921,4383,2063,2320,3775,1545,2230,1141,139,44,2451
5/1/2020,VA,Virginia,Brunswick,51025,4117,3085,1032,3476,39,3437,641,16,625,3846,2814,1032,3112,2200,912,1082,121,41,1868
5/1/2020,VA,Virginia,Buchanan,51027,7181,3713,3468,4765,28,4737,2416,18,2398,6932,3464,3468,5976,3301,2675,1645,381,104,3846
5/1/2020,VA,Virginia,Buckingham,51029,3721,2939,782,3082,21,3061,639,18,621,3487,2705,782,2714,2139,575,800,139,41,1734
5/1/2020,VA,Virginia,Buena Vista City,51530,1494,1150,344,1234,*,*,260,*,*,1390,1046,344,1102,806,296,299,63,14,726
5/1/2020,VA,Virginia,Campbell,51031,13311,10108,3203,11232,88,11144,2079,61,2018,12490,9287,3203,10306,7453,2853,2095,377,111,7723
5/1/2020,VA,Virginia,Caroline,51033,6149,4676,1473,5247,44,5203,902,32,870,5525,4052,1473,3902,2604,1298,886,200,34,2782
5/1/2020,VA,Virginia,Carroll,51035,8604,6868,1736,7207,28,7179,1397,17,1380,8169,6433,1736,6530,5068,1462,1646,263,98,4523
5/1/2020,VA,Virginia,Charles City,51036,1993,1427,566,1718,20,1698,275,16,259,1825,1259,566,1424,925,499,265,72,15,1072
5/1/2020,VA,Virginia,Charlotte,51037,3291,2566,725,2735,17,2718,556,15,541,3080,2355,725,2481,1831,650,728,122,32,1599
5/1/2020,VA,Virginia,Charlottesville City,51540,6347,5376,971,5408,29,5379,939,44,895,5685,4715,970,4669,3772,897,1228,146,34,3261
5/1/2020,VA,Virginia,Chesapeake City,51550,40016,29873,10143,34974,307,34667,5042,224,4818,36135,25993,10142,22858,13727,9131,4304,964,197,17393
5/1/2020,VA,Virginia,Chesterfield,51041,63545,46157,17388,56464,256,56208,7081,251,6830,57413,40029,17384,45442,29782,15660,5805,1043,239,38355
5/1/2020,VA,Virginia,Clarke,51043,3434,2905,529,3183,11,3172,251,*,*,3078,2549,529,2181,1780,401,291,64,26,1800
5/1/2020,VA,Virginia,Colonial Heights City,51570,4175,3278,897,3592,11,3581,583,*,*,3831,2934,897,2608,1802,806,519,104,13,1972
5/1/2020,VA,Virginia,Covington City,51580,1580,1242,338,1237,17,1220,343,*,*,1478,1140,338,1220,904,316,335,46,11,828
5/1/2020,VA,Virginia,Craig,51045,1366,964,402,1091,*,*,275,*,*,1275,873,402,1040,670,370,207,*,*,777
5/1/2020,VA,Virginia,Culpeper,51047,9812,8077,1735,8645,33,8612,1167,43,1124,8899,7165,1734,6333,5010,1323,1252,231,59,4791
5/1/2020,VA,Virginia,Cumberland,51049,2408,1759,649,2012,14,1998,396,*,*,2221,1572,649,1798,1224,574,463,89,26,1220
5/1/2020,VA,Virginia,Danville City,51590,11152,7265,3887,8909,91,8818,2243,123,2120,10450,6563,3887,9083,6076,3007,3272,395,153,5263
5/1/2020,VA,Virginia,Dickenson,51051,4931,2364,2567,3307,*,*,1624,*,*,4742,2175,2567,4067,1747,2320,1159,213,64,2631
5/1/2020,VA,Virginia,Dinwiddie,51053,6160,4531,1629,5086,41,5045,1074,39,1035,5669,4040,1629,4356,2821,1535,950,189,45,3172
5/1/2020,VA,Virginia,Emporia City,51595,1345,905,440,1070,21,1049,275,11,264,1262,822,440,1039,654,385,455,72,12,500
5/1/2020,VA,Virginia,Essex,51057,3035,2315,720,2619,15,2604,416,16,400,2795,2075,720,2173,1588,585,484,90,33,1566
5/1/2020,VA,Virginia,Fairfax,51059,156847,124556,32291,148951,615,148336,7896,437,7459,126159,93889,32270,78008,50235,27773,14527,2674,537,60270
5/1/2020,VA,Virginia,Fairfax City,51600,3969,3116,853,3731,15,3716,238,15,223,3316,2463,853,2171,1466,705,394,70,16,1691
5/1/2020,VA,Virginia,Falls Church City,51610,2122,1718,404,2049,*,*,73,*,*,1660,1256,404,1072,720,352,130,*,*,928
5/1/2020,VA,Virginia,Fauquier,51061,13149,11285,1864,12123,80,12043,1026,36,990,11630,9766,1864,7807,6415,1392,980,187,53,6587
5/1/2020,VA,Virginia,Floyd,51063,4260,3227,1033,3731,13,3718,529,*,*,3979,2947,1032,3261,2293,968,638,105,41,2477
5/1/2020,VA,Virginia,Fluvanna,51065,6288,5275,1013,5674,25,5649,614,18,596,5718,4705,1013,4310,3493,817,593,110,29,3578
5/1/2020,VA,Virginia,Franklin,51067,15356,10473,4883,13090,61,13029,2266,37,2229,14397,9514,4883,11996,7606,4390,2104,466,135,9291
5/1/2020,VA,Virginia,Franklin City,51620,2202,1708,494,1798,18,1780,404,22,382,2056,1562,494,1690,1232,458,562,58,14,1056
5/1/2020,VA,Virginia,Frederick,51069,17462,14246,3216,15745,73,15672,1717,48,1669,15841,12627,3214,11309,8705,2604,1483,371,113,9342
5/1/2020,VA,Virginia,Fredericksburg City,51630,4265,3394,871,3569,26,3543,696,25,671,3761,2890,871,2688,1906,782,852,81,29,1726
5/1/2020,VA,Virginia,Galax City,51640,1767,1503,264,1427,*,*,340,*,*,1674,1410,264,1391,1166,225,583,48,22,738
5/1/2020,VA,Virginia,Giles,51071,4629,3419,1210,3719,20,3699,910,17,893,4375,3165,1210,3681,2803,878,839,105,35,2702
5/1/2020,VA,Virginia,Gloucester,51073,8979,7153,1826,7872,52,7820,1107,20,1087,8258,6433,1825,5514,3916,1598,1037,175,51,4251
5/1/2020,VA,Virginia,Goochland,51075,6187,4742,1445,5725,29,5696,462,13,449,5696,4251,1445,4788,3571,1217,426,92,23,4247
5/1/2020,VA,Virginia,Grayson,51077,4645,3512,1133,3872,16,3856,773,*,*,4447,3314,1133,3531,2504,1027,951,190,81,2309
5/1/2020,VA,Virginia,Greene,51079,4105,3455,650,3618,14,3604,487,12,475,3719,3069,650,2789,2218,571,482,79,23,2205
5/1/2020,VA,Virginia,Greensville,51081,2139,1440,699,1736,22,1714,403,14,389,1977,1278,699,1634,1068,566,454,104,19,1057
5/1/2020,VA,Virginia,Halifax,51083,9923,7928,1995,8309,58,8251,1614,57,1557,9293,7298,1995,7587,5804,1783,2166,402,118,4901
5/1/2020,VA,Virginia,Hampton City,51650,25950,17909,8041,21704,233,21471,4246,218,4028,23598,15558,8040,15201,7628,7573,4126,748,155,10172
5/1/2020,VA,Virginia,Hanover,51085,22317,16369,5948,20475,105,20370,1842,46,1796,20349,14402,5947,16747,11766,4981,1540,306,84,14817
5/1/2020,VA,Virginia,Harrisonburg City,51660,5596,4733,863,4779,24,4755,817,21,796,5074,4211,863,4115,3431,684,1009,137,43,2926
5/1/2020,VA,Virginia,Henrico,51087,59028,41083,17945,52213,388,51825,6815,287,6528,53294,35349,17945,44404,28430,15974,6944,1391,339,35730
5/1/2020,VA,Virginia,Henry,51089,14951,9676,5275,12071,88,11983,2880,72,2808,14202,8928,5274,12355,7406,4949,3105,693,202,8355
5/1/2020,VA,Virginia,Highland,51091,809,713,96,738,0,738,71,*,*,760,664,96,580,503,77,62,*,*,493
5/1/2020,VA,Virginia,Hopewell City,51670,4607,3290,1317,3622,29,3593,985,29,956,4259,2942,1317,3081,1820,1261,1057,142,35,1847
5/1/2020,VA,Virginia,Isle of Wight,51093,8720,6605,2115,7753,62,7691,967,35,932,8057,5942,2115,5772,3821,1951,998,195,63,4516
5/1/2020,VA,Virginia,James City,51095,21700,18035,3665,20478,69,20409,1222,43,1179,20030,16367,3663,13216,10390,2826,948,242,57,11969
5/1/2020,VA,Virginia,King and Queen,51097,1812,1402,410,1556,*,*,256,*,*,1687,1277,410,1302,942,360,274,62,11,955
5/1/2020,VA,Virginia,King George,51099,4158,3578,580,3651,25,3626,507,20,487,3606,3026,580,1890,1389,501,461,71,15,1343
5/1/2020,VA,Virginia,King William,51101,3614,2851,763,3119,24,3095,495,31,464,3331,2568,763,2749,2073,676,432,99,16,2202
5/1/2020,VA,Virginia,Lancaster,51103,4408,3668,740,4093,25,4068,315,15,300,4144,3405,739,3103,2588,515,499,91,11,2502
5/1/2020,VA,Virginia,Lee,51105,6454,3026,3428,4596,17,4579,1858,21,1837,6130,2705,3425,5173,2094,3079,1992,238,61,2882
5/1/2020,VA,Virginia,Lexington City,51678,1357,1155,202,1246,*,*,111,*,*,1229,1028,201,965,791,174,175,28,11,751
5/1/2020,VA,Virginia,Loudoun,51107,40922,32368,8554,38548,185,38363,2374,117,2257,33903,25354,8549,23417,16122,7295,3491,655,144,19127
5/1/2020,VA,Virginia,Louisa,51109,8771,6759,2012,7499,56,7443,1272,39,1233,8031,6019,2012,6082,4324,1758,1166,248,49,4619
5/1/2020,VA,Virginia,Lunenburg,51111,3161,2510,651,2659,17,2642,502,13,489,2929,2278,651,2289,1698,591,737,116,36,1400
5/1/2020,VA,Virginia,Lynchburg City,51680,14728,11070,3658,12205,91,12114,2523,104,2419,13671,10013,3658,11399,8076,3323,3038,429,118,7814
5/1/2020,VA,Virginia,Madison,51113,3361,2760,601,3022,15,3007,339,*,*,3120,2519,601,2361,1879,482,435,80,16,1830
5/1/2020,VA,Virginia,Manassas City,51683,4733,3621,1112,4215,27,4188,518,43,475,3988,2876,1112,2861,1898,963,572,96,25,2168
5/1/2020,VA,Virginia,Manassas Park City,51685,1353,946,407,1184,16,1168,169,13,156,1120,713,407,838,467,371,213,*,*,565
5/1/2020,VA,Virginia,Martinsville City,51690,3842,2512,1330,2941,40,2901,901,37,864,3633,2303,1330,3167,1894,1273,1299,174,48,1646
5/1/2020,VA,Virginia,Mathews,51115,2919,2345,574,2679,12,2667,240,*,*,2743,2169,574,2014,1542,472,291,37,19,1667
5/1/2020,VA,Virginia,Mecklenburg,51117,9408,7221,2187,7942,58,7884,1466,64,1402,8813,6626,2187,7064,5141,1923,1821,375,89,4779
5/1/2020,VA,Virginia,Middlesex,51119,3705,3023,682,3368,16,3352,337,*,*,3471,2789,682,2678,2144,534,460,76,24,2118
5/1/2020,VA,Virginia,Montgomery,51121,14411,11160,3251,12202,57,12145,2209,32,2177,12957,9706,3251,10953,8033,2920,1979,331,94,8549
5/1/2020,VA,Virginia,Nelson,51125,4775,3938,837,4314,16,4298,461,*,*,4404,3568,836,3329,2608,721,582,103,36,2608
5/1/2020,VA,Virginia,New Kent,51127,4927,3873,1054,4457,20,4437,470,11,459,4481,3427,1054,3260,2431,829,326,75,18,2841
5/1/2020,VA,Virginia,Newport News City,51700,29192,20045,9147,24344,238,24106,4848,242,4606,26579,17434,9145,18118,9424,8694,5176,872,181,11889
5/1/2020,VA,Virginia,Norfolk City,51710,33832,23039,10793,27678,308,27370,6154,320,5834,30337,19545,10792,21315,11032,10283,7488,1272,247,12308
5/1/2020,VA,Virginia,Northampton,51131,3788,2888,900,3331,23,3308,457,18,439,3527,2627,900,2876,2094,782,920,83,24,1849
5/1/2020,VA,Virginia,Northumberland,51133,4698,3864,834,4370,14,4356,328,12,316,4395,3561,834,3051,2486,565,440,72,20,2519
5/1/2020,VA,Virginia,Norton City,51720,1136,618,518,800,*,*,336,*,*,1061,543,518,904,439,465,345,*,*,502
5/1/2020,VA,Virginia,Nottoway,51135,3651,2811,840,3027,24,3003,624,16,608,3385,2545,840,2707,1997,710,871,122,40,1674
5/1/2020,VA,Virginia,Orange,51137,8963,7468,1495,7990,57,7933,973,29,944,8162,6667,1495,5635,4520,1115,1007,190,53,4385
5/1/2020,VA,Virginia,Page,51139,6310,5225,1085,5306,19,5287,1004,19,985,5884,4799,1085,4409,3486,923,1079,247,57,3026
5/1/2020,VA,Virginia,Patrick,51141,5555,4017,1538,4669,15,4654,886,*,*,5280,3743,1537,4369,3024,1345,1055,185,62,3067
5/1/2020,VA,Virginia,Petersburg City,51730,7227,4675,2552,5458,99,5359,1769,73,1696,6574,4022,2552,5059,2580,2479,2159,326,54,2520
5/1/2020,VA,Virginia,Pittsylvania,51143,16599,11189,5410,13884,104,13780,2715,69,2646,15590,10180,5410,13210,9018,4192,3049,519,155,9487
5/1/2020,VA,Virginia,Poquoson City,51735,2654,2258,396,2485,*,*,169,*,*,2439,2043,396,1310,961,349,119,24,11,1156
5/1/2020,VA,Virginia,Portsmouth City,51740,18626,12723,5903,14776,196,14580,3850,202,3648,16637,10735,5902,11545,5902,5643,4163,687,112,6583
5/1/2020,VA,Virginia,Powhatan,51145,6389,4909,1480,5824,14,5810,565,12,553,5890,4410,1480,4838,3570,1268,406,110,23,4299
5/1/2020,VA,Virginia,Prince Edward,51147,4729,3655,1074,3884,38,3846,845,31,814,4352,3278,1074,3486,2596,890,1061,154,45,2226
5/1/2020,VA,Virginia,Prince George,51149,6336,5257,1079,5414,36,5378,922,31,891,5839,4761,1078,3696,2729,967,615,123,22,2936
5/1/2020,VA,Virginia,Prince William,51153,51769,40048,11721,46815,319,46496,4954,308,4646,43919,32203,11716,26575,16121,10454,5421,1143,202,19809
5/1/2020,VA,Virginia,Pulaski,51155,9219,7049,2170,7520,30,7490,1699,29,1670,8593,6423,2170,7179,5267,1912,1609,288,80,5202
5/1/2020,VA,Virginia,Radford City,51750,2078,1576,502,1709,*,*,369,*,*,1874,1372,502,1609,1148,461,336,48,22,1203
5/1/2020,VA,Virginia,Rappahannock,51157,1993,1750,243,1871,*,*,122,*,*,1793,1551,242,1256,1081,175,155,36,12,1053
5/1/2020,VA,Virginia,Richmond,51159,1968,1529,439,1725,*,*,243,11,232,1824,1385,439,1388,1077,311,316,65,12,995
5/1/2020,VA,Virginia,Richmond City,51760,34846,21477,13369,28351,274,28077,6495,306,6189,31377,18010,13367,27168,14450,12718,8929,1327,260,16652
5/1/2020,VA,Virginia,Roanoke,51161,24174,17573,6601,21664,111,21553,2510,56,2454,22279,15680,6599,18365,12651,5714,2134,448,115,15668
5/1/2020,VA,Virginia,Roanoke City,51770,21400,13885,7515,16710,171,16539,4690,140,4550,19475,11963,7512,16290,9302,6988,4947,852,173,10318
5/1/2020,VA,Virginia,Rockbridge,51163,6462,5156,1306,5593,12,5581,869,*,*,5978,4672,1306,4609,3489,1120,887,176,55,3491
5/1/2020,VA,Virginia,Rockingham,51165,18395,15477,2918,16360,57,16303,2035,42,1993,16994,14077,2917,13538,11355,2183,1871,500,136,11031
5/1/2020,VA,Virginia,Russell,51167,8018,4465,3553,5749,17,5732,2269,21,2248,7682,4130,3552,6692,3724,2968,1728,330,138,4496
5/1/2020,VA,Virginia,Salem City,51775,6134,4588,1546,5270,31,5239,864,18,846,5648,4103,1545,4634,3237,1397,863,122,34,3615
5/1/2020,VA,Virginia,Scott,51169,6796,2856,3940,5255,16,5239,1541,16,1525,6528,2588,3940,5778,2019,3759,1526,249,105,3898
5/1/2020,VA,Virginia,Shenandoah,51171,10870,8868,2002,9737,39,9698,1133,23,1110,10155,8153,2002,7469,5806,1663,1298,254,80,5837
5/1/2020,VA,Virginia,Smyth,51173,8697,5755,2942,6664,36,6628,2033,26,2007,8243,5301,2942,6942,4188,2754,2118,347,124,4353
5/1/2020,VA,Virginia,Southampton,51175,4031,3213,818,3430,30,3400,601,26,575,3742,2924,818,2973,2246,727,697,120,25,2131
5/1/2020,VA,Virginia,Spotsylvania,51177,22477,18265,4212,19784,133,19651,2693,106,2587,19872,15662,4210,12515,8961,3554,2144,561,120,9690
5/1/2020,VA,Virginia,Stafford,51179,18735,15743,2992,16734,115,16619,2001,85,1916,16381,13391,2990,8714,6167,2547,1549,357,79,6729
5/1/2020,VA,Virginia,Staunton City,51790,6357,5133,1224,5388,21,5367,969,17,952,5979,4755,1224,4787,3718,1069,1104,155,50,3478
5/1/2020,VA,Virginia,Suffolk City,51800,17244,12721,4523,14383,132,14251,2861,114,2747,15789,11266,4523,11013,6849,4164,2891,476,97,7549
5/1/2020,VA,Virginia,Surry,51181,1759,1291,468,1535,14,1521,224,*,*,1624,1156,468,1229,792,437,225,60,12,932
5/1/2020,VA,Virginia,Sussex,51183,2516,1783,733,2072,30,2042,444,*,*,2345,1612,733,1838,1145,693,523,133,19,1163
5/1/2020,VA,Virginia,Tazewell,51185,12016,7417,4599,9119,36,9083,2897,35,2862,11419,6821,4598,9341,5870,3471,2318,464,128,6431
5/1/2020,VA,Virginia,Unknown,51999,*,*,*,*,*,*,*,*,*,*,*,*,*,*,*,*,*,*,*
5/1/2020,VA,Virginia,Virginia Beach City,51810,75494,58934,16560,67236,418,66818,8258,340,7918,69033,52481,16552,41243,26206,15037,7239,1493,367,32144
5/1/2020,VA,Virginia,Warren,51187,8034,6708,1326,7033,24,7009,1001,38,963,7293,5967,1326,5110,4037,1073,934,219,65,3892
5/1/2020,VA,Virginia,Washington,51191,15243,8975,6268,12559,49,12510,2684,35,2649,14357,8090,6267,12132,6331,5801,2417,542,184,8989
5/1/2020,VA,Virginia,Waynesboro City,51820,5055,4053,1002,4229,18,4211,826,26,800,4712,3710,1002,3817,2905,912,940,118,42,2717
5/1/2020,VA,Virginia,Westmoreland,51193,5206,4328,878,4628,28,4600,578,17,561,4749,3871,878,3185,2441,744,822,136,42,2185
5/1/2020,VA,Virginia,Williamsburg City,51830,2867,2311,556,2636,*,*,231,*,*,2639,2083,556,1915,1445,470,271,*,*,1603
5/1/2020,VA,Virginia,Winchester City,51840,5609,4615,994,4864,27,4837,745,23,722,5095,4102,993,3778,2935,843,893,139,34,2712
5/1/2020,VA,Virginia,Wise,51195,10646,5120,5526,7430,25,7405,3216,27,3189,10054,4529,5525,8331,3519,4812,2467,466,154,5244
5/1/2020,VA,Virginia,Wythe,51197,7980,5601,2379,6349,37,6312,1631,18,1613,7528,5149,2379,6270,4142,2128,1684,295,96,4195
5/1/2020,VA,Virginia,York,51199,12549,10493,2056,11599,47,11552,950,37,913,11481,9425,2056,6330,4557,1773,718,155,35,5422
11/1/2020,VA,Virginia,Accomack,51001,9254,7320,1934,8074,55,8019,1180,41,1139,8582,6649,1933,6404,4821,1583,1577,350,81,4396
11/1/2020,VA,Virginia,Albemarle,51003,22319,19303,3016,20776,59,20717,1543,39,1504,20155,17142,3013,15806,13236,2570,1639,284,91,13792
11/1/2020,VA,Virginia,Alexandria City,51510,18680,14994,3686,17367,60,17307,1313,71,1242,15096,11412,3684,9538,6202,3336,2189,304,63,6982
11/1/2020,VA,Virginia,Alleghany,51005,4667,3669,998,3808,15,3793,859,13,846,4423,3425,998,3631,2767,864,844,105,46,2636
11/1/2020,VA,Virginia,Amelia,51007,3203,2217,986,2739,*,*,464,12,452,2970,1984,986,2408,1486,922,484,87,28,1809
11/1/2020,VA,Virginia,Amherst,51009,8017,5927,2090,6742,46,6696,1275,31,1244,7463,5373,2090,6169,4273,1896,1286,198,75,4610
11/1/2020,VA,Virginia,Appomattox,51011,4069,3067,1002,3378,16,3362,691,23,668,3833,2831,1002,3174,2252,922,731,100,49,2294
11/1/2020,VA,Virginia,Arlington,51013,25436,20873,4563,23881,95,23786,1555,69,1486,20052,15489,4563,12564,8401,4163,3016,382,120,9046
11/1/2020,VA,Virginia,Augusta,51015,18957,15444,3513,16578,63,16515,2379,54,2325,17787,14274,3513,14104,11038,3066,1980,393,131,11600
11/1/2020,VA,Virginia,Bath,51017,1283,1119,164,1125,*,*,158,0,158,1220,1056,164,976,831,145,167,*,*,765
11/1/2020,VA,Virginia,Bedford,51019,20581,16095,4486,17887,78,17809,2694,50,2644,19195,14710,4485,15313,11797,3516,2102,476,141,12594
11/1/2020,VA,Virginia,Bland,51021,1821,1289,532,1459,*,*,362,*,*,1717,1185,532,1345,942,403,226,58,13,1048
11/1/2020,VA,Virginia,Botetourt,51023,8971,6509,2462,7931,43,7888,1040,20,1020,8353,5891,2462,6729,4599,2130,740,160,44,5785
11/1/2020,VA,Virginia,Bristol City,51520,4673,2314,2359,3729,*,*,944,12,932,4393,2034,2359,3778,1508,2270,1165,146,41,2426
11/1/2020,VA,Virginia,Brunswick,51025,4118,3017,1101,3469,35,3434,649,17,632,3857,2756,1101,3114,2133,981,1082,127,37,1868
11/1/2020,VA,Virginia,Buchanan,51027,7167,3644,3523,4716,23,4693,2451,16,2435,6931,3408,3523,5981,3242,2739,1708,381,104,3788
11/1/2020,VA,Virginia,Buckingham,51029,3764,2930,834,3105,21,3084,659,19,640,3529,2695,834,2758,2126,632,823,133,42,1760
11/1/2020,VA,Virginia,Buena Vista City,51530,1505,1136,369,1237,*,*,268,*,*,1402,1033,369,1110,788,322,315,60,15,720
11/1/2020,VA,Virginia,Campbell,51031,13409,10079,3330,11279,78,11201,2130,60,2070,12588,9258,3330,10381,7396,2985,2172,367,119,7723
11/1/2020,VA,Virginia,Caroline,51033,6249,4728,1521,5335,41,5294,914,31,883,5651,4130,1521,3967,2615,1352,917,196,38,2816
11/1/2020,VA,Virginia,Carroll,51035,8613,6796,1817,7190,27,7163,1423,17,1406,8202,6385,1817,6532,4985,1547,1647,260,98,4527
11/1/2020,VA,Virginia,Charles City,51036,2001,1425,576,1725,18,1707,276,14,262,1838,1262,576,1427,918,509,265,80,16,1066
11/1/2020,VA,Virginia,Charlotte,51037,3295,2552,743,2732,16,2716,563,16,547,3093,2350,743,2494,1829,665,742,123,35,1594
11/1/2020,VA,Virginia,Charlottesville City,51540,6417,5353,1064,5455,26,5429,962,42,920,5742,4679,1063,4726,3736,990,1245,150,36,3295
11/1/2020,VA,Virginia,Chesapeake City,51550,40687,30119,10568,35497,279,35218,5190,219,4971,36833,26267,10566,23185,13615,9570,4450,956,206,17573
11/1/2020,VA,Virginia,Chesterfield,51041,64575,46690,17885,57321,239,57082,7254,254,7000,58428,40547,17881,46141,29955,16186,6049,1025,250,38817
11/1/2020,VA,Virginia,Clarke,51043,3463,2920,543,3211,*,*,252,*,*,3112,2569,543,2207,1785,422,294,70,27,1816
11/1/2020,VA,Virginia,Colonial Heights City,51570,4177,3264,913,3589,*,*,588,*,*,3840,2927,913,2619,1797,822,533,102,16,1968
11/1/2020,VA,Virginia,Covington City,51580,1578,1229,349,1225,17,1208,353,*,*,1479,1130,349,1216,889,327,342,48,15,811
11/1/2020,VA,Virginia,Craig,51045,1377,966,411,1097,*,*,280,*,*,1282,871,411,1045,671,374,209,*,*,778
11/1/2020,VA,Virginia,Culpeper,51047,9955,8182,1773,8765,30,8735,1190,38,1152,9016,7244,1772,6410,5051,1359,1297,233,62,4818
11/1/2020,VA,Virginia,Cumberland,51049,2410,1739,671,2010,12,1998,400,*,*,2232,1561,671,1798,1202,596,466,89,24,1219
11/1/2020,VA,Virginia,Danville City,51590,11176,7125,4051,8887,82,8805,2289,127,2162,10493,6442,4051,9107,5923,3184,3351,395,155,5206
11/1/2020,VA,Virginia,Dickenson,51051,4925,2337,2588,3277,*,*,1648,*,*,4736,2148,2588,4039,1700,2339,1168,215,63,2593
11/1/2020,VA,Virginia,Dinwiddie,51053,6188,4483,1705,5105,34,5071,1083,37,1046,5719,4014,1705,4389,2779,1610,978,190,50,3171
11/1/2020,VA,Virginia,Emporia City,51595,1323,861,462,1050,18,1032,273,*,*,1241,779,462,1027,617,410,443,72,12,500
11/1/2020,VA,Virginia,Essex,51057,3062,2314,748,2637,12,2625,425,16,409,2840,2092,748,2199,1585,614,501,88,36,1574
11/1/2020,VA,Virginia,Fairfax,51059,160138,126062,34076,151980,554,151426,8158,427,7731,129656,95598,34058,80067,50545,29522,14868,2677,576,61946
11/1/2020,VA,Virginia,Fairfax City,51600,4025,3135,890,3784,14,3770,241,14,227,3373,2483,890,2207,1473,734,402,70,17,1718
11/1/2020,VA,Virginia,Falls Church City,51610,2162,1742,420,2088,*,*,74,*,*,1702,1282,420,1101,732,369,140,*,*,947
11/1/2020,VA,Virginia,Fauquier,51061,13344,11400,1944,12293,74,12219,1051,34,1017,11823,9879,1944,7928,6455,1473,1014,189,55,6670
11/1/2020,VA,Virginia,Floyd,51063,4271,3211,1060,3732,11,3721,539,*,*,3997,2938,1059,3269,2274,995,646,102,39,2482
11/1/2020,VA,Virginia,Fluvanna,51065,6380,5341,1039,5744,23,5721,636,18,618,5814,4775,1039,4368,3522,846,616,111,29,3612
11/1/2020,VA,Virginia,Franklin,51067,15490,10488,5002,13199,57,13142,2291,33,2258,14555,9553,5002,12080,7565,4515,2139,463,144,9334
11/1/2020,VA,Virginia,Franklin City,51620,2202,1689,513,1789,17,1772,413,23,390,2067,1554,513,1685,1209,476,567,62,14,1042
11/1/2020,VA,Virginia,Frederick,51069,17627,14316,3311,15869,67,15802,1758,50,1708,16013,12704,3309,11415,8715,2700,1518,373,115,9409
11/1/2020,VA,Virginia,Fredericksburg City,51630,4293,3380,913,3599,23,3576,694,26,668,3811,2898,913,2702,1876,826,857,85,27,1733
11/1/2020,VA,Virginia,Galax City,51640,1762,1473,289,1417,*,*,345,*,*,1671,1382,289,1396,1146,250,582,53,21,740
11/1/2020,VA,Virginia,Giles,51071,4630,3383,1247,3717,17,3700,913,15,898,4386,3139,1247,3676,2746,930,824,101,37,2714
11/1/2020,VA,Virginia,Gloucester,51073,9092,7200,1892,7963,45,7918,1129,22,1107,8388,6497,1891,5581,3921,1660,1044,181,56,4300
11/1/2020,VA,Virginia,Goochland,51075,6296,4812,1484,5820,28,5792,476,13,463,5793,4309,1484,4872,3615,1257,441,96,23,4312
11/1/2020,VA,Virginia,Grayson,51077,4634,3478,1156,3852,15,3837,782,*,*,4445,3289,1156,3518,2464,1054,943,185,78,2312
11/1/2020,VA,Virginia,Greene,51079,4182,3497,685,3677,13,3664,505,12,493,3802,3117,685,2835,2229,606,498,83,22,2232
11/1/2020,VA,Virginia,Greensville,51081,2135,1408,727,1723,18,1705,412,15,397,1982,1255,727,1630,1032,598,467,93,18,1052
11/1/2020,VA,Virginia,Halifax,51083,9973,7850,2123,8321,53,8268,1652,53,1599,9340,7217,2123,7610,5693,1917,2188,395,123,4904
11/1/2020,VA,Virginia,Hampton City,51650,26243,17900,8343,21911,211,21700,4332,211,4121,23915,15573,8342,15351,7478,7873,4243,737,158,10213
11/1/2020,VA,Virginia,Hanover,51085,22655,16527,6128,20771,93,20678,1884,49,1835,20705,14579,6126,17021,11866,5155,1581,301,85,15054
11/1/2020,VA,Virginia,Harrisonburg City,51660,5633,4732,901,4808,21,4787,825,20,805,5124,4223,901,4143,3417,726,1023,135,44,2941
11/1/2020,VA,Virginia,Henrico,51087,59705,41220,18485,52715,348,52367,6990,297,6693,54094,35609,18485,45039,28488,16551,7178,1372,353,36136
11/1/2020,VA,Virginia,Henry,51089,14923,9461,5462,12000,75,11925,2923,68,2855,14225,8764,5461,12369,7231,5138,3111,701,206,8351
11/1/2020,VA,Virginia,Highland,51091,823,722,101,751,0,751,72,0,72,774,673,101,591,510,81,61,*,*,502
11/1/2020,VA,Virginia,Hopewell City,51670,4606,3221,1385,3598,27,3571,1008,28,980,4277,2892,1385,3088,1763,1325,1094,142,32,1820
11/1/2020,VA,Virginia,Isle of Wight,51093,8834,6662,2172,7841,53,7788,993,32,961,8177,6005,2172,5834,3826,2008,1027,194,56,4557
11/1/2020,VA,Virginia,James City,51095,21862,18086,3776,20603,60,20543,1259,40,1219,20276,16502,3774,13392,10450,2942,993,232,56,12111
11/1/2020,VA,Virginia,King and Queen,51097,1830,1407,423,1572,*,*,258,*,*,1698,1275,423,1306,933,373,277,63,11,955
11/1/2020,VA,Virginia,King George,51099,4233,3601,632,3702,21,3681,531,20,511,3675,3043,632,1922,1368,554,482,70,20,1350
11/1/2020,VA,Virginia,King William,51101,3650,2840,810,3142,22,3120,508,31,477,3382,2572,810,2780,2055,725,443,96,17,2224
11/1/2020,VA,Virginia,Lancaster,51103,4413,3641,772,4091,23,4068,322,16,306,4172,3401,771,3111,2555,556,500,90,12,2509
11/1/2020,VA,Virginia,Lee,51105,6431,2936,3495,4557,15,4542,1874,17,1857,6124,2632,3492,5155,2005,3150,1997,236,60,2862
11/1/2020,VA,Virginia,Lexington City,51678,1365,1146,219,1250,*,*,115,*,*,1260,1042,218,993,802,191,177,*,*,777
11/1/2020,VA,Virginia,Loudoun,51107,41821,32894,8927,39374,175,39199,2447,119,2328,34761,25839,8922,23955,16281,7674,3632,652,158,19513
11/1/2020,VA,Virginia,Louisa,51109,8907,6786,2121,7606,51,7555,1301,37,1264,8165,6044,2121,6181,4317,1864,1203,249,52,4677
11/1/2020,VA,Virginia,Lunenburg,51111,3208,2525,683,2693,16,2677,515,13,502,2977,2294,683,2312,1690,622,766,110,35,1401
11/1/2020,VA,Virginia,Lynchburg City,51680,14839,10974,3865,12259,81,12178,2580,102,2478,13801,9936,3865,11493,7961,3532,3119,423,121,7830
11/1/2020,VA,Virginia,Madison,51113,3414,2785,629,3068,11,3057,346,*,*,3175,2546,629,2390,1880,510,440,82,15,1853
11/1/2020,VA,Virginia,Manassas City,51683,4855,3707,1148,4320,25,4295,535,41,494,4076,2928,1148,2918,1919,999,594,96,23,2205
11/1/2020,VA,Virginia,Manassas Park City,51685,1367,947,420,1198,14,1184,169,13,156,1140,720,420,840,454,386,221,*,*,559
11/1/2020,VA,Virginia,Martinsville City,51690,3824,2437,1387,2918,39,2879,906,33,873,3615,2228,1387,3166,1837,1329,1293,170,47,1656
11/1/2020,VA,Virginia,Mathews,51115,2944,2348,596,2701,11,2690,243,*,*,2781,2185,596,2046,1554,492,287,35,20,1704
11/1/2020,VA,Virginia,Mecklenburg,51117,9445,7168,2277,7959,53,7906,1486,63,1423,8878,6601,2277,7115,5098,2017,1850,363,85,4817
11/1/2020,VA,Virginia,Middlesex,51119,3738,3028,710,3391,15,3376,347,*,*,3514,2804,710,2704,2135,569,459,75,23,2147
11/1/2020,VA,Virginia,Montgomery,51121,14537,11155,3382,12294,54,12240,2243,31,2212,13091,9709,3382,11060,8000,3060,2006,328,94,8632
11/1/2020,VA,Virginia,Nelson,51125,4831,3948,883,4361,16,4345,470,*,*,4485,3603,882,3368,2598,770,596,107,35,2630
11/1/2020,VA,Virginia,New Kent,51127,5035,3934,1101,4557,19,4538,478,13,465,4591,3490,1101,3331,2455,876,343,76,20,2892
11/1/2020,VA,Virginia,Newport News City,51700,29588,20038,9550,24617,214,24403,4971,236,4735,27039,17490,9549,18343,9238,9105,5383,860,186,11914
11/1/2020,VA,Virginia,Norfolk City,51710,34235,22972,11263,27939,283,27656,6296,307,5989,30776,19514,11262,21576,10816,10760,7722,1267,256,12331
11/1/2020,VA,Virginia,Northampton,51131,3810,2875,935,3343,18,3325,467,19,448,3560,2625,935,2873,2057,816,908,81,25,1859
11/1/2020,VA,Virginia,Northumberland,51133,4721,3871,850,4386,12,4374,335,*,*,4422,3572,850,3046,2465,581,442,76,22,2506
11/1/2020,VA,Virginia,Norton City,51720,1138,598,540,795,*,*,343,*,*,1069,529,540,915,428,487,344,*,*,516
11/1/2020,VA,Virginia,Nottoway,51135,3687,2786,901,3041,22,3019,646,16,630,3422,2521,901,2735,1968,767,892,121,42,1680
11/1/2020,VA,Virginia,Orange,51137,9029,7476,1553,8035,51,7984,994,30,964,8243,6690,1553,5677,4517,1160,1015,192,52,4418
11/1/2020,VA,Virginia,Page,51139,6350,5220,1130,5309,15,5294,1041,18,1023,5922,4792,1130,4433,3463,970,1097,241,59,3036
11/1/2020,VA,Virginia,Patrick,51141,5541,3949,1592,4638,12,4626,903,11,892,5289,3698,1591,4352,2954,1398,1064,186,60,3042
11/1/2020,VA,Virginia,Petersburg City,51730,7251,4571,2680,5473,91,5382,1778,75,1703,6602,3922,2680,5060,2452,2608,2209,322,52,2477
11/1/2020,VA,Virginia,Pittsylvania,51143,16689,11095,5594,13928,95,13833,2761,69,2692,15706,10112,5594,13313,8957,4356,3096,520,161,9536
11/1/2020,VA,Virginia,Poquoson City,51735,2664,2265,399,2492,*,*,172,*,*,2445,2046,399,1317,966,351,121,*,*,1162
11/1/2020,VA,Virginia,Portsmouth City,51740,18743,12557,6186,14834,178,14656,3909,196,3713,16798,10613,6185,11656,5732,5924,4285,680,118,6573
11/1/2020,VA,Virginia,Powhatan,51145,6475,4968,1507,5896,11,5885,579,12,567,5975,4468,1507,4896,3600,1296,423,102,25,4346
11/1/2020,VA,Virginia,Prince Edward,51147,4753,3593,1160,3898,33,3865,855,30,825,4401,3241,1160,3527,2547,980,1076,164,43,2244
11/1/2020,VA,Virginia,Prince George,51149,6433,5301,1132,5492,36,5456,941,29,912,5949,4818,1131,3772,2748,1024,627,121,27,2997
11/1/2020,VA,Virginia,Prince William,51153,52884,40575,12309,47783,290,47493,5101,307,4794,45009,32704,12305,27063,16002,11061,5582,1132,214,20135
11/1/2020,VA,Virginia,Pulaski,51155,9271,7035,2236,7531,26,7505,1740,33,1707,8667,6431,2236,7216,5237,1979,1639,278,87,5212
11/1/2020,VA,Virginia,Radford City,51750,2096,1582,514,1723,*,*,373,*,*,1894,1380,514,1640,1167,473,343,45,22,1230
11/1/2020,VA,Virginia,Rappahannock,51157,2037,1785,252,1910,*,*,127,*,*,1844,1593,251,1292,1108,184,161,35,15,1081
11/1/2020,VA,Virginia,Richmond,51159,1977,1514,463,1727,*,*,250,11,239,1836,1373,463,1399,1062,337,326,64,12,997
11/1/2020,VA,Virginia,Richmond City,51760,35143,21265,13878,28544,256,28288,6599,295,6304,31731,17855,13876,27400,14172,13228,9223,1299,265,16613
11/1/2020,VA,Virginia,Roanoke,51161,24356,17604,6752,21788,98,21690,2568,57,2511,22477,15727,6750,18473,12595,5878,2162,452,121,15738
11/1/2020,VA,Virginia,Roanoke City,51770,21461,13652,7809,16686,149,16537,4775,136,4639,19588,11782,7806,16313,9021,7292,5012,866,182,10253
11/1/2020,VA,Virginia,Rockbridge,51163,6529,5168,1361,5641,*,*,888,*,*,6076,4715,1361,4668,3491,1177,908,170,50,3540
11/1/2020,VA,Virginia,Rockingham,51165,18545,15552,2993,16468,52,16416,2077,42,2035,17180,14187,2993,13690,11418,2272,1913,498,137,11142
11/1/2020,VA,Virginia,Russell,51167,8042,4379,3663,5746,17,5729,2296,18,2278,7729,4067,3662,6722,3646,3076,1761,327,147,4487
11/1/2020,VA,Virginia,Salem City,51775,6104,4525,1579,5229,28,5201,875,15,860,5610,4031,1579,4604,3174,1430,849,120,41,3594
11/1/2020,VA,Virginia,Scott,51169,6805,2820,3985,5247,14,5233,1558,15,1543,6533,2548,3985,5767,1958,3809,1548,248,105,3866
11/1/2020,VA,Virginia,Shenandoah,51171,10942,8880,2062,9792,33,9759,1150,21,1129,10266,8204,2062,7574,5847,1727,1319,252,83,5920
11/1/2020,VA,Virginia,Smyth,51173,8705,5687,3018,6645,29,6616,2060,24,2036,8270,5252,3018,6957,4122,2835,2110,346,129,4372
11/1/2020,VA,Virginia,Southampton,51175,4071,3220,851,3463,26,3437,608,26,582,3777,2926,851,2987,2230,757,709,117,26,2135
11/1/2020,VA,Virginia,Spotsylvania,51177,22855,18442,4413,20086,112,19974,2769,102,2667,20246,15834,4412,12676,8919,3757,2198,550,126,9802
11/1/2020,VA,Virginia,Stafford,51179,19091,15993,3098,17045,105,16940,2046,87,1959,16741,13645,3096,8804,6152,2652,1608,353,80,6763
11/1/2020,VA,Virginia,Staunton City,51790,6357,5084,1273,5387,20,5367,970,16,954,5984,4711,1273,4783,3663,1120,1114,153,49,3467
11/1/2020,VA,Virginia,Suffolk City,51800,17457,12745,4712,14545,116,14429,2912,115,2797,15994,11282,4712,11100,6742,4358,2929,483,102,7586
11/1/2020,VA,Virginia,Surry,51181,1760,1279,481,1530,11,1519,230,*,*,1632,1151,481,1226,775,451,230,57,13,926
11/1/2020,VA,Virginia,Sussex,51183,2550,1789,761,2090,26,2064,460,*,*,2381,1620,761,1853,1133,720,529,137,19,1168
11/1/2020,VA,Virginia,Tazewell,51185,12014,7346,4668,9069,27,9042,2945,36,2909,11436,6770,4666,9334,5762,3572,2376,469,129,6360
11/1/2020,VA,Virginia,Unknown,51999,*,*,*,*,*,*,*,*,*,*,*,*,*,*,*,*,*,*,*
11/1/2020,VA,Virginia,Virginia Beach City,51810,76581,59464,17117,68115,369,67746,8466,350,8116,70126,53017,17109,41782,26176,15606,7490,1491,382,32419
11/1/2020,VA,Virginia,Warren,51187,8191,6830,1361,7160,21,7139,1031,37,994,7443,6082,1361,5199,4094,1105,974,217,66,3942
11/1/2020,VA,Virginia,Washington,51191,15289,8910,6379,12578,39,12539,2711,32,2679,14434,8056,6378,12179,6263,5916,2462,553,184,8980
11/1/2020,VA,Virginia,Waynesboro City,51820,5100,4033,1067,4258,16,4242,842,24,818,4784,3717,1067,3860,2884,976,959,112,45,2744
11/1/2020,VA,Virginia,Westmoreland,51193,5239,4308,931,4655,25,4630,584,17,567,4774,3843,931,3201,2402,799,843,139,41,2178
11/1/2020,VA,Virginia,Williamsburg City,51830,2883,2318,565,2638,*,*,245,*,*,2660,2095,565,1931,1450,481,277,*,*,1611
11/1/2020,VA,Virginia,Winchester City,51840,5637,4613,1024,4876,27,4849,761,22,739,5132,4109,1023,3809,2937,872,916,138,36,2719
11/1/2020,VA,Virginia,Wise,51195,10678,5032,5646,7417,23,7394,3261,24,3237,10116,4471,5645,8365,3420,4945,2500,469,153,5243
11/1/2020,VA,Virginia,Wythe,51197,7993,5520,2473,6338,32,6306,1655,16,1639,7559,5086,2473,6284,4058,2226,1701,284,93,4206
11/1/2020,VA,Virginia,York,51199,12790,10652,2138,11818,39,11779,972,39,933,11713,9575,2138,6425,4566,1859,738,159,34,5494
10/1/2020,VA,Virginia,Accomack,51001,9245,7311,1934,8066,56,8010,1179,42,1137,8577,6644,1933,6395,4814,1581,1568,353,80,4394
10/1/2020,VA,Virginia,Albemarle,51003,22287,19267,3020,20751,59,20692,1536,38,1498,20135,17118,3017,15780,13210,2570,1626,289,91,13774
10/1/2020,VA,Virginia,Alexandria City,51510,18642,14962,3680,17334,61,17273,1308,72,1236,15073,11395,3678,9515,6186,3329,2183,309,62,6961
10/1/2020,VA,Virginia,Alleghany,51005,4653,3654,999,3800,17,3783,853,13,840,4411,3412,999,3622,2758,864,846,104,46,2626
10/1/2020,VA,Virginia,Amelia,51007,3190,2206,984,2732,*,*,458,14,444,2955,1971,984,2401,1482,919,475,89,29,1808
10/1/2020,VA,Virginia,Amherst,51009,8009,5919,2090,6739,46,6693,1270,31,1239,7463,5373,2090,6170,4272,1898,1282,199,70,4619
10/1/2020,VA,Virginia,Appomattox,51011,4068,3064,1004,3382,17,3365,686,23,663,3829,2825,1004,3176,2253,923,732,101,48,2295
10/1/2020,VA,Virginia,Arlington,51013,25376,20830,4546,23827,96,23731,1549,69,1480,20035,15489,4546,12527,8385,4142,3014,382,117,9014
10/1/2020,VA,Virginia,Augusta,51015,18945,15434,3511,16580,64,16516,2365,52,2313,17777,14266,3511,14097,11037,3060,1970,395,130,11602
10/1/2020,VA,Virginia,Bath,51017,1280,1116,164,1121,*,*,159,0,159,1218,1054,164,973,828,145,166,*,*,762
10/1/2020,VA,Virginia,Bedford,51019,20553,16073,4480,17863,80,17783,2690,50,2640,19167,14688,4479,15292,11784,3508,2097,474,139,12582
10/1/2020,VA,Virginia,Bland,51021,1821,1285,536,1458,*,*,363,*,*,1717,1181,536,1348,940,408,227,58,14,1049
10/1/2020,VA,Virginia,Botetourt,51023,8958,6497,2461,7924,46,7878,1034,20,1014,8351,5890,2461,6717,4592,2125,742,158,45,5772
10/1/2020,VA,Virginia,Bristol City,51520,4675,2321,2354,3730,*,*,945,12,933,4399,2045,2354,3772,1509,2263,1159,144,41,2428
10/1/2020,VA,Virginia,Brunswick,51025,4117,3018,1099,3470,37,3433,647,17,630,3857,2758,1099,3113,2134,979,1077,125,37,1874
10/1/2020,VA,Virginia,Buchanan,51027,7172,3646,3526,4726,23,4703,2446,16,2430,6944,3418,3526,5985,3247,2738,1703,383,104,3795
10/1/2020,VA,Virginia,Buckingham,51029,3761,2926,835,3106,21,3085,655,19,636,3529,2694,835,2746,2115,631,812,134,43,1757
10/1/2020,VA,Virginia,Buena Vista City,51530,1501,1134,367,1235,*,*,266,*,*,1399,1032,367,1104,784,320,316,58,13,717
10/1/2020,VA,Virginia,Campbell,51031,13400,10080,3320,11277,79,11198,2123,59,2064,12593,9273,3320,10369,7397,2972,2160,365,116,7728
10/1/2020,VA,Virginia,Caroline,51033,6223,4700,1523,5310,42,5268,913,31,882,5628,4105,1523,3959,2605,1354,912,199,38,2810
10/1/2020,VA,Virginia,Carroll,51035,8603,6785,1818,7192,27,7165,1411,16,1395,8201,6383,1818,6537,4989,1548,1642,262,97,4536
10/1/2020,VA,Virginia,Charles City,51036,2000,1421,579,1724,19,1705,276,14,262,1841,1262,579,1433,921,512,267,79,16,1071
10/1/2020,VA,Virginia,Charlotte,51037,3298,2553,745,2735,16,2719,563,16,547,3099,2354,745,2496,1829,667,739,120,35,1602
10/1/2020,VA,Virginia,Charlottesville City,51540,6403,5338,1065,5444,26,5418,959,42,917,5745,4681,1064,4726,3735,991,1237,151,34,3304
10/1/2020,VA,Virginia,Chesapeake City,51550,40586,30053,10533,35412,280,35132,5174,219,4955,36770,26239,10531,23142,13618,9524,4431,957,203,17551
10/1/2020,VA,Virginia,Chesterfield,51041,64457,46576,17881,57237,241,56996,7220,256,6964,58382,40505,17877,46104,29933,16171,6014,1022,246,38822
10/1/2020,VA,Virginia,Clarke,51043,3461,2918,543,3211,*,*,250,*,*,3113,2570,543,2203,1781,422,294,71,26,1812
10/1/2020,VA,Virginia,Colonial Heights City,51570,4176,3261,915,3588,*,*,588,*,*,3841,2926,915,2620,1796,824,526,103,15,1976
10/1/2020,VA,Virginia,Covington City,51580,1579,1232,347,1230,17,1213,349,*,*,1480,1133,347,1216,891,325,341,46,15,814
10/1/2020,VA,Virginia,Craig,51045,1376,962,414,1098,*,*,278,*,*,1285,871,414,1046,669,377,211,*,*,777
10/1/2020,VA,Virginia,Culpeper,51047,9925,8148,1777,8737,30,8707,1188,39,1149,8993,7217,1776,6397,5033,1364,1289,229,62,4817
10/1/2020,VA,Virginia,Cumberland,51049,2416,1745,671,2015,12,2003,401,*,*,2236,1565,671,1801,1205,596,468,90,24,1219
10/1/2020,VA,Virginia,Danville City,51590,11174,7121,4053,8895,85,8810,2279,126,2153,10502,6449,4053,9108,5932,3176,3338,396,155,5219
10/1/2020,VA,Virginia,Dickenson,51051,4922,2333,2589,3283,*,*,1639,*,*,4740,2151,2589,4040,1701,2339,1165,214,64,2597
10/1/2020,VA,Virginia,Dinwiddie,51053,6175,4471,1704,5090,37,5053,1085,37,1048,5713,4009,1704,4383,2774,1609,969,191,49,3174
10/1/2020,VA,Virginia,Emporia City,51595,1327,867,460,1053,19,1034,274,*,*,1243,783,460,1024,616,408,442,73,12,497
10/1/2020,VA,Virginia,Essex,51057,3061,2313,748,2638,13,2625,423,16,407,2834,2086,748,2193,1579,614,497,88,35,1573
10/1/2020,VA,Virginia,Fairfax,51059,159686,125813,33873,151570,565,151005,8116,424,7692,129309,95455,33854,79767,50467,29300,14803,2678,571,61715
10/1/2020,VA,Virginia,Fairfax City,51600,4018,3132,886,3779,15,3764,239,14,225,3362,2476,886,2202,1470,732,402,70,17,1713
10/1/2020,VA,Virginia,Falls Church City,51610,2151,1735,416,2077,*,*,74,*,*,1694,1278,416,1097,734,363,139,*,*,944
10/1/2020,VA,Virginia,Fauquier,51061,13317,11380,1937,12270,74,12196,1047,35,1012,11813,9876,1937,7899,6434,1465,1009,190,53,6647
10/1/2020,VA,Virginia,Floyd,51063,4271,3211,1060,3736,11,3725,535,*,*,4001,2942,1059,3266,2271,995,645,103,39,2479
10/1/2020,VA,Virginia,Fluvanna,51065,6370,5334,1036,5736,24,5712,634,17,617,5813,4777,1036,4363,3519,844,612,112,29,3610
10/1/2020,VA,Virginia,Franklin,51067,15483,10486,4997,13197,58,13139,2286,35,2251,14548,9551,4997,12076,7565,4511,2128,469,141,9338
10/1/2020,VA,Virginia,Franklin City,51620,2202,1688,514,1791,17,1774,411,23,388,2067,1553,514,1688,1211,477,568,62,13,1045
10/1/2020,VA,Virginia,Frederick,51069,17600,14289,3311,15851,67,15784,1749,49,1700,15993,12684,3309,11410,8711,2699,1507,373,116,9414
10/1/2020,VA,Virginia,Fredericksburg City,51630,4292,3376,916,3598,24,3574,694,26,668,3803,2887,916,2703,1874,829,854,83,27,1739
10/1/2020,VA,Virginia,Galax City,51640,1765,1474,291,1420,*,*,345,*,*,1674,1383,291,1396,1144,252,582,53,22,739
10/1/2020,VA,Virginia,Giles,51071,4643,3389,1254,3731,17,3714,912,15,897,4400,3146,1254,3698,2762,936,832,103,36,2727
10/1/2020,VA,Virginia,Gloucester,51073,9083,7194,1889,7957,47,7910,1126,22,1104,8378,6490,1888,5570,3913,1657,1044,179,56,4291
10/1/2020,VA,Virginia,Goochland,51075,6273,4790,1483,5799,28,5771,474,13,461,5776,4293,1483,4851,3596,1255,436,96,23,4296
10/1/2020,VA,Virginia,Grayson,51077,4631,3478,1153,3850,16,3834,781,*,*,4439,3286,1153,3513,2462,1051,937,186,77,2313
10/1/2020,VA,Virginia,Greene,51079,4171,3494,677,3671,13,3658,500,12,488,3798,3121,677,2826,2227,599,497,80,22,2227
10/1/2020,VA,Virginia,Greensville,51081,2139,1415,724,1728,19,1709,411,15,396,1986,1262,724,1634,1039,595,466,95,19,1054
10/1/2020,VA,Virginia,Halifax,51083,9977,7847,2130,8329,54,8275,1648,54,1594,9348,7218,2130,7613,5691,1922,2195,394,119,4905
10/1/2020,VA,Virginia,Hampton City,51650,26203,17877,8326,21893,215,21678,4310,212,4098,23884,15559,8325,15319,7465,7854,4229,739,159,10192
10/1/2020,VA,Virginia,Hanover,51085,22616,16505,6111,20738,95,20643,1878,48,1830,20685,14576,6109,16998,11859,5139,1575,300,85,15038
10/1/2020,VA,Virginia,Harrisonburg City,51660,5639,4732,907,4816,21,4795,823,20,803,5133,4226,907,4150,3420,730,1021,137,44,2948
10/1/2020,VA,Virginia,Henrico,51087,59681,41208,18473,52703,355,52348,6978,298,6680,54114,35641,18473,45022,28491,16531,7164,1374,352,36132
10/1/2020,VA,Virginia,Henry,51089,14938,9467,5471,12018,78,11940,2920,69,2851,14242,8772,5470,12368,7225,5143,3101,704,204,8359
10/1/2020,VA,Virginia,Highland,51091,820,719,101,748,0,748,72,0,72,770,669,101,590,509,81,62,*,*,500
10/1/2020,VA,Virginia,Hopewell City,51670,4612,3228,1384,3604,27,3577,1008,28,980,4286,2902,1384,3092,1768,1324,1089,142,32,1829
10/1/2020,VA,Virginia,Isle of Wight,51093,8810,6637,2173,7818,54,7764,992,33,959,8153,5980,2173,5826,3816,2010,1021,195,59,4551
10/1/2020,VA,Virginia,James City,51095,21848,18076,3772,20598,62,20536,1250,41,1209,20265,16495,3770,13391,10454,2937,984,235,56,12116
10/1/2020,VA,Virginia,King and Queen,51097,1831,1409,422,1574,*,*,257,*,*,1701,1279,422,1304,931,373,281,63,11,949
10/1/2020,VA,Virginia,King George,51099,4232,3600,632,3705,21,3684,527,20,507,3675,3043,632,1920,1367,553,482,72,19,1347
10/1/2020,VA,Virginia,King William,51101,3645,2841,804,3140,22,3118,505,31,474,3379,2575,804,2777,2058,719,443,95,17,2222
10/1/2020,VA,Virginia,Lancaster,51103,4427,3661,766,4105,24,4081,322,16,306,4178,3413,765,3114,2564,550,500,90,12,2512
10/1/2020,VA,Virginia,Lee,51105,6443,2941,3502,4575,15,4560,1868,18,1850,6135,2636,3499,5169,2014,3155,2006,235,60,2868
10/1/2020,VA,Virginia,Lexington City,51678,1364,1147,217,1250,*,*,114,*,*,1257,1041,216,988,799,189,176,30,11,771
10/1/2020,VA,Virginia,Loudoun,51107,41682,32793,8889,39250,176,39074,2432,118,2314,34681,25797,8884,23870,16233,7637,3610,659,155,19446
10/1/2020,VA,Virginia,Louisa,51109,8879,6760,2119,7585,52,7533,1294,36,1258,8138,6019,2119,6161,4300,1861,1192,245,50,4674
10/1/2020,VA,Virginia,Lunenburg,51111,3208,2525,683,2693,17,2676,515,13,502,2978,2295,683,2310,1687,623,766,111,35,1398
10/1/2020,VA,Virginia,Lynchburg City,51680,14820,10962,3858,12255,84,12171,2565,101,2464,13794,9936,3858,11495,7969,3526,3108,423,122,7842
10/1/2020,VA,Virginia,Madison,51113,3406,2779,627,3058,12,3046,348,*,*,3169,2542,627,2388,1880,508,441,81,15,1851
10/1/2020,VA,Virginia,Manassas City,51683,4831,3685,1146,4297,25,4272,534,40,494,4065,2919,1146,2912,1918,994,589,95,22,2206
10/1/2020,VA,Virginia,Manassas Park City,51685,1363,947,416,1195,15,1180,168,13,155,1134,718,416,840,458,382,222,*,*,558
10/1/2020,VA,Virginia,Martinsville City,51690,3818,2433,1385,2915,39,2876,903,34,869,3617,2232,1385,3167,1838,1329,1295,171,47,1654
10/1/2020,VA,Virginia,Mathews,51115,2944,2349,595,2699,11,2688,245,*,*,2778,2183,595,2042,1549,493,292,35,20,1695
10/1/2020,VA,Virginia,Mecklenburg,51117,9447,7170,2277,7960,53,7907,1487,64,1423,8876,6599,2277,7114,5098,2016,1844,365,88,4817
10/1/2020,VA,Virginia,Middlesex,51119,3735,3028,707,3390,15,3375,345,*,*,3513,2806,707,2705,2139,566,458,76,22,2149
10/1/2020,VA,Virginia,Montgomery,51121,14526,11141,3385,12287,55,12232,2239,31,2208,13101,9716,3385,11060,7998,3062,2007,328,94,8631
10/1/2020,VA,Virginia,Nelson,51125,4831,3943,888,4364,16,4348,467,*,*,4484,3597,887,3376,2603,773,598,106,34,2638
10/1/2020,VA,Virginia,New Kent,51127,5006,3911,1095,4535,19,4516,471,11,460,4568,3473,1095,3319,2450,869,340,76,19,2884
10/1/2020,VA,Virginia,Newport News City,51700,29528,19994,9534,24580,217,24363,4948,238,4710,27006,17473,9533,18333,9247,9086,5343,873,184,11933
10/1/2020,VA,Virginia,Norfolk City,51710,34169,22929,11240,27897,287,27610,6272,314,5958,30754,19515,11239,21544,10808,10736,7694,1262,259,12329
10/1/2020,VA,Virginia,Northampton,51131,3802,2864,938,3340,18,3322,462,19,443,3551,2613,938,2874,2054,820,906,82,25,1861
10/1/2020,VA,Virginia,Northumberland,51133,4723,3871,852,4390,12,4378,333,11,322,4421,3569,852,3047,2466,581,442,73,21,2511
10/1/2020,VA,Virginia,Norton City,51720,1140,600,540,796,*,*,344,*,*,1068,528,540,913,426,487,346,*,*,512
10/1/2020,VA,Virginia,Nottoway,51135,3682,2784,898,3040,23,3017,642,16,626,3427,2529,898,2730,1966,764,887,120,42,1681
10/1/2020,VA,Virginia,Orange,51137,9021,7467,1554,8028,54,7974,993,30,963,8244,6690,1554,5670,4508,1162,1016,187,54,4413
10/1/2020,VA,Virginia,Page,51139,6347,5218,1129,5308,15,5293,1039,18,1021,5923,4794,1129,4439,3468,971,1095,240,60,3044
10/1/2020,VA,Virginia,Patrick,51141,5543,3952,1591,4645,13,4632,898,11,887,5290,3700,1590,4355,2958,1397,1058,186,61,3050
10/1/2020,VA,Virginia,Petersburg City,51730,7240,4555,2685,5471,94,5377,1769,74,1695,6597,3912,2685,5056,2443,2613,2194,320,54,2488
10/1/2020,VA,Virginia,Pittsylvania,51143,16669,11086,5583,13920,96,13824,2749,70,2679,15688,10105,5583,13301,8948,4353,3081,519,156,9545
10/1/2020,VA,Virginia,Poquoson City,51735,2669,2267,402,2496,*,*,173,*,*,2447,2045,402,1319,965,354,121,24,11,1163
10/1/2020,VA,Virginia,Portsmouth City,51740,18742,12585,6157,14839,181,14658,3903,196,3707,16816,10660,6156,11629,5734,5895,4262,683,115,6569
10/1/2020,VA,Virginia,Powhatan,51145,6462,4953,1509,5883,11,5872,579,13,566,5967,4458,1509,4896,3597,1299,425,105,25,4341
10/1/2020,VA,Virginia,Prince Edward,51147,4751,3595,1156,3896,33,3863,855,30,825,4395,3239,1156,3524,2547,977,1076,161,43,2244
10/1/2020,VA,Virginia,Prince George,51149,6427,5300,1127,5487,36,5451,940,29,911,5944,4818,1126,3757,2738,1019,627,121,27,2982
10/1/2020,VA,Virginia,Prince William,51153,52718,40465,12253,47653,293,47360,5065,301,4764,44905,32656,12249,26978,15981,10997,5555,1138,212,20073
10/1/2020,VA,Virginia,Pulaski,51155,9258,7022,2236,7529,27,7502,1729,32,1697,8658,6422,2236,7205,5227,1978,1629,280,88,5208
10/1/2020,VA,Virginia,Radford City,51750,2093,1578,515,1722,*,*,371,*,*,1898,1383,515,1637,1163,474,343,46,23,1225
10/1/2020,VA,Virginia,Rappahannock,51157,2030,1778,252,1904,*,*,126,*,*,1839,1588,251,1291,1106,185,164,35,12,1080
10/1/2020,VA,Virginia,Richmond,51159,1980,1517,463,1731,*,*,249,11,238,1840,1377,463,1403,1067,336,325,64,13,1001
10/1/2020,VA,Virginia,Richmond City,51760,35098,21220,13878,28514,259,28255,6584,297,6287,31733,17857,13876,27391,14165,13226,9186,1308,264,16633
10/1/2020,VA,Virginia,Roanoke,51161,24367,17612,6755,21811,103,21708,2556,55,2501,22493,15740,6753,18508,12632,5876,2168,457,123,15760
10/1/2020,VA,Virginia,Roanoke City,51770,21497,13673,7824,16715,153,16562,4782,139,4643,19645,11824,7821,16345,9040,7305,5024,862,182,10277
10/1/2020,VA,Virginia,Rockbridge,51163,6524,5167,1357,5637,*,*,887,*,*,6066,4709,1357,4663,3490,1173,907,170,50,3536
10/1/2020,VA,Virginia,Rockingham,51165,18529,15529,3000,16455,53,16402,2074,42,2032,17174,14174,3000,13674,11394,2280,1911,496,135,11132
10/1/2020,VA,Virginia,Russell,51167,8053,4389,3664,5757,17,5740,2296,19,2277,7741,4078,3663,6727,3650,3077,1762,324,146,4495
10/1/2020,VA,Virginia,Salem City,51775,6129,4551,1578,5250,29,5221,879,15,864,5640,4062,1578,4623,3192,1431,860,121,40,3602
10/1/2020,VA,Virginia,Scott,51169,6815,2825,3990,5257,14,5243,1558,16,1542,6546,2556,3990,5772,1959,3813,1547,249,104,3872
10/1/2020,VA,Virginia,Shenandoah,51171,10934,8877,2057,9787,33,9754,1147,21,1126,10262,8205,2057,7558,5837,1721,1317,253,82,5906
10/1/2020,VA,Virginia,Smyth,51173,8698,5680,3018,6640,30,6610,2058,24,2034,8272,5254,3018,6953,4119,2834,2111,346,129,4367
10/1/2020,VA,Virginia,Southampton,51175,4061,3208,853,3455,26,3429,606,26,580,3777,2924,853,2985,2227,758,706,115,27,2137
10/1/2020,VA,Virginia,Spotsylvania,51177,22815,18406,4409,20057,115,19942,2758,102,2656,20250,15843,4407,12682,8929,3753,2201,546,130,9805
10/1/2020,VA,Virginia,Stafford,51179,19034,15944,3090,16994,106,16888,2040,86,1954,16698,13610,3088,8801,6156,2645,1603,355,81,6762
10/1/2020,VA,Virginia,Staunton City,51790,6368,5097,1271,5404,20,5384,964,16,948,5999,4728,1271,4794,3675,1119,1111,155,51,3477
10/1/2020,VA,Virginia,Suffolk City,51800,17426,12728,4698,14519,121,14398,2907,114,2793,15977,11279,4698,11093,6750,4343,2927,481,101,7584
10/1/2020,VA,Virginia,Surry,51181,1761,1284,477,1530,11,1519,231,*,*,1634,1157,477,1228,780,448,232,57,13,926
10/1/2020,VA,Virginia,Sussex,51183,2555,1794,761,2096,27,2069,459,*,*,2383,1622,761,1857,1137,720,528,134,18,1177
10/1/2020,VA,Virginia,Tazewell,51185,12021,7345,4676,9078,30,9048,2943,36,2907,11454,6780,4674,9346,5771,3575,2371,467,129,6379
10/1/2020,VA,Virginia,Unknown,51999,*,*,*,*,*,*,*,*,*,*,*,*,*,*,*,*,*,*,*
10/1/2020,VA,Virginia,Virginia Beach City,51810,76442,59388,17054,68017,372,67645,8425,350,8075,70071,53025,17046,41691,26150,15541,7435,1487,381,32388
10/1/2020,VA,Virginia,Warren,51187,8181,6817,1364,7150,22,7128,1031,37,994,7440,6076,1364,5197,4088,1109,974,217,66,3940
10/1/2020,VA,Virginia,Washington,51191,15299,8918,6381,12592,42,12550,2707,32,2675,14450,8070,6380,12191,6275,5916,2454,553,190,8994
10/1/2020,VA,Virginia,Waynesboro City,51820,5093,4029,1064,4251,17,4234,842,25,817,4775,3711,1064,3853,2880,973,959,114,44,2736
10/1/2020,VA,Virginia,Westmoreland,51193,5241,4315,926,4658,25,4633,583,17,566,4783,3857,926,3206,2413,793,838,139,42,2187
10/1/2020,VA,Virginia,Williamsburg City,51830,2881,2317,564,2639,*,*,242,*,*,2665,2101,564,1932,1451,481,273,*,*,1616
10/1/2020,VA,Virginia,Winchester City,51840,5629,4609,1020,4873,27,4846,756,22,734,5129,4110,1019,3803,2935,868,915,138,37,2713
10/1/2020,VA,Virginia,Wise,51195,10686,5036,5650,7437,24,7413,3249,24,3225,10119,4470,5649,8367,3419,4948,2497,470,152,5248
10/1/2020,VA,Virginia,Wythe,51197,7988,5518,2470,6337,32,6305,1651,17,1634,7551,5081,2470,6283,4060,2223,1697,286,94,4206
10/1/2020,VA,Virginia,York,51199,12744,10615,2129,11774,40,11734,970,38,932,11688,9559,2129,6400,4549,1851,731,158,34,5477
9/1/2020,VA,Virginia,Accomack,51001,9233,7307,1926,8062,57,8005,1171,42,1129,8564,6639,1925,6390,4818,1572,1563,351,80,4396
9/1/2020,VA,Virginia,Albemarle,51003,22247,19240,3007,20711,62,20649,1536,38,1498,20103,17099,3004,15759,13202,2557,1628,285,91,13755
9/1/2020,VA,Virginia,Alexandria City,51510,18595,14947,3648,17289,63,17226,1306,74,1232,15013,11367,3646,9497,6203,3294,2173,306,62,6956
9/1/2020,VA,Virginia,Alleghany,51005,4651,3662,989,3797,17,3780,854,14,840,4410,3421,989,3625,2770,855,849,104,46,2626
9/1/2020,VA,Virginia,Amelia,51007,3192,2213,979,2739,*,*,453,14,439,2949,1970,979,2400,1486,914,474,88,28,1810
9/1/2020,VA,Virginia,Amherst,51009,7990,5921,2069,6722,47,6675,1268,32,1236,7452,5383,2069,6164,4287,1877,1277,198,68,4621
9/1/2020,VA,Virginia,Appomattox,51011,4069,3071,998,3384,18,3366,685,24,661,3832,2834,998,3171,2255,916,725,102,47,2297
9/1/2020,VA,Virginia,Arlington,51013,25316,20812,4504,23775,97,23678,1541,70,1471,19992,15488,4504,12507,8408,4099,3020,379,117,8991
9/1/2020,VA,Virginia,Augusta,51015,18907,15424,3483,16548,66,16482,2359,52,2307,17738,14255,3483,14077,11050,3027,1961,392,130,11594
9/1/2020,VA,Virginia,Bath,51017,1281,1119,162,1122,*,*,159,0,159,1217,1055,162,972,829,143,168,33,11,760
9/1/2020,VA,Virginia,Bedford,51019,20502,16043,4459,17822,81,17741,2680,50,2630,19125,14667,4458,15255,11771,3484,2082,478,139,12556
9/1/2020,VA,Virginia,Bland,51021,1824,1287,537,1462,*,*,362,*,*,1720,1183,537,1356,945,411,234,58,14,1050
9/1/2020,VA,Virginia,Botetourt,51023,8949,6505,2444,7918,47,7871,1031,20,1011,8334,5890,2444,6701,4591,2110,737,160,45,5759
9/1/2020,VA,Virginia,Bristol City,51520,4678,2338,2340,3736,*,*,942,12,930,4399,2059,2340,3772,1521,2251,1158,141,41,2432
9/1/2020,VA,Virginia,Brunswick,51025,4124,3029,1095,3477,38,3439,647,17,630,3860,2765,1095,3111,2137,974,1080,124,37,1870
9/1/2020,VA,Virginia,Buchanan,51027,7177,3661,3516,4737,24,4713,2440,16,2424,6946,3430,3516,5994,3264,2730,1688,383,106,3817
9/1/2020,VA,Virginia,Buckingham,51029,3754,2926,828,3102,21,3081,652,18,634,3527,2699,828,2741,2118,623,815,135,40,1751
9/1/2020,VA,Virginia,Buena Vista City,51530,1503,1143,360,1239,*,*,264,*,*,1399,1039,360,1106,792,314,315,58,13,720
9/1/2020,VA,Virginia,Campbell,51031,13388,10081,3307,11274,80,11194,2114,60,2054,12583,9276,3307,10359,7403,2956,2152,366,115,7726
9/1/2020,VA,Virginia,Caroline,51033,6217,4711,1506,5304,43,5261,913,31,882,5623,4117,1506,3947,2612,1335,910,199,35,2803
9/1/2020,VA,Virginia,Carroll,51035,8598,6789,1809,7192,27,7165,1406,16,1390,8198,6389,1809,6540,5000,1540,1634,261,100,4545
9/1/2020,VA,Virginia,Charles City,51036,2001,1423,578,1724,19,1705,277,14,263,1840,1262,578,1430,919,511,267,78,16,1069
9/1/2020,VA,Virginia,Charlotte,51037,3301,2555,746,2737,17,2720,564,16,548,3101,2355,746,2495,1827,668,737,120,34,1604
9/1/2020,VA,Virginia,Charlottesville City,51540,6397,5350,1047,5441,26,5415,956,42,914,5743,4697,1046,4723,3750,973,1233,151,34,3305
9/1/2020,VA,Virginia,Chesapeake City,51550,40467,30000,10467,35318,284,35034,5149,218,4931,36671,26206,10465,23117,13663,9454,4415,958,200,17544
9/1/2020,VA,Virginia,Chesterfield,51041,64287,46496,17791,57092,245,56847,7195,255,6940,58218,40431,17787,45983,29906,16077,5978,1027,247,38731
9/1/2020,VA,Virginia,Clarke,51043,3461,2924,537,3210,*,*,251,*,*,3111,2574,537,2194,1779,415,294,68,26,1806
9/1/2020,VA,Virginia,Colonial Heights City,51570,4172,3256,916,3590,11,3579,582,*,*,3839,2923,916,2615,1791,824,520,102,13,1980
9/1/2020,VA,Virginia,Covington City,51580,1577,1227,350,1227,17,1210,350,*,*,1477,1127,350,1219,891,328,342,45,13,819
9/1/2020,VA,Virginia,Craig,51045,1370,960,410,1093,*,*,277,*,*,1281,871,410,1044,671,373,211,*,*,775
9/1/2020,VA,Virginia,Culpeper,51047,9913,8148,1765,8731,32,8699,1182,38,1144,8989,7225,1764,6388,5034,1354,1277,230,63,4818
9/1/2020,VA,Virginia,Cumberland,51049,2418,1748,670,2020,13,2007,398,*,*,2237,1567,670,1805,1210,595,466,89,24,1226
9/1/2020,VA,Virginia,Danville City,51590,11181,7144,4037,8907,85,8822,2274,125,2149,10502,6465,4037,9117,5959,3158,3333,397,154,5233
9/1/2020,VA,Virginia,Dickenson,51051,4912,2334,2578,3282,*,*,1630,*,*,4728,2150,2578,4034,1706,2328,1157,215,64,2598
9/1/2020,VA,Virginia,Dinwiddie,51053,6180,4487,1693,5091,37,5054,1089,37,1052,5710,4017,1693,4376,2780,1596,965,192,49,3170
9/1/2020,VA,Virginia,Emporia City,51595,1331,872,459,1056,19,1037,275,*,*,1247,788,459,1027,620,407,444,74,12,497
9/1/2020,VA,Virginia,Essex,51057,3057,2313,744,2633,12,2621,424,16,408,2831,2087,744,2195,1586,609,497,89,34,1575
9/1/2020,VA,Virginia,Fairfax,51059,158982,125403,33579,150910,569,150341,8072,427,7645,128761,95203,33558,79441,50448,28993,14724,2682,563,61472
9/1/2020,VA,Virginia,Fairfax City,51600,4011,3136,875,3773,15,3758,238,14,224,3361,2486,875,2195,1472,723,398,70,17,1710
9/1/2020,VA,Virginia,Falls Church City,51610,2144,1732,412,2071,*,*,73,*,*,1688,1276,412,1094,734,360,138,*,*,942
9/1/2020,VA,Virginia,Fauquier,51061,13278,11356,1922,12237,75,12162,1041,35,1006,11787,9865,1922,7889,6437,1452,1010,187,51,6641
9/1/2020,VA,Virginia,Floyd,51063,4286,3225,1061,3752,12,3740,534,*,*,4014,2954,1060,3283,2289,994,652,101,39,2491
9/1/2020,VA,Virginia,Fluvanna,51065,6355,5322,1033,5725,24,5701,630,17,613,5800,4767,1033,4357,3518,839,609,113,29,3606
9/1/2020,VA,Virginia,Franklin,51067,15449,10464,4985,13176,58,13118,2273,33,2240,14512,9527,4985,12065,7569,4496,2125,470,139,9331
9/1/2020,VA,Virginia,Franklin City,51620,2202,1690,512,1793,17,1776,409,23,386,2067,1555,512,1688,1213,475,564,60,13,1051
9/1/2020,VA,Virginia,Frederick,51069,17569,14274,3295,15822,67,15755,1747,48,1699,15972,12679,3293,11400,8716,2684,1501,376,116,9407
9/1/2020,VA,Virginia,Fredericksburg City,51630,4286,3375,911,3591,25,3566,695,26,669,3797,2886,911,2708,1885,823,852,83,27,1746
9/1/2020,VA,Virginia,Galax City,51640,1765,1482,283,1419,*,*,346,*,*,1674,1391,283,1392,1148,244,579,52,21,740
9/1/2020,VA,Virginia,Giles,51071,4641,3389,1252,3731,18,3713,910,15,895,4396,3144,1252,3695,2764,931,826,104,36,2729
9/1/2020,VA,Virginia,Gloucester,51073,9052,7176,1876,7932,47,7885,1120,22,1098,8330,6455,1875,5548,3905,1643,1039,176,55,4278
9/1/2020,VA,Virginia,Goochland,51075,6245,4764,1481,5773,28,5745,472,13,459,5764,4283,1481,4838,3585,1253,432,94,23,4289
9/1/2020,VA,Virginia,Grayson,51077,4635,3482,1153,3853,16,3837,782,*,*,4437,3284,1153,3518,2467,1051,947,186,78,2307
9/1/2020,VA,Virginia,Greene,51079,4154,3485,669,3656,13,3643,498,12,486,3766,3097,669,2807,2217,590,494,79,22,2212
9/1/2020,VA,Virginia,Greensville,51081,2141,1422,719,1732,19,1713,409,15,394,1984,1265,719,1636,1046,590,461,97,19,1059
9/1/2020,VA,Virginia,Halifax,51083,9961,7861,2100,8317,55,8262,1644,55,1589,9339,7239,2100,7613,5722,1891,2194,394,121,4904
9/1/2020,VA,Virginia,Hampton City,51650,26163,17893,8270,21864,220,21644,4299,216,4083,23847,15578,8269,15308,7512,7796,4216,739,155,10198
9/1/2020,VA,Virginia,Hanover,51085,22546,16461,6085,20682,95,20587,1864,48,1816,20623,14539,6084,16975,11863,5112,1572,296,82,15025
9/1/2020,VA,Virginia,Harrisonburg City,51660,5632,4738,894,4808,22,4786,824,20,804,5120,4226,894,4137,3421,716,1017,135,44,2941
9/1/2020,VA,Virginia,Henrico,51087,59573,41195,18378,52631,365,52266,6942,295,6647,54002,35624,18378,44963,28533,16430,7122,1380,347,36114
9/1/2020,VA,Virginia,Henry,51089,14942,9492,5450,12023,81,11942,2919,70,2849,14239,8790,5449,12377,7254,5123,3104,702,203,8368
9/1/2020,VA,Virginia,Highland,51091,820,721,99,747,0,747,73,*,*,771,672,99,589,510,79,62,*,*,500
9/1/2020,VA,Virginia,Hopewell City,51670,4618,3240,1378,3613,28,3585,1005,28,977,4292,2914,1378,3092,1773,1319,1088,141,33,1830
9/1/2020,VA,Virginia,Isle of Wight,51093,8798,6631,2167,7813,56,7757,985,33,952,8145,5978,2167,5822,3819,2003,1017,197,62,4546
9/1/2020,VA,Virginia,James City,51095,21792,18037,3755,20547,63,20484,1245,42,1203,20229,16476,3753,13366,10449,2917,976,236,54,12100
9/1/2020,VA,Virginia,King and Queen,51097,1829,1409,420,1569,*,*,260,*,*,1703,1283,420,1305,935,370,283,*,*,950
9/1/2020,VA,Virginia,King George,51099,4221,3593,628,3700,22,3678,521,20,501,3667,3039,628,1920,1371,549,479,71,19,1351
9/1/2020,VA,Virginia,King William,51101,3635,2836,799,3130,22,3108,505,31,474,3368,2569,799,2764,2051,713,439,93,17,2215
9/1/2020,VA,Virginia,Lancaster,51103,4427,3668,759,4105,25,4080,322,16,306,4176,3418,758,3111,2567,544,498,92,11,2510
9/1/2020,VA,Virginia,Lee,51105,6451,2962,3489,4588,15,4573,1863,20,1843,6140,2654,3486,5176,2035,3141,2005,232,60,2879
9/1/2020,VA,Virginia,Lexington City,51678,1361,1145,216,1248,*,*,113,*,*,1250,1035,215,987,799,188,175,30,11,771
9/1/2020,VA,Virginia,Loudoun,51107,41515,32692,8823,39090,177,38913,2425,118,2307,34553,25735,8818,23771,16203,7568,3578,660,154,19379
9/1/2020,VA,Virginia,Louisa,51109,8863,6754,2109,7573,52,7521,1290,36,1254,8125,6016,2109,6150,4302,1848,1187,246,50,4667
9/1/2020,VA,Virginia,Lunenburg,51111,3200,2519,681,2687,17,2670,513,13,500,2971,2290,681,2312,1690,622,760,113,35,1404
9/1/2020,VA,Virginia,Lynchburg City,51680,14800,10957,3843,12242,85,12157,2558,101,2457,13771,9928,3843,11481,7972,3509,3104,424,117,7836
9/1/2020,VA,Virginia,Madison,51113,3395,2769,626,3048,13,3035,347,*,*,3160,2534,626,2381,1875,506,440,81,14,1846
9/1/2020,VA,Virginia,Manassas City,51683,4814,3672,1142,4280,25,4255,534,41,493,4062,2920,1142,2912,1922,990,584,98,23,2207
9/1/2020,VA,Virginia,Manassas Park City,51685,1360,948,412,1191,15,1176,169,14,155,1136,724,412,842,464,378,224,*,*,558
9/1/2020,VA,Virginia,Martinsville City,51690,3826,2448,1378,2924,39,2885,902,34,868,3627,2249,1378,3171,1850,1321,1296,171,47,1657
9/1/2020,VA,Virginia,Mathews,51115,2936,2347,589,2692,11,2681,244,*,*,2771,2182,589,2034,1548,486,289,37,20,1688
9/1/2020,VA,Virginia,Mecklenburg,51117,9438,7173,2265,7955,54,7901,1483,64,1419,8865,6600,2265,7116,5113,2003,1838,371,88,4819
9/1/2020,VA,Virginia,Middlesex,51119,3732,3028,704,3388,15,3373,344,*,*,3508,2804,704,2695,2133,562,456,76,22,2141
9/1/2020,VA,Virginia,Montgomery,51121,14526,11158,3368,12286,55,12231,2240,31,2209,13092,9724,3368,11067,8025,3042,2006,330,96,8635
9/1/2020,VA,Virginia,Nelson,51125,4819,3935,884,4352,16,4336,467,*,*,4473,3590,883,3376,2607,769,595,106,35,2640
9/1/2020,VA,Virginia,New Kent,51127,4990,3903,1087,4520,19,4501,470,11,459,4550,3463,1087,3313,2452,861,338,76,18,2881
9/1/2020,VA,Virginia,Newport News City,51700,29466,19987,9479,24533,222,24311,4933,238,4695,26932,17454,9478,18316,9289,9027,5330,873,186,11927
9/1/2020,VA,Virginia,Norfolk City,51710,34087,22907,11180,27843,291,27552,6244,312,5932,30698,19519,11179,21502,10831,10671,7644,1260,255,12343
9/1/2020,VA,Virginia,Northampton,51131,3795,2867,928,3335,18,3317,460,19,441,3544,2616,928,2876,2068,808,906,80,26,1864
9/1/2020,VA,Virginia,Northumberland,51133,4712,3859,853,4380,12,4368,332,11,321,4411,3558,853,3052,2468,584,440,72,22,2518
9/1/2020,VA,Virginia,Norton City,51720,1137,608,529,795,*,*,342,*,*,1064,535,529,906,430,476,346,*,*,505
9/1/2020,VA,Virginia,Nottoway,51135,3672,2782,890,3033,24,3009,639,16,623,3419,2529,890,2728,1971,757,884,120,40,1684
9/1/2020,VA,Virginia,Orange,51137,9018,7469,1549,8024,55,7969,994,30,964,8239,6690,1549,5677,4517,1160,1019,189,53,4416
9/1/2020,VA,Virginia,Page,51139,6345,5215,1130,5309,16,5293,1036,19,1017,5923,4793,1130,4438,3467,971,1092,242,60,3044
9/1/2020,VA,Virginia,Patrick,51141,5550,3971,1579,4656,14,4642,894,11,883,5288,3710,1578,4355,2969,1386,1060,186,62,3047
9/1/2020,VA,Virginia,Petersburg City,51730,7235,4575,2660,5461,96,5365,1774,75,1699,6595,3935,2660,5055,2467,2588,2195,319,55,2486
9/1/2020,VA,Virginia,Pittsylvania,51143,16656,11106,5550,13913,99,13814,2743,69,2674,15678,10128,5550,13291,8964,4327,3068,522,157,9544
9/1/2020,VA,Virginia,Poquoson City,51735,2673,2271,402,2502,*,*,171,*,*,2454,2052,402,1324,970,354,122,24,11,1167
9/1/2020,VA,Virginia,Portsmouth City,51740,18746,12620,6126,14850,183,14667,3896,199,3697,16812,10687,6125,11627,5762,5865,4247,679,115,6586
9/1/2020,VA,Virginia,Powhatan,51145,6450,4947,1503,5870,12,5858,580,13,567,5955,4452,1503,4883,3590,1293,424,106,25,4328
9/1/2020,VA,Virginia,Prince Edward,51147,4746,3605,1141,3894,34,3860,852,30,822,4390,3249,1141,3517,2554,963,1064,163,44,2246
9/1/2020,VA,Virginia,Prince George,51149,6401,5279,1122,5467,35,5432,934,29,905,5915,4794,1121,3739,2725,1014,621,121,26,2971
9/1/2020,VA,Virginia,Prince William,51153,52520,40365,12155,47469,296,47173,5051,304,4747,44742,32592,12150,26894,15996,10898,5530,1132,214,20018
9/1/2020,VA,Virginia,Pulaski,51155,9253,7031,2222,7536,27,7509,1717,30,1687,8649,6427,2222,7208,5243,1965,1625,280,85,5218
9/1/2020,VA,Virginia,Radford City,51750,2090,1579,511,1721,*,*,369,*,*,1895,1384,511,1631,1162,469,342,45,23,1221
9/1/2020,VA,Virginia,Rappahannock,51157,2018,1770,248,1894,*,*,124,*,*,1825,1578,247,1283,1102,181,158,35,12,1078
9/1/2020,VA,Virginia,Richmond,51159,1982,1516,466,1731,*,*,251,12,239,1842,1376,466,1408,1070,338,324,65,13,1006
9/1/2020,VA,Virginia,Richmond City,51760,35054,21259,13795,28482,261,28221,6572,299,6273,31682,17889,13793,27371,14228,13143,9143,1308,263,16657
9/1/2020,VA,Virginia,Roanoke,51161,24337,17605,6732,21794,105,21689,2543,54,2489,22469,15739,6730,18493,12647,5846,2162,459,124,15748
9/1/2020,VA,Virginia,Roanoke City,51770,21468,13699,7769,16712,155,16557,4756,137,4619,19609,11843,7766,16340,9090,7250,5013,854,179,10294
9/1/2020,VA,Virginia,Rockbridge,51163,6507,5159,1348,5625,11,5614,882,*,*,6047,4699,1348,4654,3490,1164,902,169,53,3530
9/1/2020,VA,Virginia,Rockingham,51165,18478,15498,2980,16413,55,16358,2065,42,2023,17119,14139,2980,13640,11382,2258,1902,504,136,11098
9/1/2020,VA,Virginia,Russell,51167,8050,4403,3647,5757,17,5740,2293,19,2274,7739,4093,3646,6729,3670,3059,1764,325,145,4495
9/1/2020,VA,Virginia,Salem City,51775,6148,4565,1583,5269,30,5239,879,16,863,5661,4078,1583,4644,3208,1436,868,119,38,3619
9/1/2020,VA,Virginia,Scott,51169,6815,2834,3981,5255,15,5240,1560,16,1544,6548,2567,3981,5781,1978,3803,1552,247,104,3878
9/1/2020,VA,Virginia,Shenandoah,51171,10914,8878,2036,9768,34,9734,1146,23,1123,10239,8203,2036,7528,5826,1702,1310,254,80,5884
9/1/2020,VA,Virginia,Smyth,51173,8701,5695,3006,6644,31,6613,2057,26,2031,8275,5269,3006,6957,4135,2822,2111,349,129,4368
9/1/2020,VA,Virginia,Southampton,51175,4052,3206,846,3446,27,3419,606,26,580,3773,2927,846,2980,2230,750,703,115,25,2137
9/1/2020,VA,Virginia,Spotsylvania,51177,22727,18349,4378,19983,116,19867,2744,103,2641,20170,15794,4376,12652,8930,3722,2185,552,130,9785
9/1/2020,VA,Virginia,Stafford,51179,18957,15891,3066,16924,110,16814,2033,85,1948,16637,13573,3064,8779,6156,2623,1589,354,81,6755
9/1/2020,VA,Virginia,Staunton City,51790,6364,5099,1265,5398,20,5378,966,16,950,5999,4734,1265,4800,3688,1112,1112,153,50,3485
9/1/2020,VA,Virginia,Suffolk City,51800,17385,12730,4655,14489,123,14366,2896,114,2782,15950,11295,4655,11084,6785,4299,2922,482,102,7578
9/1/2020,VA,Virginia,Surry,51181,1758,1284,474,1532,11,1521,226,*,*,1632,1158,474,1228,784,444,230,59,13,926
9/1/2020,VA,Virginia,Sussex,51183,2550,1791,759,2092,27,2065,458,*,*,2380,1621,759,1859,1140,719,527,134,18,1180
9/1/2020,VA,Virginia,Tazewell,51185,12036,7371,4665,9098,31,9067,2938,36,2902,11468,6805,4663,9351,5796,3555,2366,464,127,6394
9/1/2020,VA,Virginia,Unknown,51999,*,*,*,*,*,*,*,*,*,*,*,*,*,*,*,*,*,*,*
9/1/2020,VA,Virginia,Virginia Beach City,51810,76280,59314,16966,67884,386,67498,8396,350,8046,69933,52975,16958,41615,26160,15455,7404,1487,377,32347
9/1/2020,VA,Virginia,Warren,51187,8162,6805,1357,7138,22,7116,1024,37,987,7425,6068,1357,5188,4083,1105,964,216,65,3943
9/1/2020,VA,Virginia,Washington,51191,15313,8948,6365,12604,43,12561,2709,32,2677,14463,8099,6364,12212,6314,5898,2460,551,188,9013
9/1/2020,VA,Virginia,Waynesboro City,51820,5087,4035,1052,4246,17,4229,841,26,815,4764,3712,1052,3851,2890,961,959,116,44,2732
9/1/2020,VA,Virginia,Westmoreland,51193,5236,4320,916,4652,25,4627,584,17,567,4775,3859,916,3201,2418,783,833,139,42,2187
9/1/2020,VA,Virginia,Williamsburg City,51830,2877,2313,564,2637,*,*,240,*,*,2663,2099,564,1928,1449,479,272,*,*,1615
9/1/2020,VA,Virginia,Winchester City,51840,5631,4608,1023,4878,27,4851,753,22,731,5128,4106,1022,3808,2939,869,914,139,37,2718
9/1/2020,VA,Virginia,Wise,51195,10673,5052,5621,7435,25,7410,3238,24,3214,10107,4487,5620,8364,3448,4916,2488,469,152,5255
9/1/2020,VA,Virginia,Wythe,51197,7997,5542,2455,6345,34,6311,1652,17,1635,7560,5105,2455,6301,4095,2206,1702,285,96,4218
9/1/2020,VA,Virginia,York,51199,12696,10585,2111,11731,42,11689,965,37,928,11638,9527,2111,6375,4542,1833,733,156,34,5452
4/1/2021,VA,Virginia,Accomack,51001,9360,6987,2373,8249,54,8195,1111,41,1070,8660,6290,2370,6553,4527,2026,1488,369,74,4622
4/1/2021,VA,Virginia,Albemarle,51003,22816,19176,3640,21279,61,21218,1537,46,1491,20621,16983,3638,16355,13233,3122,1647,301,81,14326
4/1/2021,VA,Virginia,Alexandria City,51510,18559,14423,4136,17312,73,17239,1247,65,1182,15054,10919,4135,9747,5987,3760,2108,321,53,7265
4/1/2021,VA,Virginia,Alleghany,51005,4620,3376,1244,3810,22,3788,810,*,*,4381,3137,1244,3636,2569,1067,803,112,37,2684
4/1/2021,VA,Virginia,Amelia,51007,3230,2125,1105,2805,12,2793,425,*,*,2988,1883,1105,2450,1416,1034,442,85,24,1899
4/1/2021,VA,Virginia,Amherst,51009,8078,5625,2453,6876,55,6821,1202,31,1171,7520,5067,2453,6267,4015,2252,1243,219,71,4734
4/1/2021,VA,Virginia,Appomattox,51011,4167,2889,1278,3448,17,3431,719,22,697,3921,2643,1278,3297,2106,1191,767,117,40,2373
4/1/2021,VA,Virginia,Arlington,51013,25394,20241,5153,23907,106,23801,1487,77,1410,20045,14893,5152,12909,8177,4732,2985,407,110,9407
4/1/2021,VA,Virginia,Augusta,51015,19167,14929,4238,16916,74,16842,2251,49,2202,17982,13744,4238,14501,10631,3870,1875,423,122,12081
4/1/2021,VA,Virginia,Bath,51017,1298,1080,218,1146,*,*,152,*,*,1230,1012,218,995,796,199,162,*,*,793
4/1/2021,VA,Virginia,Bedford,51019,20794,15321,5473,18257,83,18174,2537,45,2492,19375,13903,5472,15711,11115,4596,2037,496,140,13038
4/1/2021,VA,Virginia,Bland,51021,1827,1231,596,1485,*,*,342,*,*,1722,1126,596,1376,906,470,226,60,14,1076
4/1/2021,VA,Virginia,Botetourt,51023,9064,6313,2751,8064,55,8009,1000,21,979,8410,5659,2751,6841,4441,2400,722,172,38,5909
4/1/2021,VA,Virginia,Bristol City,51520,4499,2093,2406,3602,12,3590,897,17,880,4216,1810,2406,3663,1342,2321,1086,155,35,2387
4/1/2021,VA,Virginia,Brunswick,51025,4122,2786,1336,3510,36,3474,612,17,595,3844,2508,1336,3137,1913,1224,1038,124,36,1939
4/1/2021,VA,Virginia,Buchanan,51027,7037,3281,3756,4756,23,4733,2281,15,2266,6807,3051,3756,5916,2906,3010,1589,391,84,3852
4/1/2021,VA,Virginia,Buckingham,51029,3779,2713,1066,3156,23,3133,623,18,605,3526,2460,1066,2804,1923,881,758,143,41,1862
4/1/2021,VA,Virginia,Buena Vista City,51530,1500,1062,438,1247,*,*,253,*,*,1398,960,438,1118,727,391,302,59,11,746
4/1/2021,VA,Virginia,Campbell,51031,13398,9364,4034,11373,85,11288,2025,56,1969,12559,8525,4034,10490,6817,3673,2066,398,111,7915
4/1/2021,VA,Virginia,Caroline,51033,6270,4390,1880,5417,39,5378,853,29,824,5670,3790,1880,4071,2376,1695,859,204,32,2976
4/1/2021,VA,Virginia,Carroll,51035,8639,6440,2199,7286,36,7250,1353,18,1335,8219,6020,2199,6610,4668,1942,1552,280,93,4685
4/1/2021,VA,Virginia,Charles City,51036,2004,1326,678,1754,20,1734,250,*,*,1829,1151,678,1464,854,610,251,*,*,1122
4/1/2021,VA,Virginia,Charlotte,51037,3272,2366,906,2746,21,2725,526,16,510,3068,2162,906,2512,1675,837,701,129,34,1648
4/1/2021,VA,Virginia,Charlottesville City,51540,6433,5157,1276,5535,30,5505,898,34,864,5751,4476,1275,4782,3592,1190,1186,159,28,3409
4/1/2021,VA,Virginia,Chesapeake City,51550,40994,29096,11898,36127,307,35820,4867,198,4669,37094,25198,11896,23640,12876,10764,4291,990,170,18189
4/1/2021,VA,Virginia,Chesterfield,51041,65559,45527,20032,58612,294,58318,6947,242,6705,59345,39317,20028,47608,29337,18271,5879,1070,222,40437
4/1/2021,VA,Virginia,Clarke,51043,3561,2875,686,3314,*,*,247,*,*,3216,2530,686,2342,1783,559,296,78,27,1941
4/1/2021,VA,Virginia,Colonial Heights City,51570,4159,3108,1051,3605,17,3588,554,*,*,3828,2777,1051,2662,1703,959,523,100,18,2021
4/1/2021,VA,Virginia,Covington City,51580,1558,1135,423,1205,13,1192,353,*,*,1456,1033,423,1222,818,404,335,*,*,830
4/1/2021,VA,Virginia,Craig,51045,1391,928,463,1127,*,*,264,*,*,1297,834,463,1067,648,419,198,*,*,808
4/1/2021,VA,Virginia,Culpeper,51047,10087,7818,2269,8940,42,8898,1147,33,1114,9134,6865,2269,6665,4842,1823,1242,246,67,5110
4/1/2021,VA,Virginia,Cumberland,51049,2421,1615,806,2047,13,2034,374,*,*,2244,1439,805,1845,1113,732,449,97,21,1278
4/1/2021,VA,Virginia,Danville City,51590,11105,6500,4605,8942,97,8845,2163,114,2049,10424,5819,4605,9098,5381,3717,3224,423,116,5335
4/1/2021,VA,Virginia,Dickenson,51051,4854,2022,2832,3333,11,3322,1521,*,*,4669,1837,2832,4028,1518,2510,1099,210,53,2666
4/1/2021,VA,Virginia,Dinwiddie,51053,6163,4176,1987,5145,34,5111,1018,30,988,5707,3720,1987,4462,2584,1878,901,205,42,3314
4/1/2021,VA,Virginia,Emporia City,51595,1297,772,525,1048,13,1035,249,*,*,1219,694,525,1035,562,473,437,70,12,516
4/1/2021,VA,Virginia,Essex,51057,3051,2144,907,2639,19,2620,412,14,398,2838,1931,907,2234,1465,769,478,87,26,1643
4/1/2021,VA,Virginia,Fairfax,51059,160102,121643,38459,152393,632,151761,7709,390,7319,129574,91134,38440,81977,48852,33125,14435,2736,509,64297
4/1/2021,VA,Virginia,Fairfax City,51600,4032,3019,1013,3795,14,3781,237,12,225,3375,2363,1012,2268,1423,845,385,69,13,1801
4/1/2021,VA,Virginia,Falls Church City,51610,2161,1713,448,2093,*,*,68,*,*,1715,1267,448,1127,728,399,130,*,*,983
4/1/2021,VA,Virginia,Fauquier,51061,13388,10863,2525,12408,82,12326,980,35,945,11866,9341,2525,8208,6252,1956,986,189,55,6978
4/1/2021,VA,Virginia,Floyd,51063,4314,3077,1237,3798,14,3784,516,*,*,4027,2791,1236,3298,2137,1161,621,108,28,2541
4/1/2021,VA,Virginia,Fluvanna,51065,6536,5180,1356,5919,28,5891,617,17,600,5938,4582,1356,4540,3395,1145,604,123,25,3788
4/1/2021,VA,Virginia,Franklin,51067,15558,10053,5505,13407,65,13342,2151,36,2115,14657,9152,5505,12265,7269,4996,2054,470,121,9620
4/1/2021,VA,Virginia,Franklin City,51620,2185,1525,660,1805,23,1782,380,22,358,2057,1397,660,1709,1092,617,536,*,*,1092
4/1/2021,VA,Virginia,Frederick,51069,17890,13895,3995,16198,72,16126,1692,44,1648,16256,12263,3993,11837,8499,3338,1468,382,111,9876
4/1/2021,VA,Virginia,Fredericksburg City,51630,4292,3196,1096,3647,24,3623,645,27,618,3796,2700,1096,2728,1725,1003,810,83,24,1811
4/1/2021,VA,Virginia,Galax City,51640,1736,1330,406,1418,*,*,318,*,*,1646,1240,406,1393,1020,373,553,59,21,760
4/1/2021,VA,Virginia,Giles,51071,4629,3182,1447,3782,21,3761,847,18,829,4372,2925,1447,3687,2518,1169,768,106,32,2781
4/1/2021,VA,Virginia,Gloucester,51073,9221,6992,2229,8124,53,8071,1097,26,1071,8507,6279,2228,5744,3761,1983,1012,190,50,4492
4/1/2021,VA,Virginia,Goochland,51075,6498,4843,1655,6037,33,6004,461,11,450,5974,4319,1655,5075,3642,1433,441,104,20,4510
4/1/2021,VA,Virginia,Grayson,51077,4699,3315,1384,3963,15,3948,736,*,*,4485,3101,1384,3603,2303,1300,932,174,68,2429
4/1/2021,VA,Virginia,Greene,51079,4201,3366,835,3729,20,3709,472,12,460,3803,2968,835,2887,2131,756,461,87,15,2324
4/1/2021,VA,Virginia,Greensville,51081,2141,1293,848,1754,22,1732,387,13,374,1992,1144,848,1669,917,752,455,101,18,1095
4/1/2021,VA,Virginia,Halifax,51083,9946,7252,2694,8376,55,8321,1570,54,1516,9335,6641,2694,7710,5225,2485,2058,404,110,5138
4/1/2021,VA,Virginia,Hampton City,51650,26260,16984,9276,22107,237,21870,4153,207,3946,23909,14635,9274,15610,6905,8705,4083,773,137,10617
4/1/2021,VA,Virginia,Hanover,51085,23079,16151,6928,21266,106,21160,1813,51,1762,21085,14160,6925,17571,11608,5963,1519,326,74,15652
4/1/2021,VA,Virginia,Harrisonburg City,51660,5594,4451,1143,4797,21,4776,797,21,776,5085,3942,1143,4163,3138,1025,988,139,40,2996
4/1/2021,VA,Virginia,Henrico,51087,60198,39653,20545,53551,417,53134,6647,291,6356,54568,34023,20545,46104,27509,18595,6917,1438,285,37464
4/1/2021,VA,Virginia,Henry,51089,14876,8791,6085,12102,96,12006,2774,74,2700,14176,8092,6084,12421,6684,5737,2943,743,179,8556
4/1/2021,VA,Virginia,Highland,51091,847,704,143,776,*,*,71,0,71,792,649,143,624,499,125,62,*,*,537
4/1/2021,VA,Virginia,Hopewell City,51670,4549,2999,1550,3606,32,3574,943,28,915,4218,2668,1550,3107,1625,1482,1046,157,25,1879
4/1/2021,VA,Virginia,Isle of Wight,51093,8968,6455,2513,8006,49,7957,962,33,929,8302,5789,2513,6030,3700,2330,996,198,58,4778
4/1/2021,VA,Virginia,James City,51095,22233,17889,4344,20988,74,20914,1245,35,1210,20579,16239,4340,13780,10326,3454,990,227,46,12517
4/1/2021,VA,Virginia,King and Queen,51097,1833,1326,507,1589,*,*,244,*,*,1708,1201,507,1335,885,450,267,*,*,990
4/1/2021,VA,Virginia,King George,51099,4289,3457,832,3780,24,3756,509,18,491,3721,2889,832,2047,1297,750,477,76,19,1475
4/1/2021,VA,Virginia,King William,51101,3703,2679,1024,3224,34,3190,479,27,452,3435,2411,1024,2860,1930,930,427,103,19,2311
4/1/2021,VA,Virginia,Lancaster,51103,4433,3474,959,4131,25,4106,302,13,289,4160,3202,958,3148,2405,743,478,98,12,2560
4/1/2021,VA,Virginia,Lee,51105,6423,2643,3780,4654,16,4638,1769,17,1752,6113,2335,3778,5170,1773,3397,1922,235,57,2956
4/1/2021,VA,Virginia,Lexington City,51678,1332,1064,268,1224,*,*,108,*,*,1226,959,267,975,736,239,168,*,*,768
4/1/2021,VA,Virginia,Loudoun,51107,42755,32348,10407,40408,191,40217,2347,124,2223,35568,25168,10400,24985,16030,8955,3634,689,144,20518
4/1/2021,VA,Virginia,Louisa,51109,9086,6564,2522,7855,56,7799,1231,36,1195,8307,5785,2522,6427,4174,2253,1180,258,46,4943
4/1/2021,VA,Virginia,Lunenburg,51111,3221,2326,895,2719,21,2698,502,*,*,3002,2107,895,2375,1546,829,749,118,38,1470
4/1/2021,VA,Virginia,Lynchburg City,51680,14701,10115,4586,12286,96,12190,2415,98,2317,13667,9081,4586,11536,7287,4249,2895,450,117,8074
4/1/2021,VA,Virginia,Madison,51113,3439,2698,741,3110,12,3098,329,*,*,3189,2448,741,2444,1823,621,416,82,15,1931
4/1/2021,VA,Virginia,Manassas City,51683,4858,3470,1388,4364,26,4338,494,39,455,4104,2716,1388,2994,1775,1219,534,112,24,2324
4/1/2021,VA,Virginia,Manassas Park City,51685,1402,886,516,1229,13,1216,173,11,162,1179,663,516,883,409,474,226,*,*,593
4/1/2021,VA,Virginia,Martinsville City,51690,3808,2215,1593,2929,42,2887,879,32,847,3603,2010,1593,3166,1628,1538,1229,185,43,1709
4/1/2021,VA,Virginia,Mathews,51115,2965,2283,682,2736,11,2725,229,*,*,2788,2106,682,2086,1513,573,284,40,19,1743
4/1/2021,VA,Virginia,Mecklenburg,51117,9522,6712,2810,8100,54,8046,1422,60,1362,8946,6136,2810,7278,4754,2524,1797,384,78,5019
4/1/2021,VA,Virginia,Middlesex,51119,3751,2882,869,3421,17,3404,330,*,*,3520,2651,869,2763,2040,723,441,79,18,2225
4/1/2021,VA,Virginia,Montgomery,51121,14600,10793,3807,12466,68,12398,2134,33,2101,13123,9316,3807,11127,7643,3484,1934,344,84,8765
4/1/2021,VA,Virginia,Nelson,51125,4868,3772,1096,4419,15,4404,449,*,*,4515,3420,1095,3432,2479,953,568,116,24,2724
4/1/2021,VA,Virginia,New Kent,51127,5142,3837,1305,4673,25,4648,469,14,455,4689,3384,1305,3460,2392,1068,326,84,16,3034
4/1/2021,VA,Virginia,Newport News City,51700,29729,19037,10692,24963,230,24733,4766,231,4535,27159,16468,10691,18772,8618,10154,5236,893,163,12480
4/1/2021,VA,Virginia,Norfolk City,51710,34333,21708,12625,28409,312,28097,5924,309,5615,30829,18206,12623,21972,9952,12020,7440,1347,224,12961
4/1/2021,VA,Virginia,Northampton,51131,3841,2727,1114,3411,22,3389,430,17,413,3595,2481,1114,2951,1954,997,869,86,26,1970
4/1/2021,VA,Virginia,Northumberland,51133,4785,3728,1057,4459,*,*,326,12,314,4463,3406,1057,3170,2370,800,436,89,23,2622
4/1/2021,VA,Virginia,Norton City,51720,1117,542,575,796,*,*,321,*,*,1045,471,574,905,388,517,329,*,*,510
4/1/2021,VA,Virginia,Nottoway,51135,3630,2529,1101,3034,26,3008,596,17,579,3380,2279,1101,2723,1744,979,833,131,37,1722
4/1/2021,VA,Virginia,Orange,51137,9065,6983,2082,8123,52,8071,942,33,909,8286,6204,2082,5910,4205,1705,959,204,50,4697
4/1/2021,VA,Virginia,Page,51139,6402,4961,1441,5392,17,5375,1010,18,992,5984,4543,1441,4569,3289,1280,1084,246,52,3187
4/1/2021,VA,Virginia,Patrick,51141,5538,3696,1842,4677,14,4663,861,11,850,5267,3426,1841,4387,2714,1673,1037,199,58,3093
4/1/2021,VA,Virginia,Petersburg City,51730,7209,4210,2999,5509,96,5413,1700,76,1624,6566,3567,2999,5123,2217,2906,2141,338,50,2594
4/1/2021,VA,Virginia,Pittsylvania,51143,16745,10478,6267,14128,115,14013,2617,67,2550,15785,9518,6267,13480,8476,5004,2975,558,138,9809
4/1/2021,VA,Virginia,Poquoson City,51735,2644,2187,457,2475,*,*,169,*,*,2430,1973,457,1337,925,412,115,*,*,1184
4/1/2021,VA,Virginia,Portsmouth City,51740,18617,11733,6884,14939,202,14737,3678,200,3478,16703,9820,6883,11749,5164,6585,4091,719,97,6842
4/1/2021,VA,Virginia,Powhatan,51145,6606,4872,1734,6045,17,6028,561,13,548,6102,4368,1734,5043,3512,1531,403,117,27,4496
4/1/2021,VA,Virginia,Prince Edward,51147,4784,3326,1458,3973,37,3936,811,27,784,4420,2962,1458,3599,2282,1317,1035,166,43,2355
4/1/2021,VA,Virginia,Prince George,51149,6519,5103,1416,5589,37,5552,930,31,899,6039,4623,1416,3899,2609,1290,627,136,25,3111
4/1/2021,VA,Virginia,Prince William,51153,53283,39207,14076,48455,333,48122,4828,292,4536,45353,31280,14073,27916,15289,12627,5433,1228,199,21056
4/1/2021,VA,Virginia,Pulaski,51155,9230,6626,2604,7554,36,7518,1676,30,1646,8629,6025,2604,7213,4874,2339,1551,281,72,5309
4/1/2021,VA,Virginia,Radford City,51750,2116,1535,581,1757,*,*,359,*,*,1904,1323,581,1646,1105,541,333,45,19,1249
4/1/2021,VA,Virginia,Rappahannock,51157,2069,1724,345,1942,*,*,127,*,*,1857,1513,344,1342,1075,267,154,36,11,1141
4/1/2021,VA,Virginia,Richmond,51159,1996,1435,561,1752,*,*,244,*,*,1855,1294,561,1439,990,449,326,69,11,1033
4/1/2021,VA,Virginia,Richmond City,51760,34804,19832,14972,28557,288,28269,6247,302,5945,31413,16444,14969,27395,13126,14269,8801,1328,240,17026
4/1/2021,VA,Virginia,Roanoke,51161,24479,17017,7462,21983,120,21863,2496,55,2441,22639,15180,7459,18793,12196,6597,2088,466,117,16122
4/1/2021,VA,Virginia,Roanoke City,51770,21332,12695,8637,16851,167,16684,4481,136,4345,19504,10869,8635,16429,8337,8092,4753,912,168,10596
4/1/2021,VA,Virginia,Rockbridge,51163,6558,4934,1624,5708,*,*,850,*,*,6093,4469,1624,4737,3299,1438,850,173,47,3667
4/1/2021,VA,Virginia,Rockingham,51165,18752,15152,3600,16771,54,16717,1981,38,1943,17377,13777,3600,14189,11021,3168,1787,523,129,11750
4/1/2021,VA,Virginia,Russell,51167,8064,4048,4016,5907,17,5890,2157,20,2137,7743,3728,4015,6808,3410,3398,1709,344,109,4646
4/1/2021,VA,Virginia,Salem City,51775,6141,4376,1765,5292,30,5262,849,14,835,5641,3876,1765,4649,3031,1618,811,127,43,3668
4/1/2021,VA,Virginia,Scott,51169,6773,2560,4213,5277,13,5264,1496,14,1482,6501,2288,4213,5779,1777,4002,1506,259,86,3928
4/1/2021,VA,Virginia,Shenandoah,51171,11011,8408,2603,9892,31,9861,1119,18,1101,10316,7714,2602,7749,5536,2213,1261,256,73,6159
4/1/2021,VA,Virginia,Smyth,51173,8700,5349,3351,6705,27,6678,1995,30,1965,8262,4911,3351,7007,3806,3201,2046,361,112,4488
4/1/2021,VA,Virginia,Southampton,51175,4117,3015,1102,3530,30,3500,587,25,562,3809,2707,1102,3057,2062,995,673,136,26,2222
4/1/2021,VA,Virginia,Spotsylvania,51177,23395,17389,6006,20745,131,20614,2650,99,2551,20733,14728,6005,13364,8073,5291,2188,554,108,10514
4/1/2021,VA,Virginia,Stafford,51179,19446,15409,4037,17499,117,17382,1947,90,1857,17001,12967,4034,9349,5819,3530,1568,394,62,7325
4/1/2021,VA,Virginia,Staunton City,51790,6358,4868,1490,5413,28,5385,945,14,931,5975,4485,1490,4850,3494,1356,1088,166,45,3551
4/1/2021,VA,Virginia,Suffolk City,51800,17766,12320,5446,14986,149,14837,2780,112,2668,16286,10840,5446,11381,6326,5055,2817,510,85,7969
4/1/2021,VA,Virginia,Surry,51181,1794,1221,573,1564,13,1551,230,*,*,1657,1084,573,1258,713,545,229,55,12,962
4/1/2021,VA,Virginia,Sussex,51183,2552,1664,888,2110,30,2080,442,15,427,2383,1495,888,1896,1054,842,511,134,17,1234
4/1/2021,VA,Virginia,Tazewell,51185,11980,6790,5190,9197,42,9155,2783,36,2747,11397,6209,5188,9384,5310,4074,2290,485,110,6499
4/1/2021,VA,Virginia,Unknown,51999,*,*,*,*,*,*,*,*,*,*,*,*,*,*,*,*,*,*,*
4/1/2021,VA,Virginia,Virginia Beach City,51810,77020,57593,19427,69043,409,68634,7977,322,7655,70453,51036,19417,42804,25094,17710,7219,1547,331,33707
4/1/2021,VA,Virginia,Warren,51187,8336,6516,1820,7369,30,7339,967,31,936,7570,5750,1820,5412,3899,1513,926,233,57,4196
4/1/2021,VA,Virginia,Washington,51191,15606,8643,6963,12983,41,12942,2623,34,2589,14739,7777,6962,12524,6060,6464,2388,629,149,9358
4/1/2021,VA,Virginia,Waynesboro City,51820,5105,3843,1262,4297,24,4273,808,23,785,4793,3531,1262,3917,2731,1186,891,130,39,2857
4/1/2021,VA,Virginia,Westmoreland,51193,5310,4075,1235,4759,29,4730,551,16,535,4821,3586,1235,3300,2211,1089,818,144,37,2301
4/1/2021,VA,Virginia,Williamsburg City,51830,2933,2255,678,2697,11,2686,236,*,*,2711,2033,678,1999,1411,588,283,*,*,1669
4/1/2021,VA,Virginia,Winchester City,51840,5636,4379,1257,4902,28,4874,734,22,712,5137,3880,1257,3891,2807,1084,887,141,33,2830
4/1/2021,VA,Virginia,Wise,51195,10637,4574,6063,7557,30,7527,3080,23,3057,10055,3992,6063,8398,3149,5249,2373,484,138,5403
4/1/2021,VA,Virginia,Wythe,51197,7990,5159,2831,6411,41,6370,1579,14,1565,7556,4725,2831,6341,3751,2590,1612,313,80,4336
4/1/2021,VA,Virginia,York,51199,12891,10376,2515,11957,49,11908,934,40,894,11793,9278,2515,6580,4385,2195,730,159,35,5656
8/1/2021,VA,Virginia,Accomack,51001,9466,7014,2452,8329,51,8278,1137,41,1096,8778,6329,2449,6642,4541,2101,1549,374,70,4649
8/1/2021,VA,Virginia,Albemarle,51003,23051,19333,3718,21502,57,21445,1549,47,1502,20851,17135,3716,16529,13327,3202,1667,301,78,14483
8/1/2021,VA,Virginia,Alexandria City,51510,18799,14540,4259,17528,70,17458,1271,66,1205,15283,11025,4258,9892,6010,3882,2161,319,54,7358
8/1/2021,VA,Virginia,Alleghany,51005,4613,3332,1281,3800,18,3782,813,*,*,4380,3099,1281,3642,2533,1109,815,108,35,2684
8/1/2021,VA,Virginia,Amelia,51007,3255,2126,1129,2824,*,*,431,*,*,3012,1883,1129,2466,1411,1055,454,87,24,1901
8/1/2021,VA,Virginia,Amherst,51009,8115,5607,2508,6896,53,6843,1219,31,1188,7564,5056,2508,6307,4003,2304,1259,218,69,4761
8/1/2021,VA,Virginia,Appomattox,51011,4197,2904,1293,3467,17,3450,730,21,709,3941,2648,1293,3302,2103,1199,783,109,41,2369
8/1/2021,VA,Virginia,Arlington,51013,25732,20411,5321,24227,101,24126,1505,78,1427,20350,15030,5320,13096,8202,4894,3046,408,112,9530
8/1/2021,VA,Virginia,Augusta,51015,19312,14976,4336,17032,67,16965,2280,49,2231,18169,13833,4336,14674,10703,3971,1938,419,130,12187
8/1/2021,VA,Virginia,Bath,51017,1302,1073,229,1146,*,*,156,*,*,1230,1001,229,994,783,211,167,*,*,788
8/1/2021,VA,Virginia,Bedford,51019,20973,15378,5595,18390,74,18316,2583,46,2537,19569,13975,5594,15866,11139,4727,2065,497,145,13159
8/1/2021,VA,Virginia,Bland,51021,1840,1231,609,1494,*,*,346,*,*,1734,1125,609,1387,901,486,232,56,15,1084
8/1/2021,VA,Virginia,Botetourt,51023,9110,6338,2772,8103,50,8053,1007,21,986,8472,5700,2772,6884,4464,2420,734,171,41,5938
8/1/2021,VA,Virginia,Bristol City,51520,4487,2062,2425,3581,*,*,906,15,891,4219,1794,2425,3677,1340,2337,1095,157,35,2390
8/1/2021,VA,Virginia,Brunswick,51025,4131,2734,1397,3511,32,3479,620,18,602,3867,2470,1397,3163,1883,1280,1060,122,33,1948
8/1/2021,VA,Virginia,Buchanan,51027,7027,3231,3796,4734,21,4713,2293,13,2280,6803,3007,3796,5912,2866,3046,1605,388,83,3836
8/1/2021,VA,Virginia,Buckingham,51029,3789,2672,1117,3154,20,3134,635,16,619,3552,2435,1117,2828,1899,929,787,140,39,1862
8/1/2021,VA,Virginia,Buena Vista City,51530,1505,1059,446,1246,*,*,259,*,*,1406,960,446,1122,726,396,304,59,13,746
8/1/2021,VA,Virginia,Campbell,51031,13470,9307,4163,11428,80,11348,2042,53,1989,12619,8456,4163,10559,6763,3796,2109,395,119,7936
8/1/2021,VA,Virginia,Caroline,51033,6313,4400,1913,5449,37,5412,864,29,835,5717,3804,1913,4110,2377,1733,876,205,33,2996
8/1/2021,VA,Virginia,Carroll,51035,8648,6373,2275,7291,35,7256,1357,17,1340,8244,5969,2275,6639,4620,2019,1564,281,94,4700
8/1/2021,VA,Virginia,Charles City,51036,2012,1324,688,1759,19,1740,253,*,*,1844,1156,688,1471,852,619,254,*,*,1128
8/1/2021,VA,Virginia,Charlotte,51037,3270,2338,932,2743,20,2723,527,14,513,3068,2136,932,2520,1659,861,707,131,32,1650
8/1/2021,VA,Virginia,Charlottesville City,51540,6487,5162,1325,5579,26,5553,908,31,877,5837,4514,1323,4856,3616,1240,1209,158,29,3460
8/1/2021,VA,Virginia,Chesapeake City,51550,41481,29278,12203,36528,294,36234,4953,201,4752,37581,25381,12200,23909,12849,11060,4392,982,178,18357
8/1/2021,VA,Virginia,Chesterfield,51041,66290,45808,20482,59245,277,58968,7045,242,6803,60116,39638,20478,48243,29542,18701,6027,1053,222,40941
8/1/2021,VA,Virginia,Clarke,51043,3625,2923,702,3376,*,*,249,*,*,3278,2576,702,2379,1808,571,296,74,28,1981
8/1/2021,VA,Virginia,Colonial Heights City,51570,4141,3082,1059,3581,15,3566,560,*,*,3814,2755,1059,2658,1689,969,525,101,20,2012
8/1/2021,VA,Virginia,Covington City,51580,1558,1119,439,1201,12,1189,357,*,*,1454,1015,439,1216,797,419,341,*,*,820
8/1/2021,VA,Virginia,Craig,51045,1391,914,477,1124,*,*,267,*,*,1295,818,477,1078,644,434,197,*,*,820
8/1/2021,VA,Virginia,Culpeper,51047,10186,7840,2346,9013,40,8973,1173,31,1142,9238,6892,2346,6743,4847,1896,1278,246,67,5152
8/1/2021,VA,Virginia,Cumberland,51049,2421,1612,809,2042,11,2031,379,*,*,2250,1442,808,1852,1116,736,449,100,19,1284
8/1/2021,VA,Virginia,Danville City,51590,11126,6435,4691,8950,90,8860,2176,110,2066,10443,5752,4691,9099,5301,3798,3258,429,110,5302
8/1/2021,VA,Virginia,Dickenson,51051,4856,1994,2862,3310,11,3299,1546,*,*,4681,1819,2862,4037,1494,2543,1112,208,52,2665
8/1/2021,VA,Virginia,Dinwiddie,51053,6212,4167,2045,5184,31,5153,1028,30,998,5752,3707,2045,4505,2575,1930,922,215,43,3325
8/1/2021,VA,Virginia,Emporia City,51595,1299,756,543,1049,13,1036,250,*,*,1220,677,543,1037,543,494,445,69,11,512
8/1/2021,VA,Virginia,Essex,51057,3067,2135,932,2646,18,2628,421,15,406,2853,1921,932,2249,1460,789,485,85,29,1650
8/1/2021,VA,Virginia,Fairfax,51059,162539,122986,39553,154695,607,154088,7844,399,7445,131899,92365,39534,83386,49218,34168,14842,2715,521,65308
8/1/2021,VA,Virginia,Fairfax City,51600,4085,3050,1035,3844,14,3830,241,11,230,3413,2379,1034,2281,1416,865,399,68,14,1800
8/1/2021,VA,Virginia,Falls Church City,51610,2190,1732,458,2121,*,*,69,*,*,1751,1293,458,1143,733,410,130,*,*,1001
8/1/2021,VA,Virginia,Fauquier,51061,13558,10962,2596,12560,78,12482,998,34,964,12028,9432,2596,8294,6270,2024,1009,187,58,7040
8/1/2021,VA,Virginia,Floyd,51063,4328,3078,1250,3808,13,3795,520,*,*,4044,2795,1249,3309,2135,1174,626,108,27,2548
8/1/2021,VA,Virginia,Fluvanna,51065,6597,5223,1374,5978,25,5953,619,16,603,6010,4636,1374,4588,3424,1164,608,120,27,3833
8/1/2021,VA,Virginia,Franklin,51067,15664,10073,5591,13477,61,13416,2187,34,2153,14779,9188,5591,12382,7302,5080,2089,473,120,9700
8/1/2021,VA,Virginia,Franklin City,51620,2197,1530,667,1815,19,1796,382,21,361,2066,1399,667,1716,1093,623,548,*,*,1085
8/1/2021,VA,Virginia,Frederick,51069,18089,14001,4088,16354,71,16283,1735,44,1691,16464,12378,4086,11977,8558,3419,1510,385,111,9971
8/1/2021,VA,Virginia,Fredericksburg City,51630,4316,3190,1126,3661,20,3641,655,25,630,3833,2707,1126,2761,1732,1029,827,84,25,1825
8/1/2021,VA,Virginia,Galax City,51640,1734,1323,411,1412,*,*,322,*,*,1647,1236,411,1397,1017,380,565,59,20,753
8/1/2021,VA,Virginia,Giles,51071,4597,3125,1472,3748,19,3729,849,17,832,4346,2874,1472,3679,2475,1204,767,110,29,2773
8/1/2021,VA,Virginia,Gloucester,51073,9311,7028,2283,8202,50,8152,1109,23,1086,8601,6319,2282,5798,3764,2034,1031,190,47,4530
8/1/2021,VA,Virginia,Goochland,51075,6580,4899,1681,6106,31,6075,474,12,462,6038,4357,1681,5130,3672,1458,448,102,21,4559
8/1/2021,VA,Virginia,Grayson,51077,4694,3288,1406,3953,13,3940,741,*,*,4490,3084,1406,3605,2288,1317,934,171,69,2431
8/1/2021,VA,Virginia,Greene,51079,4220,3359,861,3739,17,3722,481,11,470,3832,2971,861,2904,2123,781,472,91,14,2327
8/1/2021,VA,Virginia,Greensville,51081,2164,1294,870,1773,21,1752,391,12,379,2016,1146,870,1684,910,774,465,106,19,1094
8/1/2021,VA,Virginia,Halifax,51083,10005,7178,2827,8413,48,8365,1592,55,1537,9403,6576,2827,7780,5164,2616,2107,395,119,5159
8/1/2021,VA,Virginia,Hampton City,51650,26475,16929,9546,22265,220,22045,4210,212,3998,24141,14597,9544,15786,6830,8956,4187,797,140,10662
8/1/2021,VA,Virginia,Hanover,51085,23334,16303,7031,21490,101,21389,1844,54,1790,21359,14331,7028,17776,11707,6069,1539,328,71,15838
8/1/2021,VA,Virginia,Harrisonburg City,51660,5623,4449,1174,4817,21,4796,806,20,786,5119,3945,1174,4186,3128,1058,997,145,41,3003
8/1/2021,VA,Virginia,Henrico,51087,60580,39715,20865,53875,395,53480,6705,290,6415,55049,34184,20865,46482,27577,18905,7059,1404,287,37732
8/1/2021,VA,Virginia,Henry,51089,14904,8706,6198,12095,88,12007,2809,74,2735,14203,8006,6197,12436,6598,5838,2997,739,177,8523
8/1/2021,VA,Virginia,Highland,51091,850,703,147,779,*,*,71,0,71,804,657,147,632,503,129,63,*,*,544
8/1/2021,VA,Virginia,Hopewell City,51670,4552,2953,1599,3608,30,3578,944,26,918,4228,2629,1599,3114,1582,1532,1052,162,28,1872
8/1/2021,VA,Virginia,Isle of Wight,51093,9039,6475,2564,8063,46,8017,976,34,942,8371,5807,2564,6081,3703,2378,1002,203,63,4813
8/1/2021,VA,Virginia,James City,51095,22362,17946,4416,21092,72,21020,1270,32,1238,20725,16313,4412,13877,10348,3529,1014,223,50,12590
8/1/2021,VA,Virginia,King and Queen,51097,1845,1323,522,1601,*,*,244,*,*,1727,1205,522,1347,881,466,277,*,*,996
8/1/2021,VA,Virginia,King George,51099,4342,3479,863,3830,23,3807,512,18,494,3768,2905,863,2071,1293,778,490,73,22,1486
8/1/2021,VA,Virginia,King William,51101,3736,2695,1041,3249,33,3216,487,26,461,3463,2422,1041,2881,1935,946,442,99,18,2322
8/1/2021,VA,Virginia,Lancaster,51103,4440,3463,977,4133,21,4112,307,13,294,4166,3190,976,3166,2402,764,486,94,11,2575
8/1/2021,VA,Virginia,Lee,51105,6416,2598,3818,4632,14,4618,1784,16,1768,6122,2307,3815,5176,1738,3438,1933,228,58,2957
8/1/2021,VA,Virginia,Lexington City,51678,1330,1061,269,1221,*,*,109,*,*,1232,964,268,984,743,241,172,*,*,773
8/1/2021,VA,Virginia,Loudoun,51107,43404,32659,10745,41009,179,40830,2395,126,2269,36185,25447,10738,25378,16094,9284,3745,687,151,20795
8/1/2021,VA,Virginia,Louisa,51109,9211,6629,2582,7964,51,7913,1247,34,1213,8445,5863,2582,6520,4213,2307,1191,261,49,5019
8/1/2021,VA,Virginia,Lunenburg,51111,3249,2294,955,2742,17,2725,507,*,*,3041,2086,955,2405,1518,887,765,118,36,1486
8/1/2021,VA,Virginia,Lynchburg City,51680,14791,10060,4731,12351,93,12258,2440,98,2342,13794,9063,4731,11645,7255,4390,2949,442,120,8134
8/1/2021,VA,Virginia,Madison,51113,3448,2693,755,3111,11,3100,337,*,*,3203,2448,755,2446,1808,638,414,85,15,1932
8/1/2021,VA,Virginia,Manassas City,51683,4927,3506,1421,4432,24,4408,495,37,458,4167,2746,1421,3045,1790,1255,544,111,25,2365
8/1/2021,VA,Virginia,Manassas Park City,51685,1416,883,533,1242,13,1229,174,11,163,1200,667,533,897,405,492,231,*,*,600
8/1/2021,VA,Virginia,Martinsville City,51690,3814,2185,1629,2925,39,2886,889,33,856,3613,1984,1629,3183,1608,1575,1239,185,41,1718
8/1/2021,VA,Virginia,Mathews,51115,2979,2282,697,2749,11,2738,230,*,*,2808,2111,697,2105,1517,588,290,38,18,1759
8/1/2021,VA,Virginia,Mecklenburg,51117,9525,6621,2904,8085,49,8036,1440,59,1381,8971,6067,2904,7292,4676,2616,1800,386,82,5024
8/1/2021,VA,Virginia,Middlesex,51119,3764,2870,894,3431,16,3415,333,*,*,3546,2652,894,2771,2025,746,447,78,17,2229
8/1/2021,VA,Virginia,Montgomery,51121,14667,10795,3872,12516,62,12454,2151,32,2119,13225,9353,3872,11202,7652,3550,1952,343,87,8820
8/1/2021,VA,Virginia,Nelson,51125,4905,3784,1121,4455,15,4440,450,*,*,4563,3443,1120,3469,2493,976,576,114,24,2755
8/1/2021,VA,Virginia,New Kent,51127,5189,3850,1339,4705,23,4682,484,16,468,4737,3398,1339,3513,2412,1101,326,85,16,3086
8/1/2021,VA,Virginia,Newport News City,51700,29945,18998,10947,25114,221,24893,4831,228,4603,27395,16449,10946,18919,8535,10384,5330,910,175,12504
8/1/2021,VA,Virginia,Norfolk City,51710,34639,21594,13045,28618,292,28326,6021,310,5711,31204,18161,13043,22193,9794,12399,7601,1354,228,13010
8/1/2021,VA,Virginia,Northampton,51131,3876,2728,1148,3443,21,3422,433,17,416,3629,2481,1148,2974,1943,1031,884,88,27,1975
8/1/2021,VA,Virginia,Northumberland,51133,4813,3735,1078,4485,*,*,328,11,317,4502,3424,1078,3198,2376,822,449,86,25,2638
8/1/2021,VA,Virginia,Norton City,51720,1119,538,581,795,*,*,324,*,*,1052,472,580,911,387,524,334,*,*,515
8/1/2021,VA,Virginia,Nottoway,51135,3631,2500,1131,3032,26,3006,599,15,584,3379,2248,1131,2730,1725,1005,836,135,36,1723
8/1/2021,VA,Virginia,Orange,51137,9146,7001,2145,8186,50,8136,960,35,925,8384,6239,2145,5955,4193,1762,988,209,46,4712
8/1/2021,VA,Virginia,Page,51139,6438,4951,1487,5408,16,5392,1030,20,1010,6019,4532,1487,4612,3284,1328,1099,240,54,3219
8/1/2021,VA,Virginia,Patrick,51141,5546,3657,1889,4685,11,4674,861,11,850,5279,3391,1888,4396,2675,1721,1039,198,60,3099
8/1/2021,VA,Virginia,Petersburg City,51730,7243,4132,3111,5513,86,5427,1730,79,1651,6610,3499,3111,5185,2172,3013,2199,337,51,2598
8/1/2021,VA,Virginia,Pittsylvania,51143,16817,10409,6408,14167,108,14059,2650,68,2582,15871,9463,6408,13562,8437,5125,3002,552,143,9865
8/1/2021,VA,Virginia,Poquoson City,51735,2654,2177,477,2483,*,*,171,*,*,2439,1962,477,1354,925,429,115,*,*,1201
8/1/2021,VA,Virginia,Portsmouth City,51740,18712,11661,7051,14987,186,14801,3725,196,3529,16878,9828,7050,11831,5096,6735,4197,716,104,6814
8/1/2021,VA,Virginia,Powhatan,51145,6633,4886,1747,6067,14,6053,566,14,552,6124,4377,1747,5065,3521,1544,407,112,24,4522
8/1/2021,VA,Virginia,Prince Edward,51147,4811,3313,1498,3991,32,3959,820,27,793,4455,2957,1498,3615,2255,1360,1052,163,41,2359
8/1/2021,VA,Virginia,Prince George,51149,6578,5101,1477,5629,34,5595,949,32,917,6104,4627,1477,3938,2596,1342,643,137,28,3130
8/1/2021,VA,Virginia,Prince William,51153,54103,39500,14603,49174,314,48860,4929,295,4634,46234,31634,14600,28427,15293,13134,5637,1227,206,21357
8/1/2021,VA,Virginia,Pulaski,51155,9254,6571,2683,7555,30,7525,1699,30,1669,8656,5973,2683,7246,4834,2412,1573,277,72,5324
8/1/2021,VA,Virginia,Radford City,51750,2111,1519,592,1750,*,*,361,*,*,1905,1313,592,1643,1091,552,335,46,17,1245
8/1/2021,VA,Virginia,Rappahannock,51157,2086,1733,353,1958,*,*,128,*,*,1886,1534,352,1361,1087,274,164,36,11,1150
8/1/2021,VA,Virginia,Richmond,51159,2014,1448,566,1770,*,*,244,*,*,1873,1307,566,1458,1003,455,331,71,11,1045
8/1/2021,VA,Virginia,Richmond City,51760,34954,19704,15250,28661,275,28386,6293,291,6002,31631,16384,15247,27529,13005,14524,8959,1314,236,17020
8/1/2021,VA,Virginia,Roanoke,51161,24562,17039,7523,22038,109,21929,2524,54,2470,22737,15217,7520,18902,12256,6646,2118,467,117,16200
8/1/2021,VA,Virginia,Roanoke City,51770,21376,12614,8762,16850,155,16695,4526,136,4390,19578,10817,8761,16466,8269,8197,4824,920,173,10549
8/1/2021,VA,Virginia,Rockbridge,51163,6609,4946,1663,5744,*,*,865,*,*,6147,4484,1663,4786,3308,1478,855,177,51,3703
8/1/2021,VA,Virginia,Rockingham,51165,18828,15142,3686,16820,50,16770,2008,41,1967,17484,13798,3686,14283,11034,3249,1811,507,125,11840
8/1/2021,VA,Virginia,Russell,51167,8055,3999,4056,5887,17,5870,2168,20,2148,7742,3687,4055,6806,3365,3441,1716,336,111,4643
8/1/2021,VA,Virginia,Salem City,51775,6161,4379,1782,5301,27,5274,860,15,845,5665,3883,1782,4659,3023,1636,813,128,41,3677
8/1/2021,VA,Virginia,Scott,51169,6766,2540,4226,5253,13,5240,1513,12,1501,6492,2266,4226,5774,1760,4014,1526,265,85,3898
8/1/2021,VA,Virginia,Shenandoah,51171,11070,8427,2643,9948,27,9921,1122,17,1105,10388,7746,2642,7791,5536,2255,1267,257,76,6191
8/1/2021,VA,Virginia,Smyth,51173,8683,5265,3418,6684,26,6658,1999,28,1971,8248,4830,3418,6992,3728,3264,2060,352,117,4463
8/1/2021,VA,Virginia,Southampton,51175,4162,3020,1142,3564,29,3535,598,24,574,3862,2720,1142,3092,2056,1036,689,134,30,2239
8/1/2021,VA,Virginia,Spotsylvania,51177,23688,17495,6193,20987,122,20865,2701,101,2600,21053,14861,6192,13561,8101,5460,2273,537,110,10641
8/1/2021,VA,Virginia,Stafford,51179,19659,15491,4168,17684,111,17573,1975,91,1884,17249,13084,4165,9454,5803,3651,1605,395,65,7389
8/1/2021,VA,Virginia,Staunton City,51790,6372,4850,1522,5421,27,5394,951,14,937,6012,4490,1522,4865,3476,1389,1093,160,45,3567
8/1/2021,VA,Virginia,Suffolk City,51800,17924,12340,5584,15113,139,14974,2811,112,2699,16431,10847,5584,11478,6290,5188,2852,512,86,8028
8/1/2021,VA,Virginia,Surry,51181,1806,1218,588,1573,13,1560,233,*,*,1669,1081,588,1267,708,559,233,51,11,972
8/1/2021,VA,Virginia,Sussex,51183,2558,1644,914,2117,27,2090,441,13,428,2386,1472,914,1907,1039,868,518,138,18,1233
8/1/2021,VA,Virginia,Tazewell,51185,11982,6722,5260,9188,35,9153,2794,37,2757,11420,6162,5258,9398,5249,4149,2311,483,113,6491
8/1/2021,VA,Virginia,Unknown,51999,*,*,*,*,*,*,*,*,*,*,*,*,*,*,*,*,*,*,*
8/1/2021,VA,Virginia,Virginia Beach City,51810,77829,57937,19892,69710,386,69324,8119,323,7796,71343,51461,19882,43234,25088,18146,7373,1568,342,33951
8/1/2021,VA,Virginia,Warren,51187,8414,6515,1899,7434,30,7404,980,28,952,7650,5751,1899,5486,3905,1581,948,236,61,4241
8/1/2021,VA,Virginia,Washington,51191,15667,8642,7025,12996,37,12959,2671,32,2639,14815,7791,7024,12554,6033,6521,2403,631,150,9370
8/1/2021,VA,Virginia,Waynesboro City,51820,5112,3817,1295,4296,22,4274,816,23,793,4806,3511,1295,3931,2711,1220,896,124,41,2870
8/1/2021,VA,Virginia,Westmoreland,51193,5365,4089,1276,4805,26,4779,560,16,544,4879,3603,1276,3328,2199,1129,833,143,38,2314
8/1/2021,VA,Virginia,Williamsburg City,51830,2945,2263,682,2706,11,2695,239,*,*,2730,2048,682,2002,1411,591,296,*,*,1660
8/1/2021,VA,Virginia,Winchester City,51840,5663,4368,1295,4924,25,4899,739,21,718,5173,3878,1295,3925,2808,1117,907,145,34,2839
8/1/2021,VA,Virginia,Wise,51195,10595,4471,6124,7512,29,7483,3083,23,3060,10039,3915,6124,8380,3064,5316,2381,482,139,5378
8/1/2021,VA,Virginia,Wythe,51197,8034,5136,2898,6425,37,6388,1609,14,1595,7615,4717,2898,6392,3739,2653,1634,312,79,4367
8/1/2021,VA,Virginia,York,51199,12995,10442,2553,12054,45,12009,941,38,903,11881,9328,2553,6623,4387,2236,740,162,32,5689
12/1/2021,VA,Virginia,Accomack,51001,9485,7003,2482,8339,48,8291,1146,40,1106,8805,6326,2479,6659,4524,2135,1563,369,73,4654
12/1/2021,VA,Virginia,Albemarle,51003,23214,19444,3770,21647,57,21590,1567,48,1519,21011,17243,3768,16664,13406,3258,1693,292,81,14598
12/1/2021,VA,Virginia,Alexandria City,51510,19008,14648,4360,17721,68,17653,1287,66,1221,15417,11059,4358,10005,6029,3976,2214,320,53,7418
12/1/2021,VA,Virginia,Alleghany,51005,4598,3326,1272,3783,15,3768,815,*,*,4353,3081,1272,3616,2513,1103,798,108,37,2673
12/1/2021,VA,Virginia,Amelia,51007,3269,2129,1140,2834,*,*,435,*,*,3014,1874,1140,2470,1403,1067,458,87,22,1903
12/1/2021,VA,Virginia,Amherst,51009,8116,5585,2531,6881,47,6834,1235,31,1204,7568,5037,2531,6324,3992,2332,1274,219,68,4763
12/1/2021,VA,Virginia,Appomattox,51011,4205,2909,1296,3470,17,3453,735,21,714,3942,2646,1296,3305,2102,1203,782,110,42,2371
12/1/2021,VA,Virginia,Arlington,51013,25967,20534,5433,24441,94,24347,1526,76,1450,20516,15084,5432,13207,8213,4994,3060,414,106,9627
12/1/2021,VA,Virginia,Augusta,51015,19344,14964,4380,17039,62,16977,2305,47,2258,18199,13819,4380,14725,10715,4010,1979,404,131,12211
12/1/2021,VA,Virginia,Bath,51017,1308,1074,234,1152,*,*,156,*,*,1239,1005,234,999,785,214,168,*,*,790
12/1/2021,VA,Virginia,Bedford,51019,21094,15416,5678,18475,67,18408,2619,47,2572,19678,14001,5677,15948,11127,4821,2083,492,153,13220
12/1/2021,VA,Virginia,Bland,51021,1838,1230,608,1493,*,*,345,*,*,1731,1123,608,1389,906,483,225,58,14,1092
12/1/2021,VA,Virginia,Botetourt,51023,9120,6318,2802,8099,40,8059,1021,17,1004,8501,5699,2802,6912,4461,2451,744,163,46,5959
12/1/2021,VA,Virginia,Bristol City,51520,4462,2045,2417,3545,*,*,917,15,902,4193,1776,2417,3647,1321,2326,1098,151,36,2362
12/1/2021,VA,Virginia,Brunswick,51025,4135,2707,1428,3509,28,3481,626,13,613,3874,2446,1428,3180,1867,1313,1068,121,31,1960
12/1/2021,VA,Virginia,Buchanan,51027,6954,3196,3758,4656,17,4639,2298,13,2285,6725,2967,3758,5844,2828,3016,1607,380,84,3773
12/1/2021,VA,Virginia,Buckingham,51029,3814,2680,1134,3168,20,3148,646,16,630,3571,2437,1134,2837,1889,948,796,140,37,1864
12/1/2021,VA,Virginia,Buena Vista City,51530,1499,1059,440,1241,*,*,258,*,*,1397,957,440,1111,720,391,302,57,16,736
12/1/2021,VA,Virginia,Campbell,51031,13489,9263,4226,11423,74,11349,2066,52,2014,12627,8401,4226,10579,6723,3856,2117,395,123,7944
12/1/2021,VA,Virginia,Caroline,51033,6336,4397,1939,5457,34,5423,879,31,848,5745,3806,1939,4116,2357,1759,875,204,36,3001
12/1/2021,VA,Virginia,Carroll,51035,8624,6321,2303,7251,29,7222,1373,15,1358,8218,5915,2303,6627,4575,2052,1563,285,97,4682
12/1/2021,VA,Virginia,Charles City,51036,2019,1325,694,1764,19,1745,255,*,*,1856,1162,694,1482,858,624,257,*,*,1135
12/1/2021,VA,Virginia,Charlotte,51037,3270,2328,942,2741,18,2723,529,13,516,3073,2131,942,2511,1643,868,711,133,33,1634
12/1/2021,VA,Virginia,Charlottesville City,51540,6507,5189,1318,5588,24,5564,919,31,888,5827,4511,1316,4869,3635,1234,1220,161,27,3461
12/1/2021,VA,Virginia,Chesapeake City,51550,41845,29516,12329,36808,275,36533,5037,199,4838,37893,25567,12326,24083,12885,11198,4484,964,184,18451
12/1/2021,VA,Virginia,Chesterfield,51041,66938,46122,20816,59802,251,59551,7136,243,6893,60596,39785,20811,48647,29616,19031,6178,1033,220,41216
12/1/2021,VA,Virginia,Clarke,51043,3652,2934,718,3396,*,*,256,*,*,3299,2581,718,2391,1804,587,298,71,30,1992
12/1/2021,VA,Virginia,Colonial Heights City,51570,4129,3057,1072,3563,15,3548,566,*,*,3807,2735,1072,2656,1672,984,526,101,19,2010
12/1/2021,VA,Virginia,Covington City,51580,1558,1119,439,1199,12,1187,359,*,*,1453,1014,439,1213,795,418,341,*,*,816
12/1/2021,VA,Virginia,Craig,51045,1395,913,482,1127,*,*,268,*,*,1299,817,482,1078,640,438,201,*,*,816
12/1/2021,VA,Virginia,Culpeper,51047,10228,7854,2374,9042,37,9005,1186,31,1155,9280,6906,2374,6795,4867,1928,1276,243,70,5206
12/1/2021,VA,Virginia,Cumberland,51049,2414,1608,806,2031,11,2020,383,*,*,2241,1436,805,1847,1112,735,456,100,22,1269
12/1/2021,VA,Virginia,Danville City,51590,11085,6348,4737,8879,82,8797,2206,106,2100,10418,5681,4737,9068,5227,3841,3279,420,112,5257
12/1/2021,VA,Virginia,Dickenson,51051,4834,1968,2866,3273,*,*,1561,*,*,4656,1790,2866,4028,1474,2554,1117,210,49,2652
12/1/2021,VA,Virginia,Dinwiddie,51053,6230,4166,2064,5185,31,5154,1045,29,1016,5764,3700,2064,4505,2562,1943,950,209,44,3302
12/1/2021,VA,Virginia,Emporia City,51595,1298,748,550,1044,13,1031,254,*,*,1217,667,550,1038,536,502,451,62,11,514
12/1/2021,VA,Virginia,Essex,51057,3077,2127,950,2649,15,2634,428,14,414,2864,1914,950,2257,1452,805,490,84,31,1652
12/1/2021,VA,Virginia,Fairfax,51059,164589,124127,40462,156582,577,156005,8007,392,7615,133504,93061,40443,84624,49698,34926,15159,2694,527,66244
12/1/2021,VA,Virginia,Fairfax City,51600,4118,3073,1045,3869,13,3856,249,12,237,3436,2392,1044,2305,1431,874,403,70,13,1819
12/1/2021,VA,Virginia,Falls Church City,51610,2211,1744,467,2141,*,*,70,*,*,1761,1294,467,1148,731,417,128,*,*,1008
12/1/2021,VA,Virginia,Fauquier,51061,13675,11034,2641,12660,70,12590,1015,33,982,12119,9478,2641,8346,6280,2066,1027,188,55,7076
12/1/2021,VA,Virginia,Floyd,51063,4350,3070,1280,3824,*,*,526,*,*,4074,2795,1279,3336,2136,1200,633,106,28,2569
12/1/2021,VA,Virginia,Fluvanna,51065,6644,5248,1396,6020,25,5995,624,15,609,6061,4665,1396,4644,3455,1189,623,112,28,3881
12/1/2021,VA,Virginia,Franklin,51067,15732,10107,5625,13514,53,13461,2218,36,2182,14832,9207,5625,12416,7305,5111,2102,474,123,9717
12/1/2021,VA,Virginia,Franklin City,51620,2202,1528,674,1813,18,1795,389,21,368,2072,1398,674,1723,1091,632,549,70,11,1093
12/1/2021,VA,Virginia,Frederick,51069,18147,14040,4107,16371,64,16307,1776,41,1735,16518,12413,4105,12021,8582,3439,1544,381,113,9983
12/1/2021,VA,Virginia,Fredericksburg City,51630,4332,3180,1152,3676,19,3657,656,25,631,3852,2701,1151,2778,1723,1055,835,85,27,1831
12/1/2021,VA,Virginia,Galax City,51640,1710,1296,414,1385,*,*,325,*,*,1626,1212,414,1374,993,381,552,54,19,749
12/1/2021,VA,Virginia,Giles,51071,4586,3104,1482,3732,19,3713,854,15,839,4327,2845,1482,3668,2455,1213,774,104,29,2761
12/1/2021,VA,Virginia,Gloucester,51073,9397,7062,2335,8270,41,8229,1127,22,1105,8692,6357,2335,5824,3737,2087,1053,184,48,4539
12/1/2021,VA,Virginia,Goochland,51075,6630,4951,1679,6154,30,6124,476,12,464,6070,4391,1679,5163,3702,1461,453,98,21,4591
12/1/2021,VA,Virginia,Grayson,51077,4677,3264,1413,3931,*,*,746,*,*,4482,3069,1413,3615,2288,1327,935,168,71,2441
12/1/2021,VA,Virginia,Greene,51079,4249,3373,876,3760,17,3743,489,11,478,3859,2983,876,2930,2132,798,484,92,15,2339
12/1/2021,VA,Virginia,Greensville,51081,2184,1301,883,1788,21,1767,396,12,384,2025,1142,883,1683,895,788,468,104,18,1093
12/1/2021,VA,Virginia,Halifax,51083,10005,7118,2887,8385,41,8344,1620,53,1567,9402,6515,2887,7800,5124,2676,2119,397,126,5158
12/1/2021,VA,Virginia,Hampton City,51650,26615,16941,9674,22339,206,22133,4276,208,4068,24271,14598,9673,15887,6828,9059,4254,788,144,10701
12/1/2021,VA,Virginia,Hanover,51085,23487,16391,7096,21633,91,21542,1854,50,1804,21520,14427,7093,17916,11784,6132,1579,321,69,15947
12/1/2021,VA,Virginia,Harrisonburg City,51660,5657,4457,1200,4843,20,4823,814,20,794,5145,3945,1200,4210,3124,1086,1005,139,45,3021
12/1/2021,VA,Virginia,Henrico,51087,60915,39792,21123,54104,363,53741,6811,296,6515,55326,34203,21123,46736,27552,19184,7157,1393,294,37892
12/1/2021,VA,Virginia,Henry,51089,14854,8648,6206,12017,79,11938,2837,70,2767,14145,7940,6205,12388,6539,5849,3021,729,182,8456
12/1/2021,VA,Virginia,Highland,51091,866,719,147,796,*,*,70,0,70,820,673,147,642,514,128,66,*,*,552
12/1/2021,VA,Virginia,Hopewell City,51670,4552,2939,1613,3607,27,3580,945,26,919,4225,2612,1613,3115,1574,1541,1054,162,27,1872
12/1/2021,VA,Virginia,Isle of Wight,51093,9090,6501,2589,8104,43,8061,986,34,952,8392,5803,2589,6110,3715,2395,1014,202,62,4832
12/1/2021,VA,Virginia,James City,51095,22432,17962,4470,21144,64,21080,1288,30,1258,20790,16324,4466,13935,10358,3577,1019,224,54,12638
12/1/2021,VA,Virginia,King and Queen,51097,1857,1314,543,1607,*,*,250,*,*,1737,1194,543,1362,874,488,286,*,*,1001
12/1/2021,VA,Virginia,King George,51099,4381,3492,889,3861,23,3838,520,15,505,3799,2910,889,2096,1290,806,494,73,23,1506
12/1/2021,VA,Virginia,King William,51101,3746,2696,1050,3250,32,3218,496,25,471,3474,2424,1050,2892,1935,957,441,100,18,2333
12/1/2021,VA,Virginia,Lancaster,51103,4444,3470,974,4137,19,4118,307,12,295,4162,3189,973,3161,2388,773,491,97,11,2562
12/1/2021,VA,Virginia,Lee,51105,6402,2564,3838,4606,14,4592,1796,15,1781,6101,2266,3835,5160,1707,3453,1929,234,56,2941
12/1/2021,VA,Virginia,Lexington City,51678,1333,1056,277,1222,*,*,111,*,*,1236,960,276,984,738,246,170,*,*,776
12/1/2021,VA,Virginia,Loudoun,51107,44016,33098,10918,41548,163,41385,2468,129,2339,36625,25714,10911,25729,16269,9460,3864,689,149,21027
12/1/2021,VA,Virginia,Louisa,51109,9277,6667,2610,8017,46,7971,1260,30,1230,8486,5876,2610,6552,4220,2332,1198,252,49,5053
12/1/2021,VA,Virginia,Lunenburg,51111,3250,2263,987,2740,16,2724,510,*,*,3046,2059,987,2421,1505,916,780,116,34,1491
12/1/2021,VA,Virginia,Lynchburg City,51680,14781,9976,4805,12322,84,12238,2459,95,2364,13787,8982,4805,11641,7176,4465,2956,445,116,8124
12/1/2021,VA,Virginia,Madison,51113,3470,2703,767,3132,*,*,338,*,*,3227,2460,767,2459,1808,651,421,83,18,1937
12/1/2021,VA,Virginia,Manassas City,51683,4998,3531,1467,4499,21,4478,499,36,463,4225,2758,1467,3089,1791,1298,558,108,25,2398
12/1/2021,VA,Virginia,Manassas Park City,51685,1428,884,544,1250,*,*,178,12,166,1208,664,544,901,400,501,235,*,*,600
12/1/2021,VA,Virginia,Martinsville City,51690,3819,2160,1659,2917,32,2885,902,36,866,3615,1956,1659,3188,1585,1603,1260,175,44,1709
12/1/2021,VA,Virginia,Mathews,51115,2976,2275,701,2748,*,*,228,*,*,2807,2106,701,2113,1520,593,291,37,15,1770
12/1/2021,VA,Virginia,Mecklenburg,51117,9541,6606,2935,8087,48,8039,1454,57,1397,8970,6035,2935,7293,4643,2650,1811,384,80,5018
12/1/2021,VA,Virginia,Middlesex,51119,3757,2862,895,3425,16,3409,332,*,*,3533,2638,895,2753,2003,750,452,80,17,2204
12/1/2021,VA,Virginia,Montgomery,51121,14728,10833,3895,12557,56,12501,2171,30,2141,13262,9367,3895,11222,7660,3562,1970,330,88,8834
12/1/2021,VA,Virginia,Nelson,51125,4939,3794,1145,4481,14,4467,458,*,*,4611,3467,1144,3485,2485,1000,581,113,21,2770
12/1/2021,VA,Virginia,New Kent,51127,5257,3892,1365,4763,21,4742,494,15,479,4802,3437,1365,3549,2419,1130,342,86,16,3105
12/1/2021,VA,Virginia,Newport News City,51700,30086,18979,11107,25199,203,24996,4887,221,4666,27519,16413,11106,19007,8486,10521,5415,906,177,12509
12/1/2021,VA,Virginia,Norfolk City,51710,34828,21645,13183,28746,276,28470,6082,299,5783,31360,18178,13182,22324,9789,12535,7734,1335,230,13025
12/1/2021,VA,Virginia,Northampton,51131,3899,2727,1172,3460,20,3440,439,19,420,3655,2483,1172,2984,1929,1055,896,85,26,1977
12/1/2021,VA,Virginia,Northumberland,51133,4811,3724,1087,4478,*,*,333,12,321,4506,3419,1087,3219,2382,837,456,87,25,2651
12/1/2021,VA,Virginia,Norton City,51720,1105,521,584,784,*,*,321,*,*,1040,456,584,902,375,527,336,*,*,505
12/1/2021,VA,Virginia,Nottoway,51135,3627,2482,1145,3024,23,3001,603,15,588,3375,2230,1145,2730,1708,1022,837,140,36,1717
12/1/2021,VA,Virginia,Orange,51137,9174,6997,2177,8191,49,8142,983,36,947,8387,6210,2177,5962,4164,1798,994,207,48,4713
12/1/2021,VA,Virginia,Page,51139,6438,4920,1518,5391,15,5376,1047,20,1027,6023,4505,1518,4629,3272,1357,1104,244,55,3226
12/1/2021,VA,Virginia,Patrick,51141,5538,3635,1903,4663,*,*,875,11,864,5277,3375,1902,4385,2651,1734,1031,193,56,3105
12/1/2021,VA,Virginia,Petersburg City,51730,7247,4080,3167,5494,82,5412,1753,77,1676,6615,3448,3167,5207,2150,3057,2240,329,53,2585
12/1/2021,VA,Virginia,Pittsylvania,51143,16868,10425,6443,14194,96,14098,2674,68,2606,15901,9458,6443,13585,8432,5153,3075,542,139,9829
12/1/2021,VA,Virginia,Poquoson City,51735,2693,2208,485,2512,*,*,181,*,*,2471,1986,485,1381,944,437,120,*,*,1226
12/1/2021,VA,Virginia,Portsmouth City,51740,18787,11610,7177,15021,165,14856,3766,188,3578,16948,9772,7176,11906,5050,6856,4266,707,111,6822
12/1/2021,VA,Virginia,Powhatan,51145,6703,4936,1767,6129,13,6116,574,14,560,6180,4413,1767,5091,3527,1564,413,111,25,4542
12/1/2021,VA,Virginia,Prince Edward,51147,4816,3312,1504,3980,30,3950,836,27,809,4443,2940,1503,3616,2243,1373,1065,167,42,2342
12/1/2021,VA,Virginia,Prince George,51149,6643,5127,1516,5687,32,5655,956,33,923,6145,4629,1516,3950,2577,1373,661,135,30,3124
12/1/2021,VA,Virginia,Prince William,51153,54829,39923,14906,49787,284,49503,5042,289,4753,46801,31898,14903,28834,15413,13421,5822,1223,216,21573
12/1/2021,VA,Virginia,Pulaski,51155,9254,6545,2709,7544,28,7516,1710,29,1681,8642,5933,2709,7246,4807,2439,1578,276,78,5314
12/1/2021,VA,Virginia,Radford City,51750,2104,1514,590,1744,*,*,360,*,*,1892,1302,590,1633,1082,551,338,40,18,1237
12/1/2021,VA,Virginia,Rappahannock,51157,2098,1738,360,1968,*,*,130,*,*,1891,1532,359,1369,1084,285,163,*,*,1160
12/1/2021,VA,Virginia,Richmond,51159,2011,1437,574,1769,*,*,242,*,*,1875,1301,574,1457,993,464,331,70,12,1044
12/1/2021,VA,Virginia,Richmond City,51760,35012,19652,15360,28683,259,28424,6329,283,6046,31711,16354,15357,27595,12956,14639,9062,1288,243,17002
12/1/2021,VA,Virginia,Roanoke,51161,24663,17097,7566,22096,97,21999,2567,53,2514,22809,15246,7563,18974,12288,6686,2131,472,119,16252
12/1/2021,VA,Virginia,Roanoke City,51770,21361,12506,8855,16810,141,16669,4551,136,4415,19582,10728,8854,16499,8206,8293,4887,915,180,10517
12/1/2021,VA,Virginia,Rockbridge,51163,6619,4936,1683,5750,*,*,869,*,*,6160,4477,1683,4799,3298,1501,868,169,53,3709
12/1/2021,VA,Virginia,Rockingham,51165,18877,15174,3703,16842,46,16796,2035,39,1996,17533,13831,3702,14330,11064,3266,1827,498,125,11880
12/1/2021,VA,Virginia,Russell,51167,8014,3960,4054,5841,14,5827,2173,19,2154,7704,3651,4053,6775,3330,3445,1703,330,106,4636
12/1/2021,VA,Virginia,Salem City,51775,6143,4365,1778,5274,26,5248,869,14,855,5631,3853,1778,4621,2989,1632,803,124,40,3654
12/1/2021,VA,Virginia,Scott,51169,6748,2539,4209,5223,11,5212,1525,11,1514,6477,2268,4209,5754,1758,3996,1525,260,85,3884
12/1/2021,VA,Virginia,Shenandoah,51171,11097,8468,2629,9962,24,9938,1135,17,1118,10390,7762,2628,7785,5532,2253,1285,266,71,6163
12/1/2021,VA,Virginia,Smyth,51173,8625,5197,3428,6609,18,6591,2016,26,1990,8184,4756,3428,6955,3679,3276,2055,349,118,4433
12/1/2021,VA,Virginia,Southampton,51175,4201,3043,1158,3591,27,3564,610,22,588,3892,2735,1157,3122,2070,1052,699,137,31,2255
12/1/2021,VA,Virginia,Spotsylvania,51177,23882,17567,6315,21144,109,21035,2738,99,2639,21233,14919,6314,13684,8105,5579,2326,528,113,10717
12/1/2021,VA,Virginia,Stafford,51179,19952,15700,4252,17935,103,17832,2017,92,1925,17484,13235,4249,9579,5845,3734,1657,396,65,7461
12/1/2021,VA,Virginia,Staunton City,51790,6367,4831,1536,5401,24,5377,966,14,952,5999,4463,1536,4849,3443,1406,1111,148,46,3544
12/1/2021,VA,Virginia,Suffolk City,51800,17986,12343,5643,15148,131,15017,2838,109,2729,16486,10843,5643,11461,6216,5245,2854,520,87,8000
12/1/2021,VA,Virginia,Surry,51181,1809,1218,591,1578,11,1567,231,*,*,1668,1077,591,1266,704,562,237,48,11,970
12/1/2021,VA,Virginia,Sussex,51183,2560,1632,928,2114,23,2091,446,14,432,2386,1458,928,1916,1034,882,526,140,19,1231
12/1/2021,VA,Virginia,Tazewell,51185,11965,6703,5262,9147,33,9114,2818,33,2785,11403,6143,5260,9390,5224,4166,2337,476,120,6457
12/1/2021,VA,Virginia,Unknown,51999,*,*,*,*,*,*,*,*,*,*,*,*,*,*,*,*,*,*,*
12/1/2021,VA,Virginia,Virginia Beach City,51810,78345,58236,20109,70138,343,69795,8207,316,7891,71776,51677,20099,43508,25147,18361,7480,1539,343,34146
12/1/2021,VA,Virginia,Warren,51187,8447,6515,1932,7462,27,7435,985,27,958,7683,5751,1932,5507,3896,1611,957,229,66,4255
12/1/2021,VA,Virginia,Washington,51191,15662,8606,7056,12957,34,12923,2705,30,2675,14826,7771,7055,12581,6028,6553,2433,628,159,9361
12/1/2021,VA,Virginia,Waynesboro City,51820,5142,3831,1311,4317,19,4298,825,25,800,4825,3514,1311,3957,2718,1239,920,124,43,2870
12/1/2021,VA,Virginia,Westmoreland,51193,5370,4052,1318,4803,24,4779,567,15,552,4886,3568,1318,3341,2173,1168,836,133,39,2333
12/1/2021,VA,Virginia,Williamsburg City,51830,2948,2260,688,2705,*,*,243,*,*,2731,2043,688,2006,1407,599,298,*,*,1662
12/1/2021,VA,Virginia,Winchester City,51840,5664,4354,1310,4919,23,4896,745,20,725,5177,3867,1310,3921,2785,1136,916,144,33,2828
12/1/2021,VA,Virginia,Wise,51195,10574,4426,6148,7461,22,7439,3113,24,3089,10027,3879,6148,8366,3018,5348,2400,468,135,5363
12/1/2021,VA,Virginia,Wythe,51197,8013,5094,2919,6385,34,6351,1628,13,1615,7599,4680,2919,6388,3709,2679,1638,302,75,4373
12/1/2021,VA,Virginia,York,51199,13134,10565,2569,12171,41,12130,963,37,926,12001,9432,2569,6653,4401,2252,762,166,36,5689
2/1/2021,VA,Virginia,Accomack,51001,9341,7010,2331,8236,57,8179,1105,41,1064,8651,6323,2328,6562,4581,1981,1475,375,87,4625
2/1/2021,VA,Virginia,Albemarle,51003,22719,19122,3597,21199,63,21136,1520,44,1476,20542,16947,3595,16302,13219,3083,1632,304,91,14275
2/1/2021,VA,Virginia,Alexandria City,51510,18461,14362,4099,17218,76,17142,1243,65,1178,14988,10890,4098,9707,5993,3714,2089,321,61,7236
2/1/2021,VA,Virginia,Alleghany,51005,4626,3401,1225,3819,22,3797,807,*,*,4383,3158,1225,3633,2587,1046,800,107,43,2683
2/1/2021,VA,Virginia,Amelia,51007,3217,2127,1090,2796,11,2785,421,11,410,2985,1895,1090,2451,1431,1020,440,85,29,1897
2/1/2021,VA,Virginia,Amherst,51009,8053,5639,2414,6864,56,6808,1189,31,1158,7500,5086,2414,6273,4061,2212,1241,216,70,4746
2/1/2021,VA,Virginia,Appomattox,51011,4160,2919,1241,3445,17,3428,715,22,693,3918,2677,1241,3288,2135,1153,757,119,43,2369
2/1/2021,VA,Virginia,Arlington,51013,25293,20222,5071,23812,109,23703,1481,77,1404,19985,14915,5070,12869,8221,4648,2971,412,113,9373
2/1/2021,VA,Virginia,Augusta,51015,19142,14959,4183,16909,76,16833,2233,51,2182,17978,13795,4183,14504,10688,3816,1871,427,133,12073
2/1/2021,VA,Virginia,Bath,51017,1294,1077,217,1142,*,*,152,*,*,1231,1014,217,998,801,197,161,*,*,794
2/1/2021,VA,Virginia,Bedford,51019,20742,15351,5391,18214,90,18124,2528,46,2482,19340,13950,5390,15675,11170,4505,2035,499,151,12990
2/1/2021,VA,Virginia,Bland,51021,1819,1231,588,1481,*,*,338,*,*,1721,1133,588,1376,917,459,223,60,15,1078
2/1/2021,VA,Virginia,Botetourt,51023,9027,6300,2727,8039,56,7983,988,20,968,8399,5672,2727,6841,4463,2378,714,170,41,5916
2/1/2021,VA,Virginia,Bristol City,51520,4508,2112,2396,3614,12,3602,894,17,877,4225,1829,2396,3671,1359,2312,1087,150,39,2395
2/1/2021,VA,Virginia,Brunswick,51025,4130,2813,1317,3518,38,3480,612,17,595,3858,2541,1317,3154,1953,1201,1048,123,36,1947
2/1/2021,VA,Virginia,Buchanan,51027,7044,3321,3723,4781,23,4758,2263,15,2248,6814,3091,3723,5915,2949,2966,1580,394,106,3835
2/1/2021,VA,Virginia,Buckingham,51029,3774,2725,1049,3154,24,3130,620,18,602,3525,2476,1049,2809,1946,863,759,144,40,1866
2/1/2021,VA,Virginia,Buena Vista City,51530,1501,1065,436,1250,*,*,251,*,*,1395,959,436,1123,733,390,303,59,12,749
2/1/2021,VA,Virginia,Campbell,51031,13388,9402,3986,11379,90,11289,2009,53,1956,12559,8573,3986,10516,6891,3625,2060,403,120,7933
2/1/2021,VA,Virginia,Caroline,51033,6239,4398,1841,5397,41,5356,842,28,814,5646,3805,1841,4065,2409,1656,855,208,36,2966
2/1/2021,VA,Virginia,Carroll,51035,8618,6467,2151,7277,36,7241,1341,18,1323,8195,6044,2151,6607,4714,1893,1552,279,103,4673
2/1/2021,VA,Virginia,Charles City,51036,2005,1329,676,1752,22,1730,253,*,*,1835,1159,676,1473,865,608,252,84,14,1123
2/1/2021,VA,Virginia,Charlotte,51037,3287,2401,886,2761,23,2738,526,17,509,3080,2194,886,2531,1716,815,694,129,36,1672
2/1/2021,VA,Virginia,Charlottesville City,51540,6396,5158,1238,5508,31,5477,888,33,855,5727,4490,1237,4769,3616,1153,1181,162,31,3395
2/1/2021,VA,Virginia,Chesapeake City,51550,40913,29106,11807,36071,314,35757,4842,202,4640,37048,25243,11805,23677,13001,10676,4273,1000,206,18198
2/1/2021,VA,Virginia,Chesterfield,51041,65365,45495,19870,58446,303,58143,6919,244,6675,59208,39342,19866,47554,29447,18107,5839,1087,247,40381
2/1/2021,VA,Virginia,Clarke,51043,3548,2871,677,3305,*,*,243,*,*,3209,2532,677,2326,1776,550,290,78,28,1930
2/1/2021,VA,Virginia,Colonial Heights City,51570,4175,3130,1045,3620,17,3603,555,*,*,3851,2806,1045,2677,1727,950,526,102,17,2032
2/1/2021,VA,Virginia,Covington City,51580,1564,1144,420,1213,15,1198,351,*,*,1463,1043,420,1220,821,399,331,49,12,828
2/1/2021,VA,Virginia,Craig,51045,1379,926,453,1114,*,*,265,*,*,1287,834,453,1062,653,409,195,*,*,804
2/1/2021,VA,Virginia,Culpeper,51047,10058,7847,2211,8920,43,8877,1138,32,1106,9108,6897,2211,6652,4884,1768,1235,250,68,5099
2/1/2021,VA,Virginia,Cumberland,51049,2411,1622,789,2039,13,2026,372,*,*,2235,1447,788,1848,1132,716,443,95,25,1285
2/1/2021,VA,Virginia,Danville City,51590,11138,6606,4532,8985,103,8882,2153,115,2038,10460,5928,4532,9154,5508,3646,3226,418,135,5375
2/1/2021,VA,Virginia,Dickenson,51051,4858,2039,2819,3339,*,*,1519,*,*,4674,1855,2819,4027,1532,2495,1090,211,62,2664
2/1/2021,VA,Virginia,Dinwiddie,51053,6167,4202,1965,5147,33,5114,1020,32,988,5715,3750,1965,4479,2621,1858,914,204,46,3315
2/1/2021,VA,Virginia,Emporia City,51595,1300,786,514,1049,13,1036,251,*,*,1221,707,514,1035,572,463,441,70,13,511
2/1/2021,VA,Virginia,Essex,51057,3044,2158,886,2635,19,2616,409,14,395,2835,1949,886,2234,1486,748,474,89,33,1638
2/1/2021,VA,Virginia,Fairfax,51059,159081,121192,37889,151429,656,150773,7652,387,7265,128927,91060,37867,81514,48937,32577,14333,2753,547,63881
2/1/2021,VA,Virginia,Fairfax City,51600,4008,3013,995,3774,15,3759,234,12,222,3363,2369,994,2256,1431,825,379,71,18,1788
2/1/2021,VA,Virginia,Falls Church City,51610,2154,1709,445,2086,*,*,68,*,*,1707,1262,445,1127,730,397,132,*,*,980
2/1/2021,VA,Virginia,Fauquier,51061,13324,10854,2470,12358,84,12274,966,35,931,11821,9351,2470,8164,6266,1898,963,193,58,6950
2/1/2021,VA,Virginia,Floyd,51063,4305,3074,1231,3794,14,3780,511,*,*,4021,2791,1230,3302,2149,1153,629,108,34,2531
2/1/2021,VA,Virginia,Fluvanna,51065,6503,5182,1321,5894,28,5866,609,17,592,5917,4596,1321,4523,3413,1110,593,121,28,3781
2/1/2021,VA,Virginia,Franklin,51067,15505,10026,5479,13365,68,13297,2140,36,2104,14605,9126,5479,12253,7286,4967,2047,480,141,9585
2/1/2021,VA,Virginia,Franklin City,51620,2192,1546,646,1809,23,1786,383,24,359,2063,1417,646,1715,1110,605,536,71,15,1093
2/1/2021,VA,Virginia,Frederick,51069,17834,13856,3978,16157,76,16081,1677,46,1631,16218,12242,3976,11841,8521,3320,1459,389,118,9875
2/1/2021,VA,Virginia,Fredericksburg City,51630,4264,3180,1084,3622,25,3597,642,26,616,3776,2692,1084,2722,1734,988,797,88,28,1809
2/1/2021,VA,Virginia,Galax City,51640,1743,1352,391,1421,*,*,322,*,*,1655,1264,391,1397,1041,356,552,59,22,764
2/1/2021,VA,Virginia,Giles,51071,4621,3197,1424,3775,23,3752,846,17,829,4370,2946,1424,3699,2556,1143,770,109,34,2786
2/1/2021,VA,Virginia,Gloucester,51073,9175,6973,2202,8087,56,8031,1088,25,1063,8474,6273,2201,5706,3751,1955,1005,189,51,4461
2/1/2021,VA,Virginia,Goochland,51075,6478,4830,1648,6018,34,5984,460,11,449,5970,4322,1648,5074,3649,1425,431,106,22,4515
2/1/2021,VA,Virginia,Grayson,51077,4682,3320,1362,3950,15,3935,732,*,*,4473,3111,1362,3601,2320,1281,926,182,75,2418
2/1/2021,VA,Virginia,Greene,51079,4190,3368,822,3719,20,3699,471,12,459,3797,2975,822,2888,2148,740,462,85,16,2325
2/1/2021,VA,Virginia,Greensville,51081,2141,1307,834,1756,22,1734,385,14,371,1991,1157,834,1662,924,738,456,100,17,1089
2/1/2021,VA,Virginia,Halifax,51083,9939,7312,2627,8381,60,8321,1558,55,1503,9324,6697,2627,7712,5296,2416,2056,409,127,5120
2/1/2021,VA,Virginia,Hampton City,51650,26231,17056,9175,22090,246,21844,4141,209,3932,23897,14724,9173,15641,7031,8610,4090,778,159,10614
2/1/2021,VA,Virginia,Hanover,51085,22989,16107,6882,21191,110,21081,1798,52,1746,21024,14145,6879,17515,11602,5913,1498,327,82,15608
2/1/2021,VA,Virginia,Harrisonburg City,51660,5586,4462,1124,4801,21,4780,785,21,764,5081,3957,1124,4181,3170,1011,983,139,45,3014
2/1/2021,VA,Virginia,Henrico,51087,60094,39758,20336,53472,427,53045,6622,292,6330,54544,34208,20336,46101,27716,18385,6869,1452,333,37447
2/1/2021,VA,Virginia,Henry,51089,14907,8860,6047,12145,99,12046,2762,75,2687,14207,8161,6046,12457,6754,5703,2933,744,204,8576
2/1/2021,VA,Virginia,Highland,51091,836,696,140,767,*,*,69,0,69,786,646,140,619,497,122,60,*,*,533
2/1/2021,VA,Virginia,Hopewell City,51670,4565,3035,1530,3626,33,3593,939,29,910,4234,2704,1530,3137,1674,1463,1034,164,30,1909
2/1/2021,VA,Virginia,Isle of Wight,51093,8934,6438,2496,7982,54,7928,952,32,920,8270,5774,2496,6011,3696,2315,994,203,64,4750
2/1/2021,VA,Virginia,James City,51095,22144,17801,4343,20915,76,20839,1229,35,1194,20514,16175,4339,13744,10294,3450,969,233,55,12487
2/1/2021,VA,Virginia,King and Queen,51097,1828,1341,487,1585,*,*,243,*,*,1706,1219,487,1336,901,435,263,*,*,994
2/1/2021,VA,Virginia,King George,51099,4285,3463,822,3780,25,3755,505,18,487,3708,2886,822,2046,1309,737,475,75,20,1476
2/1/2021,VA,Virginia,King William,51101,3690,2695,995,3219,34,3185,471,27,444,3421,2426,995,2862,1961,901,421,102,19,2320
2/1/2021,VA,Virginia,Lancaster,51103,4433,3489,944,4133,26,4107,300,13,287,4161,3218,943,3163,2439,724,482,100,14,2567
2/1/2021,VA,Virginia,Lee,51105,6424,2663,3761,4663,20,4643,1761,17,1744,6121,2362,3759,5194,1813,3381,1911,246,62,2975
2/1/2021,VA,Virginia,Lexington City,51678,1339,1081,258,1228,*,*,111,*,*,1237,980,257,984,754,230,170,30,11,773
2/1/2021,VA,Virginia,Loudoun,51107,42488,32231,10257,40172,196,39976,2316,123,2193,35410,25159,10251,24852,16050,8802,3577,692,159,20424
2/1/2021,VA,Virginia,Louisa,51109,9047,6568,2479,7825,58,7767,1222,36,1186,8278,5799,2479,6420,4212,2208,1158,261,55,4946
2/1/2021,VA,Virginia,Lunenburg,51111,3221,2344,877,2720,22,2698,501,*,*,2999,2122,877,2376,1567,809,748,120,41,1467
2/1/2021,VA,Virginia,Lynchburg City,51680,14731,10217,4514,12318,103,12215,2413,99,2314,13699,9185,4514,11578,7409,4169,2901,442,126,8109
2/1/2021,VA,Virginia,Madison,51113,3429,2700,729,3102,12,3090,327,*,*,3181,2452,729,2438,1829,609,413,83,16,1926
2/1/2021,VA,Virginia,Manassas City,51683,4813,3468,1345,4319,26,4293,494,38,456,4077,2732,1345,2971,1794,1177,533,109,25,2304
2/1/2021,VA,Virginia,Manassas Park City,51685,1384,890,494,1216,13,1203,168,*,*,1168,674,494,865,413,452,217,*,*,585
2/1/2021,VA,Virginia,Martinsville City,51690,3807,2238,1569,2935,43,2892,872,31,841,3604,2035,1569,3173,1660,1513,1222,190,56,1705
2/1/2021,VA,Virginia,Mathews,51115,2967,2283,684,2740,11,2729,227,*,*,2787,2103,684,2094,1520,574,283,42,21,1748
2/1/2021,VA,Virginia,Mecklenburg,51117,9514,6775,2739,8096,58,8038,1418,61,1357,8931,6192,2739,7271,4818,2453,1790,380,87,5014
2/1/2021,VA,Virginia,Middlesex,51119,3758,2898,860,3430,17,3413,328,*,*,3528,2668,860,2769,2058,711,436,80,21,2232
2/1/2021,VA,Virginia,Montgomery,51121,14548,10783,3765,12433,74,12359,2115,33,2082,13086,9321,3765,11113,7675,3438,1892,348,96,8777
2/1/2021,VA,Virginia,Nelson,51125,4845,3775,1070,4399,17,4382,446,*,*,4496,3427,1069,3420,2496,924,562,116,32,2710
2/1/2021,VA,Virginia,New Kent,51127,5121,3830,1291,4654,26,4628,467,14,453,4673,3382,1291,3452,2394,1058,319,83,18,3032
2/1/2021,VA,Virginia,Newport News City,51700,29640,19112,10528,24898,242,24656,4742,232,4510,27112,16586,10526,18746,8745,10001,5179,891,188,12488
2/1/2021,VA,Virginia,Norfolk City,51710,34209,21812,12397,28319,323,27996,5890,308,5582,30732,18337,12395,21906,10109,11797,7347,1356,243,12960
2/1/2021,VA,Virginia,Northampton,51131,3838,2745,1093,3418,22,3396,420,16,404,3587,2494,1093,2946,1972,974,864,86,28,1968
2/1/2021,VA,Virginia,Northumberland,51133,4765,3731,1034,4440,11,4429,325,12,313,4445,3411,1034,3156,2384,772,433,87,22,2614
2/1/2021,VA,Virginia,Norton City,51720,1122,548,574,800,*,*,322,*,*,1052,479,573,918,401,517,332,*,*,517
2/1/2021,VA,Virginia,Nottoway,51135,3638,2571,1067,3043,27,3016,595,17,578,3383,2316,1067,2726,1786,940,833,130,42,1721
2/1/2021,VA,Virginia,Orange,51137,9047,7011,2036,8117,56,8061,930,33,897,8262,6226,2036,5893,4235,1658,951,207,57,4678
2/1/2021,VA,Virginia,Page,51139,6398,4992,1406,5390,18,5372,1008,20,988,5980,4574,1406,4575,3334,1241,1082,251,60,3182
2/1/2021,VA,Virginia,Patrick,51141,5545,3718,1827,4685,15,4670,860,12,848,5282,3456,1826,4403,2744,1659,1029,202,60,3112
2/1/2021,VA,Virginia,Petersburg City,51730,7222,4280,2942,5533,100,5433,1689,76,1613,6587,3645,2942,5138,2286,2852,2135,338,53,2612
2/1/2021,VA,Virginia,Pittsylvania,51143,16758,10541,6217,14156,121,14035,2602,68,2534,15779,9562,6217,13494,8538,4956,2965,557,163,9809
2/1/2021,VA,Virginia,Poquoson City,51735,2639,2191,448,2472,*,*,167,*,*,2425,1977,448,1331,929,402,116,*,*,1175
2/1/2021,VA,Virginia,Portsmouth City,51740,18611,11819,6792,14943,207,14736,3668,203,3465,16687,9896,6791,11761,5272,6489,4086,718,115,6842
2/1/2021,VA,Virginia,Powhatan,51145,6592,4870,1722,6033,18,6015,559,14,545,6091,4369,1722,5047,3527,1520,414,117,27,4489
2/1/2021,VA,Virginia,Prince Edward,51147,4782,3339,1443,3973,39,3934,809,28,781,4416,2973,1443,3612,2322,1290,1030,170,44,2368
2/1/2021,VA,Virginia,Prince George,51149,6521,5130,1391,5597,39,5558,924,32,892,6045,4654,1391,3910,2647,1263,625,139,27,3119
2/1/2021,VA,Virginia,Prince William,51153,52941,39123,13818,48165,341,47824,4776,294,4482,45108,31293,13815,27787,15418,12369,5357,1235,224,20971
2/1/2021,VA,Virginia,Pulaski,51155,9224,6645,2579,7560,37,7523,1664,29,1635,8622,6043,2579,7230,4921,2309,1556,285,82,5307
2/1/2021,VA,Virginia,Radford City,51750,2121,1543,578,1766,*,*,355,*,*,1915,1337,578,1651,1114,537,329,46,20,1256
2/1/2021,VA,Virginia,Rappahannock,51157,2053,1715,338,1928,*,*,125,*,*,1848,1511,337,1333,1072,261,149,36,13,1135
2/1/2021,VA,Virginia,Richmond,51159,1993,1448,545,1756,*,*,237,*,*,1856,1311,545,1437,1006,431,318,69,11,1039
2/1/2021,VA,Virginia,Richmond City,51760,34811,19973,14838,28571,300,28271,6240,303,5937,31442,16607,14835,27436,13291,14145,8767,1343,274,17052
2/1/2021,VA,Virginia,Roanoke,51161,24451,17025,7426,21977,126,21851,2474,52,2422,22625,15202,7423,18803,12250,6553,2082,467,132,16122
2/1/2021,VA,Virginia,Roanoke City,51770,21325,12750,8575,16859,169,16690,4466,136,4330,19510,10937,8573,16476,8450,8026,4718,924,181,10653
2/1/2021,VA,Virginia,Rockbridge,51163,6522,4914,1608,5685,*,*,837,*,*,6070,4462,1608,4742,3318,1424,841,179,51,3671
2/1/2021,VA,Virginia,Rockingham,51165,18709,15208,3501,16732,61,16671,1977,41,1936,17347,13846,3501,14176,11109,3067,1781,530,142,11723
2/1/2021,VA,Virginia,Russell,51167,8061,4063,3998,5909,17,5892,2152,20,2132,7739,3742,3997,6811,3435,3376,1706,347,134,4624
2/1/2021,VA,Virginia,Salem City,51775,6132,4390,1742,5287,31,5256,845,14,831,5640,3898,1742,4639,3045,1594,811,125,42,3661
2/1/2021,VA,Virginia,Scott,51169,6777,2590,4187,5284,14,5270,1493,17,1476,6506,2319,4187,5797,1815,3982,1507,260,96,3934
2/1/2021,VA,Virginia,Shenandoah,51171,10988,8436,2552,9882,31,9851,1106,17,1089,10298,7747,2551,7735,5575,2160,1250,259,82,6144
2/1/2021,VA,Virginia,Smyth,51173,8710,5396,3314,6724,28,6696,1986,30,1956,8273,4959,3314,7008,3844,3164,2029,370,127,4482
2/1/2021,VA,Virginia,Southampton,51175,4117,3037,1080,3532,30,3502,585,25,560,3809,2729,1080,3042,2074,968,674,132,31,2205
2/1/2021,VA,Virginia,Spotsylvania,51177,23284,17392,5892,20658,136,20522,2626,97,2529,20647,14756,5891,13331,8148,5183,2160,564,125,10482
2/1/2021,VA,Virginia,Stafford,51179,19324,15380,3944,17400,125,17275,1924,87,1837,16916,12974,3942,9317,5869,3448,1549,393,80,7295
2/1/2021,VA,Virginia,Staunton City,51790,6350,4887,1463,5402,29,5373,948,15,933,5972,4509,1463,4859,3525,1334,1079,167,50,3563
2/1/2021,VA,Virginia,Suffolk City,51800,17685,12308,5377,14922,153,14769,2763,112,2651,16222,10845,5377,11353,6369,4984,2803,516,95,7939
2/1/2021,VA,Virginia,Surry,51181,1784,1228,556,1558,13,1545,226,*,*,1650,1094,556,1252,725,527,224,57,14,957
2/1/2021,VA,Virginia,Sussex,51183,2559,1689,870,2122,31,2091,437,14,423,2387,1517,870,1896,1072,824,509,137,20,1230
2/1/2021,VA,Virginia,Tazewell,51185,11969,6825,5144,9203,42,9161,2766,35,2731,11389,6247,5142,9397,5369,4028,2271,491,129,6506
2/1/2021,VA,Virginia,Unknown,51999,*,*,*,*,*,*,*,*,*,*,*,*,*,*,*,*,*,*,*
2/1/2021,VA,Virginia,Virginia Beach City,51810,76773,57532,19241,68839,424,68415,7934,330,7604,70315,51084,19231,42745,25236,17509,7168,1552,364,33661
2/1/2021,VA,Virginia,Warren,51187,8322,6554,1768,7358,31,7327,964,33,931,7555,5787,1768,5403,3941,1462,918,231,69,4185
2/1/2021,VA,Virginia,Washington,51191,15610,8680,6930,12993,43,12950,2617,35,2582,14739,7810,6929,12523,6092,6431,2385,626,169,9343
2/1/2021,VA,Virginia,Waynesboro City,51820,5099,3852,1247,4291,24,4267,808,24,784,4788,3541,1247,3918,2747,1171,883,129,45,2861
2/1/2021,VA,Virginia,Westmoreland,51193,5298,4100,1198,4747,29,4718,551,16,535,4801,3603,1198,3298,2250,1048,813,146,43,2296
2/1/2021,VA,Virginia,Williamsburg City,51830,2931,2261,670,2691,*,*,240,*,*,2708,2038,670,1989,1410,579,280,*,*,1662
2/1/2021,VA,Virginia,Winchester City,51840,5641,4387,1254,4904,28,4876,737,23,714,5142,3888,1254,3901,2821,1080,885,142,33,2841
2/1/2021,VA,Virginia,Wise,51195,10629,4604,6025,7563,31,7532,3066,23,3043,10055,4030,6025,8400,3192,5208,2365,493,148,5394
2/1/2021,VA,Virginia,Wythe,51197,7986,5200,2786,6416,41,6375,1570,15,1555,7551,4765,2786,6338,3792,2546,1597,312,91,4338
2/1/2021,VA,Virginia,York,51199,12849,10350,2499,11923,53,11870,926,38,888,11765,9266,2499,6596,4421,2175,728,162,39,5667
1/1/2021,VA,Virginia,Accomack,51001,9336,7008,2328,8233,59,8174,1103,42,1061,8645,6320,2325,6553,4582,1971,1473,372,87,4621
1/1/2021,VA,Virginia,Albemarle,51003,22718,19128,3590,21202,64,21138,1516,44,1472,20557,16969,3588,16281,13213,3068,1635,303,93,14250
1/1/2021,VA,Virginia,Alexandria City,51510,18455,14409,4046,17208,75,17133,1247,68,1179,14987,10942,4045,9687,6029,3658,2082,315,61,7229
1/1/2021,VA,Virginia,Alleghany,51005,4646,3423,1223,3841,23,3818,805,*,*,4405,3182,1223,3647,2604,1043,812,108,43,2684
1/1/2021,VA,Virginia,Amelia,51007,3234,2142,1092,2811,12,2799,423,12,411,2998,1906,1092,2463,1444,1019,450,88,30,1895
1/1/2021,VA,Virginia,Amherst,51009,8060,5653,2407,6872,57,6815,1188,32,1156,7511,5104,2407,6282,4077,2205,1245,213,72,4752
1/1/2021,VA,Virginia,Appomattox,51011,4169,2935,1234,3455,17,3438,714,22,692,3923,2689,1234,3294,2149,1145,759,122,46,2367
1/1/2021,VA,Virginia,Arlington,51013,25271,20243,5028,23787,110,23677,1484,76,1408,19983,14956,5027,12853,8259,4594,2975,403,114,9361
1/1/2021,VA,Virginia,Augusta,51015,19157,15000,4157,16930,76,16854,2227,51,2176,17992,13835,4157,14492,10704,3788,1873,425,134,12060
1/1/2021,VA,Virginia,Bath,51017,1300,1086,214,1148,*,*,152,*,*,1239,1025,214,1008,814,194,167,*,*,797
1/1/2021,VA,Virginia,Bedford,51019,20747,15375,5372,18228,90,18138,2519,46,2473,19344,13973,5371,15675,11204,4471,2018,494,148,13015
1/1/2021,VA,Virginia,Bland,51021,1818,1233,585,1480,*,*,338,*,*,1721,1136,585,1374,920,454,224,58,15,1077
1/1/2021,VA,Virginia,Botetourt,51023,9030,6323,2707,8045,57,7988,985,20,965,8409,5702,2707,6838,4482,2356,710,170,43,5915
1/1/2021,VA,Virginia,Bristol City,51520,4533,2124,2409,3641,13,3628,892,17,875,4249,1840,2409,3685,1363,2322,1088,154,42,2401
1/1/2021,VA,Virginia,Brunswick,51025,4136,2841,1295,3525,39,3486,611,17,594,3864,2569,1295,3151,1978,1173,1045,125,35,1946
1/1/2021,VA,Virginia,Buchanan,51027,7060,3348,3712,4799,23,4776,2261,15,2246,6830,3118,3712,5922,2968,2954,1587,395,106,3834
1/1/2021,VA,Virginia,Buckingham,51029,3776,2731,1045,3159,25,3134,617,18,599,3530,2485,1045,2810,1955,855,759,146,41,1864
1/1/2021,VA,Virginia,Buena Vista City,51530,1506,1070,436,1255,*,*,251,*,*,1400,964,436,1127,738,389,303,58,14,752
1/1/2021,VA,Virginia,Campbell,51031,13410,9433,3977,11414,94,11320,1996,52,1944,12586,8609,3977,10536,6925,3611,2061,400,123,7952
1/1/2021,VA,Virginia,Caroline,51033,6243,4411,1832,5399,44,5355,844,28,816,5650,3818,1832,4072,2425,1647,861,209,37,2965
1/1/2021,VA,Virginia,Carroll,51035,8637,6493,2144,7296,36,7260,1341,17,1324,8212,6068,2144,6619,4736,1883,1563,276,105,4675
1/1/2021,VA,Virginia,Charles City,51036,2005,1340,665,1752,22,1730,253,11,242,1835,1170,665,1472,875,597,250,84,15,1123
1/1/2021,VA,Virginia,Charlotte,51037,3290,2410,880,2767,23,2744,523,17,506,3085,2205,880,2535,1728,807,690,129,37,1679
1/1/2021,VA,Virginia,Charlottesville City,51540,6390,5160,1230,5504,33,5471,886,34,852,5724,4495,1229,4771,3625,1146,1179,161,30,3401
1/1/2021,VA,Virginia,Chesapeake City,51550,40883,29104,11779,36047,321,35726,4836,205,4631,37048,25271,11777,23690,13051,10639,4286,999,208,18197
1/1/2021,VA,Virginia,Chesterfield,51041,65284,45468,19816,58391,308,58083,6893,248,6645,59164,39352,19812,47481,29436,18045,5810,1091,245,40335
1/1/2021,VA,Virginia,Clarke,51043,3551,2874,677,3308,*,*,243,*,*,3204,2527,677,2319,1769,550,288,77,29,1925
1/1/2021,VA,Virginia,Colonial Heights City,51570,4185,3150,1035,3631,17,3614,554,*,*,3857,2822,1035,2678,1736,942,521,102,17,2038
1/1/2021,VA,Virginia,Covington City,51580,1572,1152,420,1221,16,1205,351,*,*,1473,1053,420,1232,835,397,334,49,14,835
1/1/2021,VA,Virginia,Craig,51045,1379,930,449,1114,*,*,265,*,*,1284,835,449,1061,654,407,195,51,11,804
1/1/2021,VA,Virginia,Culpeper,51047,10076,7873,2203,8943,46,8897,1133,32,1101,9121,6918,2203,6658,4900,1758,1238,249,68,5103
1/1/2021,VA,Virginia,Cumberland,51049,2418,1629,789,2046,13,2033,372,*,*,2242,1454,788,1849,1133,716,443,95,25,1286
1/1/2021,VA,Virginia,Danville City,51590,11155,6640,4515,9004,105,8899,2151,115,2036,10484,5969,4515,9166,5542,3624,3231,417,136,5382
1/1/2021,VA,Virginia,Dickenson,51051,4868,2060,2808,3346,11,3335,1522,*,*,4679,1871,2808,4025,1541,2484,1092,213,62,2658
1/1/2021,VA,Virginia,Dinwiddie,51053,6162,4214,1948,5144,34,5110,1018,33,985,5706,3758,1948,4475,2636,1839,910,203,47,3315
1/1/2021,VA,Virginia,Emporia City,51595,1304,799,505,1053,14,1039,251,*,*,1226,721,505,1033,581,452,437,70,13,513
1/1/2021,VA,Virginia,Essex,51057,3057,2175,882,2648,20,2628,409,15,394,2844,1962,882,2242,1499,743,475,88,34,1645
1/1/2021,VA,Virginia,Fairfax,51059,158724,121188,37536,151105,666,150439,7619,390,7229,128711,91197,37514,81216,48995,32221,14309,2748,557,63602
1/1/2021,VA,Virginia,Fairfax City,51600,4004,3011,993,3769,16,3753,235,12,223,3362,2370,992,2255,1433,822,382,71,17,1785
1/1/2021,VA,Virginia,Falls Church City,51610,2150,1706,444,2082,*,*,68,*,*,1708,1264,444,1123,727,396,130,*,*,979
1/1/2021,VA,Virginia,Fauquier,51061,13335,10873,2462,12372,87,12285,963,36,927,11829,9367,2462,8164,6275,1889,961,195,57,6951
1/1/2021,VA,Virginia,Floyd,51063,4295,3067,1228,3786,14,3772,509,*,*,4015,2788,1227,3300,2149,1151,627,108,35,2530
1/1/2021,VA,Virginia,Fluvanna,51065,6493,5172,1321,5887,28,5859,606,17,589,5909,4588,1321,4520,3411,1109,592,123,27,3778
1/1/2021,VA,Virginia,Franklin,51067,15522,10049,5473,13381,69,13312,2141,36,2105,14611,9138,5473,12247,7285,4962,2044,474,144,9585
1/1/2021,VA,Virginia,Franklin City,51620,2195,1550,645,1812,23,1789,383,24,359,2067,1422,645,1719,1118,601,542,70,15,1092
1/1/2021,VA,Virginia,Frederick,51069,17814,13861,3953,16141,77,16064,1673,45,1628,16199,12248,3951,11805,8514,3291,1454,382,119,9850
1/1/2021,VA,Virginia,Fredericksburg City,51630,4266,3191,1075,3625,26,3599,641,27,614,3773,2698,1075,2721,1742,979,795,92,24,1810
1/1/2021,VA,Virginia,Galax City,51640,1751,1367,384,1429,*,*,322,*,*,1662,1278,384,1400,1053,347,557,59,22,762
1/1/2021,VA,Virginia,Giles,51071,4649,3218,1431,3799,23,3776,850,17,833,4399,2968,1431,3721,2575,1146,784,108,34,2795
1/1/2021,VA,Virginia,Gloucester,51073,9170,6968,2202,8084,57,8027,1086,26,1060,8469,6268,2201,5705,3754,1951,999,192,52,4462
1/1/2021,VA,Virginia,Goochland,51075,6461,4807,1654,6000,34,5966,461,11,450,5962,4308,1654,5058,3629,1429,431,105,23,4499
1/1/2021,VA,Virginia,Grayson,51077,4684,3336,1348,3951,16,3935,733,*,*,4476,3128,1348,3600,2332,1268,917,184,76,2423
1/1/2021,VA,Virginia,Greene,51079,4200,3378,822,3732,20,3712,468,12,456,3807,2985,822,2891,2152,739,465,86,17,2323
1/1/2021,VA,Virginia,Greensville,51081,2145,1323,822,1758,22,1736,387,14,373,1995,1173,822,1660,933,727,458,99,17,1086
1/1/2021,VA,Virginia,Halifax,51083,9946,7337,2609,8396,61,8335,1550,55,1495,9329,6720,2609,7717,5320,2397,2059,412,124,5122
1/1/2021,VA,Virginia,Hampton City,51650,26233,17086,9147,22107,252,21855,4126,208,3918,23902,14757,9145,15631,7061,8570,4087,775,159,10610
1/1/2021,VA,Virginia,Hanover,51085,22998,16123,6875,21202,114,21088,1796,53,1743,21041,14169,6872,17511,11610,5901,1496,328,79,15608
1/1/2021,VA,Virginia,Harrisonburg City,51660,5592,4477,1115,4808,23,4785,784,20,764,5086,3971,1115,4179,3178,1001,990,138,46,3005
1/1/2021,VA,Virginia,Henrico,51087,60161,39856,20305,53546,434,53112,6615,293,6322,54621,34316,20305,46107,27775,18332,6870,1446,341,37450
1/1/2021,VA,Virginia,Henry,51089,14950,8918,6032,12183,101,12082,2767,76,2691,14249,8218,6031,12489,6802,5687,2931,744,206,8608
1/1/2021,VA,Virginia,Highland,51091,834,697,137,765,*,*,69,0,69,785,648,137,616,498,118,60,*,*,530
1/1/2021,VA,Virginia,Hopewell City,51670,4578,3051,1527,3643,35,3608,935,28,907,4248,2721,1527,3141,1680,1461,1038,165,29,1909
1/1/2021,VA,Virginia,Isle of Wight,51093,8929,6434,2495,7981,57,7924,948,33,915,8265,5770,2495,6002,3689,2313,998,203,64,4737
1/1/2021,VA,Virginia,James City,51095,22134,17789,4345,20911,77,20834,1223,35,1188,20514,16173,4341,13739,10294,3445,958,230,55,12496
1/1/2021,VA,Virginia,King and Queen,51097,1824,1343,481,1582,*,*,242,0,242,1701,1220,481,1329,901,428,265,*,*,985
1/1/2021,VA,Virginia,King George,51099,4281,3469,812,3779,26,3753,502,18,484,3708,2896,812,2039,1313,726,475,73,20,1471
1/1/2021,VA,Virginia,King William,51101,3691,2703,988,3218,34,3184,473,27,446,3425,2437,988,2857,1962,895,423,98,18,2318
1/1/2021,VA,Virginia,Lancaster,51103,4439,3504,935,4138,26,4112,301,14,287,4172,3238,934,3169,2455,714,482,100,13,2574
1/1/2021,VA,Virginia,Lee,51105,6434,2682,3752,4671,20,4651,1763,17,1746,6127,2377,3750,5197,1825,3372,1906,245,62,2984
1/1/2021,VA,Virginia,Lexington City,51678,1347,1095,252,1236,*,*,111,*,*,1246,995,251,991,767,224,170,30,11,780
1/1/2021,VA,Virginia,Loudoun,51107,42416,32249,10167,40104,198,39906,2312,121,2191,35406,25245,10161,24769,16066,8703,3567,692,159,20351
1/1/2021,VA,Virginia,Louisa,51109,9051,6587,2464,7835,59,7776,1216,36,1180,8272,5808,2464,6416,4226,2190,1144,266,53,4953
1/1/2021,VA,Virginia,Lunenburg,51111,3222,2349,873,2720,22,2698,502,*,*,2993,2120,873,2371,1567,804,747,115,39,1470
1/1/2021,VA,Virginia,Lynchburg City,51680,14755,10275,4480,12342,107,12235,2413,102,2311,13725,9245,4480,11582,7448,4134,2905,443,127,8107
1/1/2021,VA,Virginia,Madison,51113,3421,2695,726,3097,13,3084,324,*,*,3177,2451,726,2435,1827,608,412,81,16,1926
1/1/2021,VA,Virginia,Manassas City,51683,4811,3497,1314,4315,27,4288,496,39,457,4073,2759,1314,2959,1810,1149,536,108,25,2290
1/1/2021,VA,Virginia,Manassas Park City,51685,1374,896,478,1208,14,1194,166,*,*,1155,677,478,853,416,437,214,*,*,575
1/1/2021,VA,Virginia,Martinsville City,51690,3819,2257,1562,2949,44,2905,870,32,838,3613,2051,1562,3182,1677,1505,1236,187,55,1704
1/1/2021,VA,Virginia,Mathews,51115,2970,2291,679,2744,13,2731,226,*,*,2793,2114,679,2097,1528,569,282,43,21,1751
1/1/2021,VA,Virginia,Mecklenburg,51117,9499,6790,2709,8088,60,8028,1411,61,1350,8924,6215,2709,7258,4835,2423,1791,376,86,5005
1/1/2021,VA,Virginia,Middlesex,51119,3763,2903,860,3434,17,3417,329,*,*,3531,2671,860,2772,2059,713,440,80,21,2231
1/1/2021,VA,Virginia,Montgomery,51121,14541,10786,3755,12433,75,12358,2108,34,2074,13079,9324,3755,11117,7688,3429,1896,345,97,8779
1/1/2021,VA,Virginia,Nelson,51125,4845,3794,1051,4400,17,4383,445,*,*,4499,3449,1050,3415,2506,909,555,117,31,2712
1/1/2021,VA,Virginia,New Kent,51127,5108,3829,1279,4643,26,4617,465,14,451,4664,3385,1279,3440,2394,1046,322,86,17,3015
1/1/2021,VA,Virginia,Newport News City,51700,29633,19194,10439,24915,247,24668,4718,234,4484,27103,16666,10437,18713,8801,9912,5172,888,187,12466
1/1/2021,VA,Virginia,Norfolk City,51710,34238,21892,12346,28350,327,28023,5888,307,5581,30785,18441,12344,21937,10189,11748,7350,1355,247,12985
1/1/2021,VA,Virginia,Northampton,51131,3836,2751,1085,3415,22,3393,421,16,405,3587,2502,1085,2945,1978,967,861,90,28,1966
1/1/2021,VA,Virginia,Northumberland,51133,4771,3750,1021,4447,12,4435,324,12,312,4453,3432,1021,3158,2399,759,434,89,22,2613
1/1/2021,VA,Virginia,Norton City,51720,1132,557,575,807,*,*,325,*,*,1061,487,574,924,406,518,335,*,*,520
1/1/2021,VA,Virginia,Nottoway,51135,3659,2597,1062,3066,30,3036,593,17,576,3398,2336,1062,2736,1805,931,836,128,42,1730
1/1/2021,VA,Virginia,Orange,51137,9062,7025,2037,8132,57,8075,930,34,896,8275,6238,2037,5901,4242,1659,951,210,58,4682
1/1/2021,VA,Virginia,Page,51139,6401,5003,1398,5398,18,5380,1003,20,983,5981,4583,1398,4568,3336,1232,1079,254,57,3178
1/1/2021,VA,Virginia,Patrick,51141,5546,3717,1829,4689,15,4674,857,12,845,5294,3466,1828,4408,2750,1658,1027,198,60,3123
1/1/2021,VA,Virginia,Petersburg City,51730,7232,4307,2925,5544,104,5440,1688,76,1612,6589,3664,2925,5142,2308,2834,2127,346,53,2616
1/1/2021,VA,Virginia,Pittsylvania,51143,16765,10587,6178,14171,122,14049,2594,68,2526,15787,9609,6178,13476,8567,4909,2951,558,165,9802
1/1/2021,VA,Virginia,Poquoson City,51735,2646,2201,445,2478,*,*,168,*,*,2433,1988,445,1336,938,398,116,*,*,1179
1/1/2021,VA,Virginia,Portsmouth City,51740,18627,11868,6759,14971,217,14754,3656,201,3455,16709,9951,6758,11776,5326,6450,4075,714,119,6868
1/1/2021,VA,Virginia,Powhatan,51145,6584,4862,1722,6029,18,6011,555,14,541,6087,4365,1722,5030,3515,1515,405,114,28,4483
1/1/2021,VA,Virginia,Prince Edward,51147,4780,3344,1436,3974,39,3935,806,28,778,4421,2986,1435,3614,2336,1278,1031,169,43,2371
1/1/2021,VA,Virginia,Prince George,51149,6521,5134,1387,5600,39,5561,921,33,888,6040,4654,1386,3914,2656,1258,628,136,28,3122
1/1/2021,VA,Virginia,Prince William,51153,52829,39122,13707,48065,348,47717,4764,292,4472,45051,31347,13704,27683,15436,12247,5329,1223,224,20907
1/1/2021,VA,Virginia,Pulaski,51155,9245,6682,2563,7579,37,7542,1666,29,1637,8642,6079,2563,7236,4941,2295,1565,287,82,5302
1/1/2021,VA,Virginia,Radford City,51750,2122,1552,570,1768,*,*,354,*,*,1916,1346,570,1649,1120,529,328,45,20,1256
1/1/2021,VA,Virginia,Rappahannock,51157,2054,1719,335,1929,*,*,125,*,*,1850,1516,334,1335,1075,260,150,36,13,1136
1/1/2021,VA,Virginia,Richmond,51159,1992,1449,543,1755,*,*,237,*,*,1854,1311,543,1437,1011,426,316,70,11,1040
1/1/2021,VA,Virginia,Richmond City,51760,34885,20096,14789,28641,308,28333,6244,304,5940,31503,16716,14787,27465,13363,14102,8765,1348,274,17078
1/1/2021,VA,Virginia,Roanoke,51161,24448,17039,7409,21984,128,21856,2464,52,2412,22619,15213,7406,18793,12266,6527,2083,473,130,16107
1/1/2021,VA,Virginia,Roanoke City,51770,21345,12823,8522,16884,171,16713,4461,134,4327,19531,11011,8520,16472,8501,7971,4707,924,179,10662
1/1/2021,VA,Virginia,Rockbridge,51163,6535,4939,1596,5706,*,*,829,*,*,6083,4487,1596,4750,3339,1411,845,176,52,3677
1/1/2021,VA,Virginia,Rockingham,51165,18692,15208,3484,16726,62,16664,1966,41,1925,17342,13858,3484,14156,11111,3045,1786,529,142,11699
1/1/2021,VA,Virginia,Russell,51167,8076,4089,3987,5924,18,5906,2152,21,2131,7760,3774,3986,6814,3451,3363,1713,347,137,4617
1/1/2021,VA,Virginia,Salem City,51775,6152,4414,1738,5310,32,5278,842,14,828,5657,3919,1738,4654,3065,1589,814,126,42,3672
1/1/2021,VA,Virginia,Scott,51169,6793,2606,4187,5307,14,5293,1486,17,1469,6526,2339,4187,5804,1824,3980,1504,258,97,3945
1/1/2021,VA,Virginia,Shenandoah,51171,11002,8456,2546,9901,34,9867,1101,17,1084,10317,7772,2545,7759,5604,2155,1248,261,85,6165
1/1/2021,VA,Virginia,Smyth,51173,8726,5437,3289,6747,29,6718,1979,30,1949,8291,5002,3289,7013,3876,3137,2021,369,128,4495
1/1/2021,VA,Virginia,Southampton,51175,4105,3040,1065,3526,32,3494,579,24,555,3803,2738,1065,3035,2080,955,664,131,30,2210
1/1/2021,VA,Virginia,Spotsylvania,51177,23247,17386,5861,20627,139,20488,2620,95,2525,20628,14768,5860,13308,8161,5147,2143,564,127,10474
1/1/2021,VA,Virginia,Stafford,51179,19272,15348,3924,17357,127,17230,1915,86,1829,16881,12959,3922,9311,5887,3424,1551,392,82,7286
1/1/2021,VA,Virginia,Staunton City,51790,6354,4894,1460,5411,29,5382,943,15,928,5983,4523,1460,4866,3539,1327,1078,163,51,3574
1/1/2021,VA,Virginia,Suffolk City,51800,17687,12343,5344,14936,158,14778,2751,113,2638,16223,10879,5344,11371,6423,4948,2800,511,93,7967
1/1/2021,VA,Virginia,Surry,51181,1782,1227,555,1557,13,1544,225,*,*,1646,1091,555,1252,725,527,222,59,15,956
1/1/2021,VA,Virginia,Sussex,51183,2563,1693,870,2124,31,2093,439,14,425,2391,1521,870,1897,1073,824,509,137,21,1230
1/1/2021,VA,Virginia,Tazewell,51185,11996,6871,5125,9230,43,9187,2766,35,2731,11410,6287,5123,9419,5415,4004,2281,492,128,6518
1/1/2021,VA,Virginia,Unknown,51999,*,*,*,*,*,*,*,*,*,*,*,*,*,*,*,*,*,*,*
1/1/2021,VA,Virginia,Virginia Beach City,51810,76711,57537,19174,68789,435,68354,7922,333,7589,70284,51120,19164,42689,25257,17432,7167,1541,374,33607
1/1/2021,VA,Virginia,Warren,51187,8322,6561,1761,7359,31,7328,963,34,929,7557,5796,1761,5393,3942,1451,913,232,69,4179
1/1/2021,VA,Virginia,Washington,51191,15616,8695,6921,13008,44,12964,2608,34,2574,14753,7833,6920,12543,6113,6430,2383,618,174,9368
1/1/2021,VA,Virginia,Waynesboro City,51820,5102,3862,1240,4297,25,4272,805,24,781,4789,3549,1240,3915,2752,1163,885,128,46,2856
1/1/2021,VA,Virginia,Westmoreland,51193,5292,4093,1199,4743,30,4713,549,16,533,4802,3603,1199,3299,2249,1050,807,145,45,2302
1/1/2021,VA,Virginia,Williamsburg City,51830,2936,2276,660,2696,*,*,240,*,*,2712,2052,660,1986,1417,569,279,*,*,1661
1/1/2021,VA,Virginia,Winchester City,51840,5660,4415,1245,4919,28,4891,741,23,718,5161,3916,1245,3901,2831,1070,887,140,34,2840
1/1/2021,VA,Virginia,Wise,51195,10641,4630,6011,7581,31,7550,3060,23,3037,10068,4057,6011,8391,3207,5184,2359,496,146,5390
1/1/2021,VA,Virginia,Wythe,51197,8005,5231,2774,6439,42,6397,1566,15,1551,7570,4796,2774,6352,3819,2533,1600,314,92,4346
1/1/2021,VA,Virginia,York,51199,12862,10373,2489,11941,54,11887,921,37,884,11786,9297,2489,6605,4443,2162,722,159,39,5685
7/1/2021,VA,Virginia,Accomack,51001,9437,6999,2438,8308,51,8257,1129,41,1088,8745,6310,2435,6618,4529,2089,1540,378,73,4627
7/1/2021,VA,Virginia,Albemarle,51003,22991,19294,3697,21445,59,21386,1546,46,1500,20809,17114,3695,16482,13301,3181,1662,302,80,14438
7/1/2021,VA,Virginia,Alexandria City,51510,18725,14503,4222,17457,70,17387,1268,66,1202,15235,11014,4221,9856,6013,3843,2154,318,54,7330
7/1/2021,VA,Virginia,Alleghany,51005,4615,3335,1280,3799,19,3780,816,*,*,4386,3106,1280,3645,2539,1106,820,110,35,2680
7/1/2021,VA,Virginia,Amelia,51007,3242,2121,1121,2814,*,*,428,*,*,2999,1878,1121,2458,1410,1048,451,86,24,1897
7/1/2021,VA,Virginia,Amherst,51009,8108,5610,2498,6893,54,6839,1215,31,1184,7558,5060,2498,6295,4001,2294,1254,219,69,4753
7/1/2021,VA,Virginia,Appomattox,51011,4187,2902,1285,3462,17,3445,725,21,704,3939,2654,1285,3296,2104,1192,780,110,39,2367
7/1/2021,VA,Virginia,Arlington,51013,25643,20356,5287,24150,103,24047,1493,77,1416,20288,15002,5286,13050,8187,4863,3034,401,112,9503
7/1/2021,VA,Virginia,Augusta,51015,19279,14964,4315,17004,68,16936,2275,49,2226,18130,13815,4315,14626,10680,3946,1918,418,126,12164
7/1/2021,VA,Virginia,Bath,51017,1297,1067,230,1143,*,*,154,*,*,1228,998,230,995,784,211,166,*,*,790
7/1/2021,VA,Virginia,Bedford,51019,20910,15329,5581,18338,78,18260,2572,46,2526,19514,13934,5580,15825,11118,4707,2062,495,143,13125
7/1/2021,VA,Virginia,Bland,51021,1840,1234,606,1495,*,*,345,*,*,1735,1129,606,1385,903,482,231,57,14,1083
7/1/2021,VA,Virginia,Botetourt,51023,9097,6327,2770,8090,52,8038,1007,21,986,8456,5686,2770,6869,4451,2418,728,174,39,5928
7/1/2021,VA,Virginia,Bristol City,51520,4486,2066,2420,3584,*,*,902,15,887,4220,1800,2420,3669,1337,2332,1088,157,35,2389
7/1/2021,VA,Virginia,Brunswick,51025,4118,2734,1384,3499,32,3467,619,17,602,3856,2472,1384,3151,1882,1269,1051,123,33,1944
7/1/2021,VA,Virginia,Buchanan,51027,7033,3242,3791,4739,22,4717,2294,14,2280,6810,3019,3791,5920,2879,3041,1603,390,82,3845
7/1/2021,VA,Virginia,Buckingham,51029,3791,2678,1113,3154,21,3133,637,16,621,3550,2437,1113,2829,1903,926,785,142,41,1861
7/1/2021,VA,Virginia,Buena Vista City,51530,1503,1060,443,1246,*,*,257,*,*,1405,962,443,1122,728,394,302,60,14,746
7/1/2021,VA,Virginia,Campbell,51031,13450,9318,4132,11411,81,11330,2039,53,1986,12610,8478,4132,10536,6768,3768,2099,396,119,7922
7/1/2021,VA,Virginia,Caroline,51033,6302,4400,1902,5443,37,5406,859,29,830,5705,3803,1902,4106,2387,1719,877,204,30,2995
7/1/2021,VA,Virginia,Carroll,51035,8628,6376,2252,7276,35,7241,1352,18,1334,8222,5970,2252,6616,4618,1998,1557,281,93,4685
7/1/2021,VA,Virginia,Charles City,51036,2010,1329,681,1759,19,1740,251,*,*,1842,1161,681,1464,852,612,251,*,*,1124
7/1/2021,VA,Virginia,Charlotte,51037,3260,2334,926,2735,20,2715,525,14,511,3059,2133,926,2515,1659,856,702,130,33,1650
7/1/2021,VA,Virginia,Charlottesville City,51540,6476,5158,1318,5569,28,5541,907,33,874,5829,4513,1316,4849,3616,1233,1206,157,29,3457
7/1/2021,VA,Virginia,Chesapeake City,51550,41351,29230,12121,36424,295,36129,4927,200,4727,37485,25366,12119,23830,12850,10980,4354,981,177,18318
7/1/2021,VA,Virginia,Chesterfield,51041,66096,45727,20369,59063,283,58780,7033,243,6790,59962,39597,20365,48080,29484,18596,6000,1056,223,40801
7/1/2021,VA,Virginia,Clarke,51043,3596,2898,698,3347,*,*,249,*,*,3256,2558,698,2366,1796,570,298,76,27,1965
7/1/2021,VA,Virginia,Colonial Heights City,51570,4145,3091,1054,3586,15,3571,559,*,*,3824,2770,1054,2658,1693,965,520,104,19,2015
7/1/2021,VA,Virginia,Covington City,51580,1555,1127,428,1199,12,1187,356,*,*,1450,1022,428,1213,805,408,338,*,*,819
7/1/2021,VA,Virginia,Craig,51045,1392,918,474,1125,*,*,267,*,*,1295,821,474,1074,643,431,195,*,*,818
7/1/2021,VA,Virginia,Culpeper,51047,10166,7827,2339,8998,40,8958,1168,31,1137,9218,6879,2339,6726,4839,1887,1266,248,67,5145
7/1/2021,VA,Virginia,Cumberland,51049,2423,1615,808,2044,12,2032,379,*,*,2253,1446,807,1850,1116,734,446,100,20,1284
7/1/2021,VA,Virginia,Danville City,51590,11121,6443,4678,8945,91,8854,2176,110,2066,10441,5763,4678,9099,5312,3787,3249,425,112,5313
7/1/2021,VA,Virginia,Dickenson,51051,4854,1999,2855,3316,11,3305,1538,*,*,4679,1824,2855,4027,1493,2534,1106,210,52,2659
7/1/2021,VA,Virginia,Dinwiddie,51053,6199,4163,2036,5172,31,5141,1027,30,997,5742,3706,2036,4497,2574,1923,921,215,42,3319
7/1/2021,VA,Virginia,Emporia City,51595,1298,754,544,1049,13,1036,249,*,*,1219,675,544,1039,544,495,445,69,11,514
7/1/2021,VA,Virginia,Essex,51057,3060,2135,925,2644,18,2626,416,15,401,2847,1922,925,2243,1458,785,479,86,28,1650
7/1/2021,VA,Virginia,Fairfax,51059,161942,122599,39343,154135,612,153523,7807,391,7416,131486,92162,39324,83072,49103,33969,14750,2712,522,65088
7/1/2021,VA,Virginia,Fairfax City,51600,4080,3048,1032,3839,14,3825,241,11,230,3415,2384,1031,2282,1420,862,399,67,13,1803
7/1/2021,VA,Virginia,Falls Church City,51610,2185,1728,457,2116,*,*,69,*,*,1741,1284,457,1143,734,409,131,*,*,1000
7/1/2021,VA,Virginia,Fauquier,51061,13533,10952,2581,12535,80,12455,998,34,964,12013,9432,2581,8272,6262,2010,1006,189,56,7021
7/1/2021,VA,Virginia,Floyd,51063,4323,3075,1248,3804,13,3791,519,*,*,4039,2792,1247,3304,2131,1173,632,108,27,2537
7/1/2021,VA,Virginia,Fluvanna,51065,6575,5211,1364,5954,26,5928,621,16,605,5992,4628,1364,4574,3421,1153,602,122,27,3823
7/1/2021,VA,Virginia,Franklin,51067,15644,10076,5568,13467,63,13404,2177,34,2143,14764,9196,5568,12349,7291,5058,2086,470,118,9675
7/1/2021,VA,Virginia,Franklin City,51620,2189,1527,662,1808,19,1789,381,21,360,2059,1397,662,1708,1089,619,543,*,*,1082
7/1/2021,VA,Virginia,Frederick,51069,18033,13969,4064,16308,71,16237,1725,44,1681,16433,12371,4062,11945,8548,3397,1506,382,111,9946
7/1/2021,VA,Virginia,Fredericksburg City,51630,4303,3187,1116,3649,20,3629,654,25,629,3821,2705,1116,2745,1726,1019,819,82,25,1819
7/1/2021,VA,Virginia,Galax City,51640,1731,1322,409,1413,*,*,318,*,*,1646,1237,409,1395,1017,378,557,60,20,758
7/1/2021,VA,Virginia,Giles,51071,4616,3143,1473,3767,20,3747,849,17,832,4360,2887,1473,3688,2488,1200,770,107,30,2781
7/1/2021,VA,Virginia,Gloucester,51073,9292,7016,2276,8186,51,8135,1106,23,1083,8586,6311,2275,5777,3753,2024,1022,189,48,4518
7/1/2021,VA,Virginia,Goochland,51075,6556,4884,1672,6086,32,6054,470,12,458,6022,4350,1672,5113,3665,1448,451,103,20,4539
7/1/2021,VA,Virginia,Grayson,51077,4694,3294,1400,3953,14,3939,741,*,*,4487,3087,1400,3603,2289,1314,934,170,67,2432
7/1/2021,VA,Virginia,Greene,51079,4224,3366,858,3746,19,3727,478,11,467,3838,2980,858,2909,2132,777,467,92,15,2335
7/1/2021,VA,Virginia,Greensville,51081,2155,1288,867,1765,22,1743,390,12,378,2009,1142,867,1682,911,771,460,107,18,1097
7/1/2021,VA,Virginia,Halifax,51083,9992,7207,2785,8402,49,8353,1590,55,1535,9393,6608,2785,7771,5196,2575,2102,400,115,5154
7/1/2021,VA,Virginia,Hampton City,51650,26412,16928,9484,22221,224,21997,4191,212,3979,24087,14605,9482,15747,6848,8899,4146,791,140,10670
7/1/2021,VA,Virginia,Hanover,51085,23273,16256,7017,21442,100,21342,1831,54,1777,21309,14295,7014,17732,11680,6052,1533,328,72,15799
7/1/2021,VA,Virginia,Harrisonburg City,51660,5608,4438,1170,4801,21,4780,807,20,787,5109,3939,1170,4180,3126,1054,997,145,39,2999
7/1/2021,VA,Virginia,Henrico,51087,60475,39673,20802,53784,399,53385,6691,290,6401,54982,34180,20802,46394,27547,18847,7013,1417,286,37678
7/1/2021,VA,Virginia,Henry,51089,14890,8714,6176,12087,89,11998,2803,75,2728,14196,8021,6175,12414,6598,5816,2987,741,178,8508
7/1/2021,VA,Virginia,Highland,51091,850,705,145,778,*,*,72,0,72,800,655,145,628,501,127,63,*,*,540
7/1/2021,VA,Virginia,Hopewell City,51670,4549,2956,1593,3605,30,3575,944,27,917,4227,2634,1593,3116,1591,1525,1055,161,27,1873
7/1/2021,VA,Virginia,Isle of Wight,51093,9019,6473,2546,8047,46,8001,972,34,938,8356,5810,2546,6067,3706,2361,994,203,61,4809
7/1/2021,VA,Virginia,James City,51095,22328,17934,4394,21064,73,20991,1264,32,1232,20694,16304,4390,13860,10352,3508,1005,226,46,12583
7/1/2021,VA,Virginia,King and Queen,51097,1838,1321,517,1593,*,*,245,*,*,1718,1201,517,1340,879,461,273,*,*,993
7/1/2021,VA,Virginia,King George,51099,4330,3480,850,3821,23,3798,509,18,491,3758,2908,850,2061,1295,766,482,74,21,1484
7/1/2021,VA,Virginia,King William,51101,3718,2684,1034,3234,34,3200,484,27,457,3452,2418,1034,2872,1931,941,436,100,18,2318
7/1/2021,VA,Virginia,Lancaster,51103,4438,3461,977,4133,24,4109,305,12,293,4166,3190,976,3157,2396,761,486,96,11,2564
7/1/2021,VA,Virginia,Lee,51105,6419,2613,3806,4638,14,4624,1781,16,1765,6127,2323,3804,5179,1753,3426,1931,234,56,2958
7/1/2021,VA,Virginia,Lexington City,51678,1331,1062,269,1222,*,*,109,*,*,1233,965,268,984,743,241,168,*,*,776
7/1/2021,VA,Virginia,Loudoun,51107,43275,32599,10676,40883,182,40701,2392,128,2264,36086,25417,10669,25288,16073,9215,3729,691,146,20722
7/1/2021,VA,Virginia,Louisa,51109,9187,6624,2563,7946,52,7894,1241,34,1207,8418,5855,2563,6504,4215,2289,1195,262,49,4998
7/1/2021,VA,Virginia,Lunenburg,51111,3241,2304,937,2737,20,2717,504,*,*,3032,2095,937,2403,1532,871,762,119,36,1486
7/1/2021,VA,Virginia,Lynchburg City,51680,14769,10096,4673,12332,93,12239,2437,99,2338,13770,9097,4673,11606,7273,4333,2941,442,118,8105
7/1/2021,VA,Virginia,Madison,51113,3447,2703,744,3109,11,3098,338,*,*,3204,2460,744,2445,1818,627,416,84,15,1930
7/1/2021,VA,Virginia,Manassas City,51683,4904,3494,1410,4409,24,4385,495,38,457,4149,2739,1410,3025,1781,1244,535,109,25,2356
7/1/2021,VA,Virginia,Manassas Park City,51685,1413,884,529,1238,13,1225,175,11,164,1197,668,529,892,404,488,231,*,*,595
7/1/2021,VA,Virginia,Martinsville City,51690,3802,2187,1615,2918,39,2879,884,33,851,3602,1987,1615,3168,1608,1560,1233,184,41,1710
7/1/2021,VA,Virginia,Mathews,51115,2972,2277,695,2741,11,2730,231,*,*,2806,2111,695,2106,1519,587,293,38,18,1757
7/1/2021,VA,Virginia,Mecklenburg,51117,9517,6644,2873,8082,49,8033,1435,59,1376,8960,6087,2873,7286,4700,2586,1802,390,83,5011
7/1/2021,VA,Virginia,Middlesex,51119,3764,2868,896,3431,16,3415,333,*,*,3547,2651,896,2774,2026,748,450,79,17,2228
7/1/2021,VA,Virginia,Montgomery,51121,14641,10787,3854,12495,65,12430,2146,32,2114,13197,9343,3854,11182,7648,3534,1947,342,86,8807
7/1/2021,VA,Virginia,Nelson,51125,4892,3769,1123,4442,15,4427,450,*,*,4552,3430,1122,3464,2486,978,577,115,24,2748
7/1/2021,VA,Virginia,New Kent,51127,5172,3838,1334,4691,24,4667,481,16,465,4722,3388,1334,3492,2395,1097,326,83,16,3067
7/1/2021,VA,Virginia,Newport News City,51700,29911,19019,10892,25092,223,24869,4819,229,4590,27370,16479,10891,18906,8571,10335,5322,913,170,12501
7/1/2021,VA,Virginia,Norfolk City,51710,34547,21607,12940,28539,296,28243,6008,311,5697,31130,18192,12938,22155,9847,12308,7572,1350,227,13006
7/1/2021,VA,Virginia,Northampton,51131,3876,2738,1138,3442,21,3421,434,17,417,3630,2492,1138,2974,1952,1022,882,88,27,1977
7/1/2021,VA,Virginia,Northumberland,51133,4807,3737,1070,4477,*,*,330,11,319,4491,3421,1070,3188,2372,816,444,87,25,2632
7/1/2021,VA,Virginia,Norton City,51720,1114,539,575,791,*,*,323,*,*,1047,473,574,906,388,518,333,*,*,511
7/1/2021,VA,Virginia,Nottoway,51135,3628,2511,1117,3032,26,3006,596,16,580,3382,2265,1117,2722,1730,992,831,134,37,1720
7/1/2021,VA,Virginia,Orange,51137,9119,6983,2136,8159,50,8109,960,35,925,8359,6223,2136,5943,4189,1754,984,207,48,4704
7/1/2021,VA,Virginia,Page,51139,6432,4949,1483,5404,16,5388,1028,19,1009,6016,4533,1483,4610,3287,1323,1103,238,54,3215
7/1/2021,VA,Virginia,Patrick,51141,5539,3658,1881,4679,11,4668,860,11,849,5271,3391,1880,4387,2672,1715,1031,200,59,3097
7/1/2021,VA,Virginia,Petersburg City,51730,7226,4154,3072,5513,89,5424,1713,78,1635,6599,3527,3072,5156,2178,2978,2183,330,50,2593
7/1/2021,VA,Virginia,Pittsylvania,51143,16810,10435,6375,14167,110,14057,2643,67,2576,15857,9482,6375,13549,8449,5100,3001,554,141,9853
7/1/2021,VA,Virginia,Poquoson City,51735,2651,2175,476,2480,*,*,171,*,*,2437,1961,476,1356,925,431,115,*,*,1204
7/1/2021,VA,Virginia,Portsmouth City,51740,18680,11680,7000,14971,193,14778,3709,197,3512,16844,9844,7000,11796,5106,6690,4166,717,104,6809
7/1/2021,VA,Virginia,Powhatan,51145,6627,4881,1746,6060,15,6045,567,14,553,6123,4377,1746,5063,3519,1544,409,113,25,4516
7/1/2021,VA,Virginia,Prince Edward,51147,4805,3323,1482,3984,34,3950,821,27,794,4447,2965,1482,3604,2261,1343,1054,165,41,2344
7/1/2021,VA,Virginia,Prince George,51149,6557,5089,1468,5616,35,5581,941,32,909,6084,4616,1468,3928,2592,1336,635,137,28,3128
7/1/2021,VA,Virginia,Prince William,51153,53895,39408,14487,48990,319,48671,4905,294,4611,46096,31612,14484,28312,15289,13023,5601,1227,200,21284
7/1/2021,VA,Virginia,Pulaski,51155,9254,6592,2662,7559,31,7528,1695,29,1666,8653,5991,2662,7249,4857,2392,1570,279,71,5329
7/1/2021,VA,Virginia,Radford City,51750,2108,1519,589,1748,*,*,360,*,*,1900,1311,589,1643,1094,549,336,47,18,1242
7/1/2021,VA,Virginia,Rappahannock,51157,2083,1733,350,1955,*,*,128,*,*,1883,1534,349,1357,1085,272,162,36,11,1148
7/1/2021,VA,Virginia,Richmond,51159,2009,1449,560,1766,*,*,243,*,*,1871,1311,560,1453,1004,449,331,70,11,1041
7/1/2021,VA,Virginia,Richmond City,51760,34921,19730,15191,28633,277,28356,6288,294,5994,31603,16414,15189,27484,13018,14466,8934,1317,235,16998
7/1/2021,VA,Virginia,Roanoke,51161,24519,17016,7503,22005,112,21893,2514,55,2459,22704,15204,7500,18856,12226,6630,2099,472,118,16167
7/1/2021,VA,Virginia,Roanoke City,51770,21388,12645,8743,16871,160,16711,4517,137,4380,19592,10850,8742,16478,8294,8184,4800,920,169,10589
7/1/2021,VA,Virginia,Rockbridge,51163,6608,4961,1647,5745,*,*,863,*,*,6148,4501,1647,4774,3312,1462,847,173,49,3705
7/1/2021,VA,Virginia,Rockingham,51165,18805,15133,3672,16804,50,16754,2001,40,1961,17467,13795,3672,14261,11027,3234,1798,508,125,11830
7/1/2021,VA,Virginia,Russell,51167,8052,4019,4033,5886,17,5869,2166,20,2146,7734,3702,4032,6798,3382,3416,1713,337,112,4636
7/1/2021,VA,Virginia,Salem City,51775,6160,4382,1778,5301,28,5273,859,15,844,5670,3892,1778,4667,3035,1632,816,129,40,3682
7/1/2021,VA,Virginia,Scott,51169,6763,2541,4222,5254,13,5241,1509,12,1497,6489,2267,4222,5771,1762,4009,1519,262,85,3905
7/1/2021,VA,Virginia,Shenandoah,51171,11052,8418,2634,9931,28,9903,1121,18,1103,10360,7727,2633,7765,5517,2248,1261,257,76,6171
7/1/2021,VA,Virginia,Smyth,51173,8678,5277,3401,6678,26,6652,2000,28,1972,8247,4846,3401,6990,3742,3248,2055,352,117,4466
7/1/2021,VA,Virginia,Southampton,51175,4147,3015,1132,3551,29,3522,596,24,572,3850,2718,1132,3081,2055,1026,684,137,28,2232
7/1/2021,VA,Virginia,Spotsylvania,51177,23614,17464,6150,20924,127,20797,2690,99,2591,20984,14835,6149,13519,8097,5422,2251,540,110,10618
7/1/2021,VA,Virginia,Stafford,51179,19587,15438,4149,17617,113,17504,1970,93,1877,17185,13039,4146,9429,5795,3634,1603,390,64,7372
7/1/2021,VA,Virginia,Staunton City,51790,6373,4853,1520,5423,27,5396,950,14,936,6007,4487,1520,4868,3480,1388,1089,161,45,3573
7/1/2021,VA,Virginia,Suffolk City,51800,17867,12316,5551,15062,141,14921,2805,112,2693,16393,10842,5551,11440,6283,5157,2843,511,84,8002
7/1/2021,VA,Virginia,Surry,51181,1810,1223,587,1578,13,1565,232,*,*,1676,1089,587,1273,715,558,234,51,12,976
7/1/2021,VA,Virginia,Sussex,51183,2559,1651,908,2116,28,2088,443,14,429,2385,1477,908,1906,1043,863,517,137,19,1233
7/1/2021,VA,Virginia,Tazewell,51185,11983,6749,5234,9191,37,9154,2792,37,2755,11422,6190,5232,9396,5270,4126,2307,485,111,6493
7/1/2021,VA,Virginia,Unknown,51999,*,*,*,*,*,*,*,*,*,*,*,*,*,*,*,*,*,*,*
7/1/2021,VA,Virginia,Virginia Beach City,51810,77625,57827,19798,69530,390,69140,8095,322,7773,71160,51372,19788,43132,25076,18056,7355,1565,337,33875
7/1/2021,VA,Virginia,Warren,51187,8395,6496,1899,7418,30,7388,977,28,949,7628,5729,1899,5478,3896,1582,940,236,59,4243
7/1/2021,VA,Virginia,Washington,51191,15653,8633,7020,12987,39,12948,2666,33,2633,14812,7793,7019,12547,6029,6518,2398,628,153,9368
7/1/2021,VA,Virginia,Waynesboro City,51820,5102,3823,1279,4286,24,4262,816,23,793,4793,3514,1279,3921,2716,1205,895,124,40,2862
7/1/2021,VA,Virginia,Westmoreland,51193,5357,4090,1267,4797,27,4770,560,16,544,4869,3602,1267,3319,2197,1122,830,142,37,2310
7/1/2021,VA,Virginia,Williamsburg City,51830,2940,2259,681,2701,11,2690,239,*,*,2725,2044,681,1998,1408,590,292,*,*,1661
7/1/2021,VA,Virginia,Winchester City,51840,5648,4363,1285,4914,26,4888,734,20,714,5156,3871,1285,3899,2790,1109,900,146,34,2819
7/1/2021,VA,Virginia,Wise,51195,10603,4493,6110,7527,29,7498,3076,23,3053,10036,3926,6110,8380,3076,5304,2373,487,137,5383
7/1/2021,VA,Virginia,Wythe,51197,8015,5136,2879,6415,37,6378,1600,14,1586,7594,4715,2879,6365,3731,2634,1623,309,79,4354
7/1/2021,VA,Virginia,York,51199,12961,10419,2542,12025,46,11979,936,39,897,11845,9303,2542,6607,4381,2226,739,161,33,5674
6/1/2021,VA,Virginia,Accomack,51001,9398,6985,2413,8279,51,8228,1119,42,1077,8689,6279,2410,6579,4514,2065,1512,372,74,4621
6/1/2021,VA,Virginia,Albemarle,51003,22937,19263,3674,21387,59,21328,1550,46,1504,20711,17039,3672,16431,13272,3159,1656,306,82,14387
6/1/2021,VA,Virginia,Alexandria City,51510,18659,14480,4179,17397,72,17325,1262,66,1196,15074,10896,4178,9795,5994,3801,2135,320,52,7288
6/1/2021,VA,Virginia,Alleghany,51005,4615,3347,1268,3802,22,3780,813,*,*,4379,3111,1268,3639,2544,1095,809,112,35,2683
6/1/2021,VA,Virginia,Amelia,51007,3236,2122,1114,2809,*,*,427,*,*,2990,1876,1114,2450,1407,1043,447,86,23,1894
6/1/2021,VA,Virginia,Amherst,51009,8106,5626,2480,6892,55,6837,1214,32,1182,7534,5054,2480,6279,4000,2279,1256,220,68,4735
6/1/2021,VA,Virginia,Appomattox,51011,4171,2887,1284,3450,17,3433,721,21,700,3918,2634,1284,3290,2098,1192,778,113,39,2360
6/1/2021,VA,Virginia,Arlington,51013,25540,20316,5224,24045,104,23941,1495,77,1418,20116,14893,5223,12960,8157,4803,3016,406,111,9427
6/1/2021,VA,Virginia,Augusta,51015,19237,14957,4280,16969,68,16901,2268,49,2219,18047,13767,4280,14573,10662,3911,1910,416,126,12121
6/1/2021,VA,Virginia,Bath,51017,1298,1073,225,1146,*,*,152,*,*,1228,1003,225,996,790,206,167,*,*,790
6/1/2021,VA,Virginia,Bedford,51019,20866,15323,5543,18305,78,18227,2561,47,2514,19439,13897,5542,15779,11113,4666,2051,492,143,13093
6/1/2021,VA,Virginia,Bland,51021,1835,1238,597,1489,*,*,346,*,*,1731,1134,597,1379,908,471,229,58,14,1078
6/1/2021,VA,Virginia,Botetourt,51023,9085,6321,2764,8083,52,8031,1002,21,981,8429,5665,2764,6865,4452,2413,728,173,39,5925
6/1/2021,VA,Virginia,Bristol City,51520,4493,2079,2414,3594,*,*,899,15,884,4216,1802,2414,3668,1341,2327,1094,156,37,2381
6/1/2021,VA,Virginia,Brunswick,51025,4105,2746,1359,3488,32,3456,617,17,600,3829,2470,1359,3133,1889,1244,1046,123,34,1930
6/1/2021,VA,Virginia,Buchanan,51027,7027,3250,3777,4743,22,4721,2284,14,2270,6794,3017,3777,5905,2876,3029,1597,387,83,3838
6/1/2021,VA,Virginia,Buckingham,51029,3787,2691,1096,3154,21,3133,633,17,616,3531,2435,1096,2818,1906,912,772,143,40,1863
6/1/2021,VA,Virginia,Buena Vista City,51530,1500,1061,439,1243,*,*,257,*,*,1400,961,439,1120,729,391,303,61,13,743
6/1/2021,VA,Virginia,Campbell,51031,13436,9345,4091,11401,83,11318,2035,55,1980,12590,8499,4091,10517,6790,3727,2094,399,117,7907
6/1/2021,VA,Virginia,Caroline,51033,6293,4406,1887,5437,37,5400,856,29,827,5692,3805,1887,4094,2391,1703,866,207,31,2990
6/1/2021,VA,Virginia,Carroll,51035,8632,6379,2253,7281,35,7246,1351,18,1333,8217,5964,2253,6613,4617,1996,1555,285,93,4680
6/1/2021,VA,Virginia,Charles City,51036,2010,1327,683,1758,19,1739,252,*,*,1832,1149,683,1462,849,613,250,*,*,1120
6/1/2021,VA,Virginia,Charlotte,51037,3258,2338,920,2735,21,2714,523,15,508,3054,2134,920,2511,1661,850,698,129,34,1650
6/1/2021,VA,Virginia,Charlottesville City,51540,6458,5163,1295,5554,28,5526,904,34,870,5791,4497,1294,4821,3611,1210,1196,158,29,3438
6/1/2021,VA,Virginia,Chesapeake City,51550,41207,29207,12000,36306,295,36011,4901,200,4701,37211,25213,11998,23693,12823,10870,4328,976,174,18215
6/1/2021,VA,Virginia,Chesterfield,51041,65863,45669,20194,58858,285,58573,7005,243,6762,59582,39392,20190,47840,29408,18432,5949,1054,223,40614
6/1/2021,VA,Virginia,Clarke,51043,3575,2878,697,3326,*,*,249,*,*,3223,2526,697,2354,1783,571,298,76,27,1953
6/1/2021,VA,Virginia,Colonial Heights City,51570,4146,3096,1050,3586,17,3569,560,*,*,3818,2768,1050,2653,1692,961,518,103,19,2013
6/1/2021,VA,Virginia,Covington City,51580,1558,1137,421,1203,12,1191,355,*,*,1453,1032,421,1216,814,402,337,*,*,822
6/1/2021,VA,Virginia,Craig,51045,1397,925,472,1130,*,*,267,*,*,1301,829,472,1075,647,428,198,*,*,817
6/1/2021,VA,Virginia,Culpeper,51047,10121,7821,2300,8962,40,8922,1159,33,1126,9160,6860,2300,6690,4836,1854,1259,244,68,5119
6/1/2021,VA,Virginia,Cumberland,51049,2418,1615,803,2044,13,2031,374,*,*,2242,1440,802,1847,1118,729,443,99,20,1285
6/1/2021,VA,Virginia,Danville City,51590,11110,6466,4644,8937,93,8844,2173,111,2062,10419,5775,4644,9093,5337,3756,3240,424,112,5317
6/1/2021,VA,Virginia,Dickenson,51051,4854,2015,2839,3324,11,3313,1530,*,*,4668,1829,2839,4025,1507,2518,1105,209,54,2657
6/1/2021,VA,Virginia,Dinwiddie,51053,6169,4156,2013,5144,31,5113,1025,30,995,5710,3697,2013,4474,2572,1902,917,212,42,3303
6/1/2021,VA,Virginia,Emporia City,51595,1295,755,540,1045,13,1032,250,*,*,1216,676,540,1036,546,490,437,73,11,515
6/1/2021,VA,Virginia,Essex,51057,3059,2145,914,2644,18,2626,415,15,400,2842,1928,914,2243,1468,775,480,87,27,1649
6/1/2021,VA,Virginia,Fairfax,51059,161253,122292,38961,153476,618,152858,7777,391,7386,130260,91318,38942,82554,48961,33593,14677,2717,517,64643
6/1/2021,VA,Virginia,Fairfax City,51600,4066,3038,1028,3827,14,3813,239,12,227,3400,2373,1027,2276,1418,858,392,69,14,1801
6/1/2021,VA,Virginia,Falls Church City,51610,2179,1727,452,2110,*,*,69,*,*,1726,1274,452,1134,730,404,132,*,*,990
6/1/2021,VA,Virginia,Fauquier,51061,13483,10931,2552,12489,81,12408,994,35,959,11935,9383,2552,8243,6263,1980,1005,186,56,6996
6/1/2021,VA,Virginia,Floyd,51063,4314,3068,1246,3797,14,3783,517,*,*,4017,2772,1245,3295,2124,1171,625,108,27,2535
6/1/2021,VA,Virginia,Fluvanna,51065,6558,5196,1362,5940,26,5914,618,16,602,5961,4599,1362,4554,3403,1151,595,120,27,3812
6/1/2021,VA,Virginia,Franklin,51067,15588,10058,5530,13426,63,13363,2162,34,2128,14683,9153,5530,12287,7264,5023,2062,475,119,9631
6/1/2021,VA,Virginia,Franklin City,51620,2189,1528,661,1807,23,1784,382,21,361,2061,1400,661,1716,1098,618,544,*,*,1091
6/1/2021,VA,Virginia,Frederick,51069,17979,13933,4046,16266,71,16195,1713,44,1669,16345,12301,4044,11889,8511,3378,1497,380,111,9901
6/1/2021,VA,Virginia,Fredericksburg City,51630,4303,3197,1106,3648,21,3627,655,26,629,3803,2697,1106,2736,1725,1011,820,84,24,1808
6/1/2021,VA,Virginia,Galax City,51640,1730,1320,410,1411,*,*,319,*,*,1640,1230,410,1393,1017,376,554,60,20,759
6/1/2021,VA,Virginia,Giles,51071,4615,3148,1467,3766,20,3746,849,17,832,4357,2890,1467,3686,2494,1192,769,107,31,2779
6/1/2021,VA,Virginia,Gloucester,51073,9268,7012,2256,8166,52,8114,1102,24,1078,8545,6290,2255,5765,3759,2006,1020,189,48,4508
6/1/2021,VA,Virginia,Goochland,51075,6537,4882,1655,6069,33,6036,468,12,456,5999,4344,1655,5095,3664,1431,449,102,21,4523
6/1/2021,VA,Virginia,Grayson,51077,4702,3309,1393,3966,15,3951,736,*,*,4484,3091,1393,3597,2290,1307,935,174,67,2421
6/1/2021,VA,Virginia,Greene,51079,4218,3373,845,3742,19,3723,476,11,465,3816,2971,845,2893,2128,765,465,90,15,2323
6/1/2021,VA,Virginia,Greensville,51081,2150,1292,858,1762,22,1740,388,12,376,1998,1140,858,1672,910,762,456,104,18,1094
6/1/2021,VA,Virginia,Halifax,51083,9985,7253,2732,8394,52,8342,1591,55,1536,9368,6636,2732,7751,5226,2525,2099,402,114,5136
6/1/2021,VA,Virginia,Hampton City,51650,26340,16942,9398,22155,226,21929,4185,212,3973,23952,14556,9396,15680,6862,8818,4131,784,136,10629
6/1/2021,VA,Virginia,Hanover,51085,23183,16211,6972,21359,101,21258,1824,52,1772,21168,14199,6969,17636,11626,6010,1531,326,72,15707
6/1/2021,VA,Virginia,Harrisonburg City,51660,5601,4438,1163,4796,21,4775,805,21,784,5090,3927,1163,4166,3120,1046,996,143,39,2988
6/1/2021,VA,Virginia,Henrico,51087,60372,39668,20704,53696,404,53292,6676,292,6384,54717,34013,20704,46255,27502,18753,6977,1425,282,37571
6/1/2021,VA,Virginia,Henry,51089,14876,8751,6125,12083,91,11992,2793,74,2719,14160,8036,6124,12400,6628,5772,2963,744,180,8513
6/1/2021,VA,Virginia,Highland,51091,849,707,142,777,*,*,72,0,72,796,654,142,624,500,124,63,*,*,536
6/1/2021,VA,Virginia,Hopewell City,51670,4545,2965,1580,3603,30,3573,942,27,915,4209,2629,1580,3110,1600,1510,1047,159,26,1878
6/1/2021,VA,Virginia,Isle of Wight,51093,9002,6469,2533,8031,46,7985,971,33,938,8334,5801,2533,6056,3704,2352,988,202,60,4806
6/1/2021,VA,Virginia,James City,51095,22281,17917,4364,21024,73,20951,1257,31,1226,20614,16254,4360,13806,10327,3479,1004,222,45,12535
6/1/2021,VA,Virginia,King and Queen,51097,1835,1318,517,1590,*,*,245,*,*,1712,1195,517,1338,877,461,271,*,*,991
6/1/2021,VA,Virginia,King George,51099,4317,3474,843,3807,23,3784,510,18,492,3738,2895,843,2054,1295,759,483,73,20,1478
6/1/2021,VA,Virginia,King William,51101,3715,2685,1030,3235,34,3201,480,27,453,3441,2411,1030,2866,1929,937,433,102,19,2312
6/1/2021,VA,Virginia,Lancaster,51103,4427,3461,966,4126,24,4102,301,12,289,4149,3184,965,3152,2402,750,485,95,11,2561
6/1/2021,VA,Virginia,Lee,51105,6418,2634,3784,4639,14,4625,1779,16,1763,6112,2330,3782,5166,1762,3404,1927,234,56,2949
6/1/2021,VA,Virginia,Lexington City,51678,1337,1068,269,1229,*,*,108,*,*,1230,962,268,983,743,240,169,*,*,775
6/1/2021,VA,Virginia,Loudoun,51107,43069,32496,10573,40688,184,40504,2381,127,2254,35756,25190,10566,25135,16032,9103,3694,688,144,20609
6/1/2021,VA,Virginia,Louisa,51109,9131,6595,2536,7898,54,7844,1233,33,1200,8336,5800,2536,6447,4181,2266,1184,261,49,4953
6/1/2021,VA,Virginia,Lunenburg,51111,3231,2313,918,2730,21,2709,501,*,*,3013,2095,918,2388,1537,851,755,118,37,1478
6/1/2021,VA,Virginia,Lynchburg City,51680,14723,10093,4630,12301,93,12208,2422,98,2324,13692,9062,4630,11552,7260,4292,2919,445,116,8072
6/1/2021,VA,Virginia,Madison,51113,3443,2703,740,3106,11,3095,337,*,*,3192,2452,740,2438,1816,622,411,84,15,1928
6/1/2021,VA,Virginia,Manassas City,51683,4886,3484,1402,4392,24,4368,494,38,456,4118,2716,1402,3007,1773,1234,535,109,25,2338
6/1/2021,VA,Virginia,Manassas Park City,51685,1404,884,520,1231,13,1218,173,11,162,1182,662,520,890,411,479,231,*,*,593
6/1/2021,VA,Virginia,Martinsville City,51690,3797,2191,1606,2916,40,2876,881,32,849,3591,1985,1606,3164,1614,1550,1231,185,40,1708
6/1/2021,VA,Virginia,Mathews,51115,2973,2278,695,2743,11,2732,230,*,*,2798,2103,695,2105,1520,585,292,40,19,1754
6/1/2021,VA,Virginia,Mecklenburg,51117,9520,6670,2850,8089,50,8039,1431,60,1371,8946,6096,2850,7284,4721,2563,1804,385,82,5013
6/1/2021,VA,Virginia,Middlesex,51119,3762,2876,886,3430,17,3413,332,*,*,3531,2645,886,2772,2034,738,449,80,16,2227
6/1/2021,VA,Virginia,Montgomery,51121,14619,10786,3833,12476,67,12409,2143,33,2110,13146,9313,3833,11144,7632,3512,1939,343,84,8778
6/1/2021,VA,Virginia,Nelson,51125,4882,3771,1111,4436,15,4421,446,*,*,4533,3423,1110,3455,2487,968,570,115,23,2747
6/1/2021,VA,Virginia,New Kent,51127,5158,3832,1326,4682,24,4658,476,15,461,4704,3378,1326,3473,2384,1089,323,83,17,3050
6/1/2021,VA,Virginia,Newport News City,51700,29839,19032,10807,25028,227,24801,4811,232,4579,27217,16411,10806,18832,8573,10259,5297,910,168,12457
6/1/2021,VA,Virginia,Norfolk City,51710,34429,21639,12790,28459,303,28156,5970,309,5661,30896,18108,12788,22058,9889,12169,7508,1347,223,12980
6/1/2021,VA,Virginia,Northampton,51131,3862,2729,1133,3431,21,3410,431,17,414,3612,2479,1133,2964,1947,1017,880,88,27,1969
6/1/2021,VA,Virginia,Northumberland,51133,4793,3723,1070,4465,*,*,328,11,317,4470,3400,1070,3184,2369,815,439,88,25,2632
6/1/2021,VA,Virginia,Norton City,51720,1112,539,573,791,*,*,321,*,*,1041,469,572,902,386,516,333,*,*,507
6/1/2021,VA,Virginia,Nottoway,51135,3624,2518,1106,3029,26,3003,595,16,579,3373,2267,1106,2722,1739,983,836,132,38,1716
6/1/2021,VA,Virginia,Orange,51137,9104,6998,2106,8147,50,8097,957,34,923,8316,6210,2106,5926,4200,1726,976,205,48,4697
6/1/2021,VA,Virginia,Page,51139,6419,4950,1469,5398,16,5382,1021,18,1003,5994,4525,1469,4589,3280,1309,1096,241,54,3198
6/1/2021,VA,Virginia,Patrick,51141,5527,3666,1861,4673,12,4661,854,*,*,5254,3394,1860,4374,2682,1692,1028,198,59,3089
6/1/2021,VA,Virginia,Petersburg City,51730,7214,4166,3048,5510,91,5419,1704,75,1629,6569,3521,3048,5151,2196,2955,2168,333,49,2601
6/1/2021,VA,Virginia,Pittsylvania,51143,16779,10458,6321,14143,112,14031,2636,67,2569,15804,9483,6321,13518,8465,5053,2994,554,140,9830
6/1/2021,VA,Virginia,Poquoson City,51735,2642,2169,473,2472,*,*,170,*,*,2429,1956,473,1352,924,428,117,*,*,1198
6/1/2021,VA,Virginia,Portsmouth City,51740,18658,11712,6946,14954,195,14759,3704,200,3504,16746,9800,6946,11766,5126,6640,4141,717,99,6809
6/1/2021,VA,Virginia,Powhatan,51145,6612,4876,1736,6047,15,6032,565,14,551,6099,4363,1736,5048,3513,1535,408,113,25,4502
6/1/2021,VA,Virginia,Prince Edward,51147,4793,3320,1473,3974,35,3939,819,27,792,4426,2953,1473,3598,2263,1335,1050,165,41,2342
6/1/2021,VA,Virginia,Prince George,51149,6547,5097,1450,5607,37,5570,940,32,908,6056,4606,1450,3919,2599,1320,637,136,26,3120
6/1/2021,VA,Virginia,Prince William,51153,53681,39389,14292,48794,322,48472,4887,296,4591,45644,31355,14289,28109,15268,12841,5535,1227,201,21146
6/1/2021,VA,Virginia,Pulaski,51155,9232,6598,2634,7547,32,7515,1685,29,1656,8627,5993,2634,7226,4860,2366,1558,278,70,5320
6/1/2021,VA,Virginia,Radford City,51750,2111,1527,584,1751,*,*,360,*,*,1904,1320,584,1640,1096,544,334,46,19,1241
6/1/2021,VA,Virginia,Rappahannock,51157,2077,1728,349,1948,*,*,129,*,*,1864,1516,348,1351,1081,270,161,36,11,1143
6/1/2021,VA,Virginia,Richmond,51159,2003,1442,561,1760,*,*,243,*,*,1860,1299,561,1444,994,450,326,69,11,1038
6/1/2021,VA,Virginia,Richmond City,51760,34861,19780,15081,28580,282,28298,6281,298,5983,31441,16363,15078,27414,13047,14367,8876,1328,237,16973
6/1/2021,VA,Virginia,Roanoke,51161,24507,17025,7482,22004,115,21889,2503,55,2448,22651,15172,7479,18812,12199,6613,2103,471,118,16120
6/1/2021,VA,Virginia,Roanoke City,51770,21359,12660,8699,16854,163,16691,4505,137,4368,19523,10825,8698,16436,8295,8141,4784,921,167,10564
6/1/2021,VA,Virginia,Rockbridge,51163,6596,4954,1642,5735,*,*,861,11,850,6120,4478,1642,4756,3299,1457,849,175,47,3685
6/1/2021,VA,Virginia,Rockingham,51165,18787,15157,3630,16794,52,16742,1993,38,1955,17406,13776,3630,14217,11021,3196,1810,509,126,11772
6/1/2021,VA,Virginia,Russell,51167,8045,4015,4030,5885,17,5868,2160,20,2140,7719,3690,4029,6793,3382,3411,1706,340,108,4639
6/1/2021,VA,Virginia,Salem City,51775,6145,4376,1769,5290,28,5262,855,15,840,5646,3877,1769,4650,3028,1622,810,129,40,3671
6/1/2021,VA,Virginia,Scott,51169,6765,2537,4228,5260,13,5247,1505,12,1493,6495,2267,4228,5776,1760,4016,1519,257,86,3914
6/1/2021,VA,Virginia,Shenandoah,51171,11041,8421,2620,9922,29,9893,1119,18,1101,10334,7715,2619,7759,5526,2233,1257,256,75,6171
6/1/2021,VA,Virginia,Smyth,51173,8694,5311,3383,6692,26,6666,2002,28,1974,8255,4872,3383,6995,3763,3232,2050,358,117,4470
6/1/2021,VA,Virginia,Southampton,51175,4133,3007,1126,3539,30,3509,594,24,570,3824,2698,1126,3070,2051,1019,680,138,28,2224
6/1/2021,VA,Virginia,Spotsylvania,51177,23510,17415,6095,20840,129,20711,2670,99,2571,20834,14740,6094,13456,8086,5370,2230,542,110,10574
6/1/2021,VA,Virginia,Stafford,51179,19522,15420,4102,17553,115,17438,1969,93,1876,17060,12961,4099,9373,5781,3592,1591,394,61,7327
6/1/2021,VA,Virginia,Staunton City,51790,6361,4861,1500,5414,27,5387,947,13,934,5975,4475,1500,4848,3480,1368,1086,161,45,3556
6/1/2021,VA,Virginia,Suffolk City,51800,17807,12286,5521,15012,145,14867,2795,114,2681,16302,10781,5521,11398,6269,5129,2834,510,85,7969
6/1/2021,VA,Virginia,Surry,51181,1805,1223,582,1573,13,1560,232,*,*,1664,1082,582,1264,711,553,233,52,12,967
6/1/2021,VA,Virginia,Sussex,51183,2551,1649,902,2110,29,2081,441,14,427,2376,1474,902,1898,1041,857,512,136,18,1232
6/1/2021,VA,Virginia,Tazewell,51185,11972,6753,5219,9184,38,9146,2788,37,2751,11394,6177,5217,9380,5274,4106,2299,484,112,6485
6/1/2021,VA,Virginia,Unknown,51999,*,*,*,*,*,*,*,*,*,*,*,*,*,*,*,*,*,*,*
6/1/2021,VA,Virginia,Virginia Beach City,51810,77403,57782,19621,69358,394,68964,8045,323,7722,70756,51145,19611,42982,25094,17888,7297,1566,340,33779
6/1/2021,VA,Virginia,Warren,51187,8367,6505,1862,7393,30,7363,974,28,946,7589,5727,1862,5447,3894,1553,938,236,57,4216
6/1/2021,VA,Virginia,Washington,51191,15650,8652,6998,12995,40,12955,2655,33,2622,14789,7792,6997,12539,6038,6501,2400,630,151,9358
6/1/2021,VA,Virginia,Waynesboro City,51820,5096,3818,1278,4285,24,4261,811,23,788,4781,3503,1278,3906,2702,1204,888,124,39,2855
6/1/2021,VA,Virginia,Westmoreland,51193,5332,4080,1252,4775,28,4747,557,16,541,4839,3587,1252,3313,2208,1105,832,143,37,2301
6/1/2021,VA,Virginia,Williamsburg City,51830,2939,2258,681,2702,11,2691,237,*,*,2720,2039,681,1996,1405,591,287,*,*,1662
6/1/2021,VA,Virginia,Winchester City,51840,5639,4366,1273,4907,28,4879,732,21,711,5140,3867,1273,3892,2792,1100,894,144,33,2821
6/1/2021,VA,Virginia,Wise,51195,10628,4535,6093,7546,29,7517,3082,23,3059,10033,3940,6093,8386,3104,5282,2374,487,136,5389
6/1/2021,VA,Virginia,Wythe,51197,8002,5144,2858,6411,37,6374,1591,15,1576,7569,4711,2858,6348,3737,2611,1612,310,79,4347
6/1/2021,VA,Virginia,York,51199,12936,10408,2528,12002,48,11954,934,39,895,11801,9273,2528,6590,4380,2210,739,155,35,5661
3/1/2021,VA,Virginia,Accomack,51001,9359,7006,2353,8251,55,8196,1108,41,1067,8661,6311,2350,6559,4553,2006,1482,375,87,4615
3/1/2021,VA,Virginia,Albemarle,51003,22755,19154,3601,21227,61,21166,1528,45,1483,20562,16963,3599,16327,13241,3086,1643,304,91,14289
3/1/2021,VA,Virginia,Alexandria City,51510,18492,14381,4111,17250,75,17175,1242,64,1178,15002,10892,4110,9725,5994,3731,2096,323,61,7245
3/1/2021,VA,Virginia,Alleghany,51005,4615,3381,1234,3808,22,3786,807,*,*,4375,3141,1234,3636,2579,1057,803,111,43,2679
3/1/2021,VA,Virginia,Amelia,51007,3230,2136,1094,2805,11,2794,425,11,414,2992,1898,1094,2455,1432,1023,443,85,29,1898
3/1/2021,VA,Virginia,Amherst,51009,8067,5628,2439,6869,55,6814,1198,31,1167,7509,5070,2439,6276,4041,2235,1244,218,70,4744
3/1/2021,VA,Virginia,Appomattox,51011,4163,2911,1252,3447,17,3430,716,22,694,3919,2667,1252,3294,2129,1165,762,118,43,2371
3/1/2021,VA,Virginia,Arlington,51013,25326,20219,5107,23845,107,23738,1481,76,1405,20004,14898,5106,12892,8204,4688,2977,412,113,9390
3/1/2021,VA,Virginia,Augusta,51015,19152,14937,4215,16909,76,16833,2243,50,2193,17974,13759,4215,14509,10661,3848,1873,429,134,12073
3/1/2021,VA,Virginia,Bath,51017,1295,1078,217,1142,*,*,153,*,*,1230,1013,217,996,799,197,160,*,*,793
3/1/2021,VA,Virginia,Bedford,51019,20754,15335,5419,18220,87,18133,2534,45,2489,19352,13934,5418,15680,11143,4537,2035,494,149,13002
3/1/2021,VA,Virginia,Bland,51021,1820,1231,589,1482,*,*,338,*,*,1719,1130,589,1372,911,461,224,60,15,1073
3/1/2021,VA,Virginia,Botetourt,51023,9050,6315,2735,8055,55,8000,995,20,975,8404,5669,2735,6839,4454,2385,716,171,42,5910
3/1/2021,VA,Virginia,Bristol City,51520,4506,2098,2408,3613,12,3601,893,17,876,4222,1814,2408,3669,1346,2323,1088,152,39,2390
3/1/2021,VA,Virginia,Brunswick,51025,4119,2793,1326,3509,37,3472,610,17,593,3846,2520,1326,3136,1923,1213,1038,122,37,1939
3/1/2021,VA,Virginia,Buchanan,51027,7036,3300,3736,4769,23,4746,2267,15,2252,6810,3074,3736,5914,2931,2983,1581,395,105,3833
3/1/2021,VA,Virginia,Buckingham,51029,3779,2722,1057,3155,24,3131,624,18,606,3525,2468,1057,2809,1937,872,764,146,40,1859
3/1/2021,VA,Virginia,Buena Vista City,51530,1502,1067,435,1249,*,*,253,*,*,1398,963,435,1124,735,389,303,60,12,749
3/1/2021,VA,Virginia,Campbell,51031,13376,9379,3997,11357,87,11270,2019,56,1963,12541,8544,3997,10499,6857,3642,2059,400,122,7918
3/1/2021,VA,Virginia,Caroline,51033,6252,4395,1857,5405,41,5364,847,27,820,5656,3799,1857,4070,2399,1671,860,209,36,2965
3/1/2021,VA,Virginia,Carroll,51035,8630,6459,2171,7285,36,7249,1345,18,1327,8209,6038,2171,6613,4698,1915,1548,281,105,4679
3/1/2021,VA,Virginia,Charles City,51036,2003,1331,672,1752,21,1731,251,*,*,1829,1157,672,1464,860,604,252,83,12,1117
3/1/2021,VA,Virginia,Charlotte,51037,3280,2390,890,2751,22,2729,529,17,512,3074,2184,890,2525,1704,821,699,129,34,1663
3/1/2021,VA,Virginia,Charlottesville City,51540,6414,5159,1255,5522,31,5491,892,34,858,5738,4484,1254,4782,3612,1170,1187,159,31,3405
3/1/2021,VA,Virginia,Chesapeake City,51550,40938,29091,11847,36080,312,35768,4858,202,4656,37085,25240,11845,23686,12959,10727,4305,996,204,18181
3/1/2021,VA,Virginia,Chesterfield,51041,65455,45532,19923,58519,297,58222,6936,242,6694,59241,39322,19919,47561,29399,18162,5857,1075,248,40381
3/1/2021,VA,Virginia,Clarke,51043,3550,2871,679,3305,*,*,245,*,*,3210,2531,679,2331,1779,552,291,79,28,1933
3/1/2021,VA,Virginia,Colonial Heights City,51570,4161,3121,1040,3607,17,3590,554,*,*,3834,2794,1040,2660,1713,947,527,102,19,2012
3/1/2021,VA,Virginia,Covington City,51580,1564,1141,423,1211,15,1196,353,*,*,1462,1039,423,1224,822,402,335,49,13,827
3/1/2021,VA,Virginia,Craig,51045,1385,926,459,1120,*,*,265,*,*,1293,834,459,1066,650,416,199,*,*,806
3/1/2021,VA,Virginia,Culpeper,51047,10073,7829,2244,8932,43,8889,1141,33,1108,9120,6876,2244,6661,4864,1797,1238,250,68,5105
3/1/2021,VA,Virginia,Cumberland,51049,2421,1627,794,2047,13,2034,374,*,*,2244,1451,793,1853,1132,721,446,96,25,1286
3/1/2021,VA,Virginia,Danville City,51590,11128,6554,4574,8968,101,8867,2160,115,2045,10443,5869,4574,9146,5462,3684,3229,423,135,5359
3/1/2021,VA,Virginia,Dickenson,51051,4858,2035,2823,3338,*,*,1520,*,*,4673,1850,2823,4027,1528,2499,1097,212,61,2657
3/1/2021,VA,Virginia,Dinwiddie,51053,6166,4191,1975,5148,34,5114,1018,30,988,5708,3733,1975,4470,2602,1868,907,205,47,3311
3/1/2021,VA,Virginia,Emporia City,51595,1294,779,515,1044,13,1031,250,*,*,1218,703,515,1033,568,465,438,69,13,513
3/1/2021,VA,Virginia,Essex,51057,3049,2152,897,2637,19,2618,412,14,398,2841,1944,897,2241,1482,759,477,89,33,1642
3/1/2021,VA,Virginia,Fairfax,51059,159637,121461,38176,151957,649,151308,7680,390,7290,129264,91108,38156,81802,48940,32862,14383,2758,556,64105
3/1/2021,VA,Virginia,Fairfax City,51600,4023,3018,1005,3787,15,3772,236,12,224,3372,2368,1004,2268,1432,836,379,70,18,1801
3/1/2021,VA,Virginia,Falls Church City,51610,2154,1709,445,2087,*,*,67,*,*,1709,1264,445,1124,727,397,132,*,*,977
3/1/2021,VA,Virginia,Fauquier,51061,13344,10859,2485,12376,83,12293,968,35,933,11828,9343,2485,8178,6261,1917,970,192,61,6955
3/1/2021,VA,Virginia,Floyd,51063,4314,3077,1237,3800,14,3786,514,*,*,4026,2790,1236,3308,2149,1159,625,109,34,2540
3/1/2021,VA,Virginia,Fluvanna,51065,6529,5193,1336,5915,28,5887,614,17,597,5938,4602,1336,4530,3406,1124,600,122,26,3782
3/1/2021,VA,Virginia,Franklin,51067,15536,10046,5490,13390,66,13324,2146,36,2110,14624,9134,5490,12253,7274,4979,2055,476,139,9583
3/1/2021,VA,Virginia,Franklin City,51620,2189,1535,654,1808,23,1785,381,23,358,2060,1406,654,1712,1100,612,531,73,15,1093
3/1/2021,VA,Virginia,Frederick,51069,17850,13868,3982,16168,73,16095,1682,45,1637,16222,12242,3980,11836,8511,3325,1466,386,118,9866
3/1/2021,VA,Virginia,Fredericksburg City,51630,4286,3195,1091,3641,25,3616,645,27,618,3789,2698,1091,2727,1731,996,805,87,27,1808
3/1/2021,VA,Virginia,Galax City,51640,1740,1343,397,1421,*,*,319,*,*,1651,1254,397,1403,1040,363,556,60,22,765
3/1/2021,VA,Virginia,Giles,51071,4627,3197,1430,3780,22,3758,847,18,829,4367,2937,1430,3692,2542,1150,769,108,35,2780
3/1/2021,VA,Virginia,Gloucester,51073,9200,6989,2211,8109,56,8053,1091,26,1065,8491,6281,2210,5736,3767,1969,1012,189,52,4483
3/1/2021,VA,Virginia,Goochland,51075,6480,4831,1649,6019,33,5986,461,12,449,5971,4322,1649,5072,3645,1427,438,105,22,4507
3/1/2021,VA,Virginia,Grayson,51077,4693,3316,1377,3957,15,3942,736,*,*,4481,3104,1377,3601,2307,1294,933,180,76,2412
3/1/2021,VA,Virginia,Greene,51079,4190,3366,824,3721,20,3701,469,12,457,3792,2968,824,2884,2140,744,457,86,15,2326
3/1/2021,VA,Virginia,Greensville,51081,2142,1298,844,1755,22,1733,387,14,373,1991,1147,844,1670,923,747,457,102,18,1093
3/1/2021,VA,Virginia,Halifax,51083,9938,7286,2652,8380,58,8322,1558,54,1504,9326,6674,2652,7711,5267,2444,2054,411,127,5119
3/1/2021,VA,Virginia,Hampton City,51650,26225,17020,9205,22082,241,21841,4143,209,3934,23881,14678,9203,15607,6972,8635,4084,776,159,10588
3/1/2021,VA,Virginia,Hanover,51085,23016,16129,6887,21211,109,21102,1805,52,1753,21040,14156,6884,17525,11605,5920,1504,326,80,15615
3/1/2021,VA,Virginia,Harrisonburg City,51660,5601,4471,1130,4808,21,4787,793,21,772,5088,3958,1130,4186,3172,1014,995,139,45,3007
3/1/2021,VA,Virginia,Henrico,51087,60173,39726,20447,53546,426,53120,6627,289,6338,54575,34129,20446,46132,27633,18499,6892,1450,330,37460
3/1/2021,VA,Virginia,Henry,51089,14886,8822,6064,12114,98,12016,2772,75,2697,14186,8123,6063,12433,6714,5719,2934,743,203,8553
3/1/2021,VA,Virginia,Highland,51091,839,698,141,769,*,*,70,0,70,787,646,141,617,494,123,61,*,*,530
3/1/2021,VA,Virginia,Hopewell City,51670,4553,3007,1546,3610,33,3577,943,28,915,4224,2678,1546,3124,1645,1479,1037,163,30,1894
3/1/2021,VA,Virginia,Isle of Wight,51093,8940,6442,2498,7988,50,7938,952,32,920,8274,5776,2498,6017,3702,2315,996,197,62,4762
3/1/2021,VA,Virginia,James City,51095,22172,17823,4349,20937,74,20863,1235,34,1201,20538,16193,4345,13765,10306,3459,986,228,54,12497
3/1/2021,VA,Virginia,King and Queen,51097,1830,1336,494,1586,*,*,244,*,*,1706,1212,494,1340,898,442,267,*,*,994
3/1/2021,VA,Virginia,King George,51099,4289,3465,824,3781,25,3756,508,19,489,3718,2894,824,2046,1306,740,478,75,20,1473
3/1/2021,VA,Virginia,King William,51101,3699,2689,1010,3222,34,3188,477,27,450,3435,2425,1010,2868,1952,916,427,103,19,2319
3/1/2021,VA,Virginia,Lancaster,51103,4429,3480,949,4128,26,4102,301,13,288,4159,3211,948,3152,2423,729,481,98,13,2560
3/1/2021,VA,Virginia,Lee,51105,6427,2653,3774,4659,19,4640,1768,17,1751,6123,2351,3772,5184,1793,3391,1917,242,62,2963
3/1/2021,VA,Virginia,Lexington City,51678,1339,1072,267,1229,*,*,110,*,*,1235,969,266,984,746,238,171,30,11,772
3/1/2021,VA,Virginia,Loudoun,51107,42633,32304,10329,40301,195,40106,2332,123,2209,35507,25184,10323,24946,16068,8878,3607,691,157,20491
3/1/2021,VA,Virginia,Louisa,51109,9071,6574,2497,7843,56,7787,1228,36,1192,8295,5798,2497,6425,4196,2229,1162,262,54,4947
3/1/2021,VA,Virginia,Lunenburg,51111,3219,2335,884,2715,21,2694,504,*,*,2994,2110,884,2368,1550,818,747,119,40,1462
3/1/2021,VA,Virginia,Lynchburg City,51680,14702,10157,4545,12293,99,12194,2409,98,2311,13663,9118,4545,11549,7344,4205,2900,444,125,8080
3/1/2021,VA,Virginia,Madison,51113,3438,2704,734,3110,12,3098,328,*,*,3190,2456,734,2446,1833,613,416,83,16,1931
3/1/2021,VA,Virginia,Manassas City,51683,4839,3470,1369,4345,26,4319,494,38,456,4094,2725,1369,2986,1787,1199,534,114,25,2313
3/1/2021,VA,Virginia,Manassas Park City,51685,1392,892,500,1222,13,1209,170,11,159,1170,670,500,871,413,458,223,*,*,585
3/1/2021,VA,Virginia,Martinsville City,51690,3808,2233,1575,2933,43,2890,875,31,844,3603,2028,1575,3174,1655,1519,1232,187,56,1699
3/1/2021,VA,Virginia,Mathews,51115,2965,2280,685,2737,11,2726,228,*,*,2784,2099,685,2092,1517,575,283,42,20,1747
3/1/2021,VA,Virginia,Mecklenburg,51117,9529,6759,2770,8109,57,8052,1420,61,1359,8945,6175,2770,7275,4789,2486,1798,380,88,5009
3/1/2021,VA,Virginia,Middlesex,51119,3754,2890,864,3426,17,3409,328,*,*,3522,2658,864,2762,2046,716,440,79,21,2222
3/1/2021,VA,Virginia,Montgomery,51121,14572,10785,3787,12448,72,12376,2124,33,2091,13100,9313,3787,11124,7662,3462,1915,345,95,8769
3/1/2021,VA,Virginia,Nelson,51125,4864,3784,1080,4416,15,4401,448,*,*,4512,3433,1079,3427,2492,935,564,115,32,2716
3/1/2021,VA,Virginia,New Kent,51127,5132,3832,1300,4662,25,4637,470,14,456,4686,3386,1300,3462,2396,1066,327,84,18,3033
3/1/2021,VA,Virginia,Newport News City,51700,29690,19088,10602,24939,236,24703,4751,232,4519,27133,16532,10601,18775,8702,10073,5217,894,190,12474
3/1/2021,VA,Virginia,Norfolk City,51710,34266,21776,12490,28358,316,28042,5908,307,5601,30781,18293,12488,21945,10051,11894,7391,1361,244,12949
3/1/2021,VA,Virginia,Northampton,51131,3839,2736,1103,3413,22,3391,426,18,408,3591,2488,1103,2950,1965,985,868,86,28,1968
3/1/2021,VA,Virginia,Northumberland,51133,4769,3725,1044,4442,*,*,327,12,315,4449,3405,1044,3163,2377,786,434,88,24,2617
3/1/2021,VA,Virginia,Norton City,51720,1116,545,571,794,*,*,322,*,*,1045,475,570,908,394,514,329,*,*,511
3/1/2021,VA,Virginia,Nottoway,51135,3631,2555,1076,3035,26,3009,596,17,579,3376,2300,1076,2725,1775,950,832,133,41,1719
3/1/2021,VA,Virginia,Orange,51137,9057,7000,2057,8118,55,8063,939,33,906,8274,6217,2057,5902,4222,1680,960,205,57,4680
3/1/2021,VA,Virginia,Page,51139,6397,4991,1406,5390,17,5373,1007,19,988,5979,4573,1406,4569,3324,1245,1079,250,59,3181
3/1/2021,VA,Virginia,Patrick,51141,5533,3704,1829,4674,14,4660,859,11,848,5262,3434,1828,4388,2728,1660,1035,203,60,3090
3/1/2021,VA,Virginia,Petersburg City,51730,7212,4240,2972,5516,97,5419,1696,77,1619,6579,3607,2972,5133,2251,2882,2137,340,52,2604
3/1/2021,VA,Virginia,Pittsylvania,51143,16733,10494,6239,14123,119,14004,2610,68,2542,15759,9520,6239,13478,8501,4977,2977,557,159,9785
3/1/2021,VA,Virginia,Poquoson City,51735,2644,2194,450,2476,*,*,168,*,*,2428,1978,450,1339,933,406,117,*,*,1182
3/1/2021,VA,Virginia,Portsmouth City,51740,18617,11791,6826,14940,204,14736,3677,202,3475,16710,9885,6825,11757,5230,6527,4097,718,114,6828
3/1/2021,VA,Virginia,Powhatan,51145,6589,4869,1720,6029,18,6011,560,13,547,6092,4372,1720,5044,3527,1517,403,117,28,4496
3/1/2021,VA,Virginia,Prince Edward,51147,4775,3332,1443,3963,37,3926,812,27,785,4413,2970,1443,3603,2309,1294,1028,171,46,2358
3/1/2021,VA,Virginia,Prince George,51149,6511,5112,1399,5587,37,5550,924,30,894,6033,4634,1399,3902,2630,1272,625,140,27,3110
3/1/2021,VA,Virginia,Prince William,51153,53105,39151,13954,48296,337,47959,4809,293,4516,45241,31290,13951,27876,15369,12507,5409,1235,222,21010
3/1/2021,VA,Virginia,Pulaski,51155,9226,6646,2580,7556,37,7519,1670,30,1640,8621,6041,2580,7220,4906,2314,1556,285,82,5297
3/1/2021,VA,Virginia,Radford City,51750,2120,1540,580,1760,*,*,360,*,*,1908,1328,580,1648,1108,540,334,46,20,1248
3/1/2021,VA,Virginia,Rappahannock,51157,2060,1722,338,1935,*,*,125,*,*,1855,1518,337,1337,1076,261,152,36,13,1136
3/1/2021,VA,Virginia,Richmond,51159,1996,1444,552,1756,*,*,240,*,*,1856,1304,552,1441,1002,439,323,70,11,1037
3/1/2021,VA,Virginia,Richmond City,51760,34796,19908,14888,28555,296,28259,6241,304,5937,31407,16522,14885,27400,13206,14194,8786,1334,271,17009
3/1/2021,VA,Virginia,Roanoke,51161,24487,17042,7445,21994,125,21869,2493,55,2438,22646,15204,7442,18805,12230,6575,2097,465,131,16112
3/1/2021,VA,Virginia,Roanoke City,51770,21332,12726,8606,16859,168,16691,4473,136,4337,19516,10912,8604,16471,8407,8064,4746,926,180,10619
3/1/2021,VA,Virginia,Rockbridge,51163,6539,4922,1617,5695,*,*,844,*,*,6078,4461,1617,4743,3312,1431,847,177,51,3668
3/1/2021,VA,Virginia,Rockingham,51165,18724,15191,3533,16743,58,16685,1981,39,1942,17355,13822,3533,14180,11081,3099,1783,526,142,11729
3/1/2021,VA,Virginia,Russell,51167,8059,4061,3998,5901,17,5884,2158,20,2138,7736,3739,3997,6803,3426,3377,1712,348,133,4610
3/1/2021,VA,Virginia,Salem City,51775,6131,4384,1747,5286,30,5256,845,14,831,5634,3887,1747,4640,3042,1598,809,126,42,3663
3/1/2021,VA,Virginia,Scott,51169,6780,2582,4198,5283,14,5269,1497,16,1481,6506,2308,4198,5793,1802,3991,1511,262,95,3925
3/1/2021,VA,Virginia,Shenandoah,51171,10999,8430,2569,9886,31,9855,1113,17,1096,10305,7737,2568,7748,5570,2178,1254,260,81,6153
3/1/2021,VA,Virginia,Smyth,51173,8712,5377,3335,6720,27,6693,1992,30,1962,8274,4939,3335,7012,3826,3186,2039,369,126,4478
3/1/2021,VA,Virginia,Southampton,51175,4116,3030,1086,3532,30,3502,584,25,559,3809,2723,1086,3041,2067,974,671,135,29,2206
3/1/2021,VA,Virginia,Spotsylvania,51177,23370,17427,5943,20722,133,20589,2648,98,2550,20713,14771,5942,13376,8144,5232,2190,565,123,10498
3/1/2021,VA,Virginia,Stafford,51179,19386,15418,3968,17443,121,17322,1943,89,1854,16971,13006,3965,9337,5866,3471,1558,397,78,7304
3/1/2021,VA,Virginia,Staunton City,51790,6361,4880,1481,5413,29,5384,948,14,934,5979,4498,1481,4856,3505,1351,1080,166,51,3559
3/1/2021,VA,Virginia,Suffolk City,51800,17723,12336,5387,14950,151,14799,2773,112,2661,16254,10867,5387,11371,6376,4995,2817,513,98,7943
3/1/2021,VA,Virginia,Surry,51181,1788,1226,562,1559,13,1546,229,*,*,1653,1091,562,1255,722,533,230,56,14,955
3/1/2021,VA,Virginia,Sussex,51183,2559,1683,876,2118,31,2087,441,15,426,2387,1511,876,1896,1066,830,509,137,20,1230
3/1/2021,VA,Virginia,Tazewell,51185,11980,6817,5163,9203,42,9161,2777,36,2741,11398,6237,5161,9393,5341,4052,2291,494,132,6476
3/1/2021,VA,Virginia,Unknown,51999,*,*,*,*,*,*,*,*,*,*,*,*,*,*,*,*,*,*,*
3/1/2021,VA,Virginia,Virginia Beach City,51810,76864,57554,19310,68901,417,68484,7963,327,7636,70359,51059,19300,42768,25181,17587,7173,1556,368,33671
3/1/2021,VA,Virginia,Warren,51187,8326,6555,1771,7360,30,7330,966,31,935,7563,5792,1771,5394,3933,1461,922,230,69,4173
3/1/2021,VA,Virginia,Washington,51191,15609,8663,6946,12991,41,12950,2618,33,2585,14744,7799,6945,12530,6083,6447,2387,627,167,9349
3/1/2021,VA,Virginia,Waynesboro City,51820,5102,3846,1256,4293,23,4270,809,24,785,4793,3537,1256,3917,2738,1179,888,127,44,2858
3/1/2021,VA,Virginia,Westmoreland,51193,5300,4094,1206,4751,29,4722,549,16,533,4809,3603,1206,3299,2240,1059,822,146,42,2289
3/1/2021,VA,Virginia,Williamsburg City,51830,2929,2257,672,2692,11,2681,237,*,*,2709,2037,672,1994,1412,582,282,*,*,1664
3/1/2021,VA,Virginia,Winchester City,51840,5639,4381,1258,4903,28,4875,736,23,713,5137,3879,1258,3895,2810,1085,887,142,32,2834
3/1/2021,VA,Virginia,Wise,51195,10636,4590,6046,7559,31,7528,3077,22,3055,10063,4017,6046,8402,3173,5229,2372,496,149,5385
3/1/2021,VA,Virginia,Wythe,51197,7988,5193,2795,6411,41,6370,1577,14,1563,7555,4760,2795,6350,3793,2557,1615,312,92,4331
3/1/2021,VA,Virginia,York,51199,12878,10370,2508,11950,51,11899,928,38,890,11779,9271,2508,6584,4399,2185,726,161,40,5657
5/1/2021,VA,Virginia,Accomack,51001,9373,6980,2393,8259,53,8206,1114,42,1072,8673,6283,2390,6559,4513,2046,1494,374,74,4617
5/1/2021,VA,Virginia,Albemarle,51003,22863,19204,3659,21323,61,21262,1540,46,1494,20631,16974,3657,16368,13226,3142,1648,302,81,14337
5/1/2021,VA,Virginia,Alexandria City,51510,18591,14430,4161,17340,73,17267,1251,65,1186,15052,10892,4160,9769,5986,3783,2110,318,53,7288
5/1/2021,VA,Virginia,Alleghany,51005,4618,3364,1254,3805,22,3783,813,*,*,4378,3124,1254,3629,2552,1077,805,113,36,2675
5/1/2021,VA,Virginia,Amelia,51007,3236,2127,1109,2811,12,2799,425,*,*,2992,1883,1109,2454,1415,1039,446,86,23,1899
5/1/2021,VA,Virginia,Amherst,51009,8092,5625,2467,6882,54,6828,1210,31,1179,7522,5055,2467,6269,4004,2265,1250,216,69,4734
5/1/2021,VA,Virginia,Appomattox,51011,4172,2894,1278,3452,17,3435,720,21,699,3922,2644,1278,3294,2105,1189,772,116,39,2367
5/1/2021,VA,Virginia,Arlington,51013,25464,20283,5181,23971,104,23867,1493,77,1416,20060,14880,5180,12930,8169,4761,2998,408,111,9413
5/1/2021,VA,Virginia,Augusta,51015,19213,14957,4256,16949,71,16878,2264,49,2215,18016,13760,4256,14533,10646,3887,1889,414,124,12106
5/1/2021,VA,Virginia,Bath,51017,1297,1078,219,1145,*,*,152,*,*,1228,1009,219,994,794,200,165,*,*,789
5/1/2021,VA,Virginia,Bedford,51019,20839,15331,5508,18290,80,18210,2549,45,2504,19405,13898,5507,15748,11114,4634,2047,493,142,13066
5/1/2021,VA,Virginia,Bland,51021,1830,1237,593,1487,*,*,343,*,*,1726,1133,593,1375,907,468,226,58,14,1077
5/1/2021,VA,Virginia,Botetourt,51023,9069,6311,2758,8071,53,8018,998,21,977,8420,5662,2758,6856,4449,2407,726,174,37,5919
5/1/2021,VA,Virginia,Bristol City,51520,4499,2083,2416,3599,*,*,900,17,883,4217,1801,2416,3674,1343,2331,1093,155,36,2390
5/1/2021,VA,Virginia,Brunswick,51025,4111,2766,1345,3497,34,3463,614,16,598,3830,2485,1345,3133,1901,1232,1045,124,35,1929
5/1/2021,VA,Virginia,Buchanan,51027,7029,3266,3763,4747,23,4724,2282,15,2267,6797,3034,3763,5907,2890,3017,1594,390,84,3839
5/1/2021,VA,Virginia,Buckingham,51029,3784,2710,1074,3159,23,3136,625,17,608,3532,2458,1074,2807,1920,887,765,140,40,1862
5/1/2021,VA,Virginia,Buena Vista City,51530,1502,1065,437,1247,*,*,255,*,*,1400,963,437,1116,726,390,302,60,13,741
5/1/2021,VA,Virginia,Campbell,51031,13422,9361,4061,11393,84,11309,2029,55,1974,12569,8508,4061,10499,6798,3701,2076,398,112,7913
5/1/2021,VA,Virginia,Caroline,51033,6268,4389,1879,5415,38,5377,853,29,824,5668,3789,1879,4078,2383,1695,861,204,32,2981
5/1/2021,VA,Virginia,Carroll,51035,8629,6415,2214,7280,35,7245,1349,18,1331,8217,6003,2214,6610,4652,1958,1552,282,93,4683
5/1/2021,VA,Virginia,Charles City,51036,2005,1324,681,1755,19,1736,250,*,*,1831,1150,681,1467,855,612,251,*,*,1124
5/1/2021,VA,Virginia,Charlotte,51037,3266,2350,916,2742,21,2721,524,16,508,3064,2148,916,2515,1668,847,695,129,34,1657
5/1/2021,VA,Virginia,Charlottesville City,51540,6446,5168,1278,5543,28,5515,903,34,869,5761,4484,1277,4786,3591,1195,1192,157,29,3408
5/1/2021,VA,Virginia,Chesapeake City,51550,41070,29138,11932,36191,299,35892,4879,198,4681,37126,25196,11930,23649,12848,10801,4294,984,174,18197
5/1/2021,VA,Virginia,Chesterfield,51041,65716,45609,20107,58733,293,58440,6983,245,6738,59471,39368,20103,47710,29367,18343,5914,1060,220,40516
5/1/2021,VA,Virginia,Clarke,51043,3573,2884,689,3326,*,*,247,*,*,3226,2537,689,2347,1784,563,296,76,27,1948
5/1/2021,VA,Virginia,Colonial Heights City,51570,4153,3096,1057,3599,17,3582,554,*,*,3819,2762,1057,2658,1692,966,520,103,19,2016
5/1/2021,VA,Virginia,Covington City,51580,1559,1136,423,1205,13,1192,354,*,*,1456,1033,423,1218,814,404,334,*,*,827
5/1/2021,VA,Virginia,Craig,51045,1393,927,466,1128,*,*,265,*,*,1298,832,466,1074,651,423,199,*,*,815
5/1/2021,VA,Virginia,Culpeper,51047,10103,7824,2279,8951,41,8910,1152,33,1119,9139,6860,2279,6662,4827,1835,1249,244,68,5101
5/1/2021,VA,Virginia,Cumberland,51049,2417,1616,801,2043,13,2030,374,*,*,2240,1440,800,1839,1112,727,443,97,21,1278
5/1/2021,VA,Virginia,Danville City,51590,11117,6506,4611,8948,94,8854,2169,112,2057,10435,5824,4611,9097,5375,3722,3227,424,115,5331
5/1/2021,VA,Virginia,Dickenson,51051,4851,2018,2833,3325,11,3314,1526,*,*,4665,1832,2833,4021,1509,2512,1101,208,54,2658
5/1/2021,VA,Virginia,Dinwiddie,51053,6168,4164,2004,5146,32,5114,1022,30,992,5710,3706,2004,4472,2578,1894,908,207,42,3315
5/1/2021,VA,Virginia,Emporia City,51595,1299,769,530,1050,13,1037,249,*,*,1220,690,530,1034,554,480,438,71,12,513
5/1/2021,VA,Virginia,Essex,51057,3058,2146,912,2644,19,2625,414,15,399,2843,1931,912,2240,1465,775,483,87,26,1644
5/1/2021,VA,Virginia,Fairfax,51059,160620,121906,38714,152889,626,152263,7731,389,7342,129866,91171,38695,82218,48857,33361,14543,2733,508,64434
5/1/2021,VA,Virginia,Fairfax City,51600,4047,3034,1013,3809,14,3795,238,12,226,3385,2373,1012,2270,1423,847,388,69,13,1800
5/1/2021,VA,Virginia,Falls Church City,51610,2174,1723,451,2105,*,*,69,*,*,1724,1273,451,1133,730,403,130,*,*,989
5/1/2021,VA,Virginia,Fauquier,51061,13437,10892,2545,12452,81,12371,985,35,950,11901,9356,2545,8233,6257,1976,998,186,55,6994
5/1/2021,VA,Virginia,Floyd,51063,4319,3073,1246,3802,14,3788,517,*,*,4026,2781,1245,3304,2134,1170,624,106,27,2547
5/1/2021,VA,Virginia,Fluvanna,51065,6553,5199,1354,5937,27,5910,616,16,600,5956,4602,1354,4545,3402,1143,595,121,25,3804
5/1/2021,VA,Virginia,Franklin,51067,15573,10055,5518,13416,64,13352,2157,34,2123,14671,9153,5518,12278,7265,5013,2059,469,121,9629
5/1/2021,VA,Virginia,Franklin City,51620,2182,1522,660,1800,23,1777,382,22,360,2053,1393,660,1705,1088,617,535,*,*,1088
5/1/2021,VA,Virginia,Frederick,51069,17930,13912,4018,16227,72,16155,1703,44,1659,16285,12269,4016,11851,8496,3355,1483,375,108,9885
5/1/2021,VA,Virginia,Fredericksburg City,51630,4296,3194,1102,3650,22,3628,646,26,620,3796,2694,1102,2730,1722,1008,811,83,23,1813
5/1/2021,VA,Virginia,Galax City,51640,1733,1331,402,1416,*,*,317,*,*,1642,1240,402,1393,1024,369,550,59,21,763
5/1/2021,VA,Virginia,Giles,51071,4624,3163,1461,3777,21,3756,847,18,829,4366,2905,1461,3688,2509,1179,768,106,32,2782
5/1/2021,VA,Virginia,Gloucester,51073,9239,6992,2247,8141,51,8090,1098,26,1072,8522,6276,2246,5743,3744,1999,1016,187,48,4492
5/1/2021,VA,Virginia,Goochland,51075,6514,4858,1656,6048,33,6015,466,11,455,5986,4330,1656,5081,3648,1433,444,103,21,4513
5/1/2021,VA,Virginia,Grayson,51077,4701,3314,1387,3967,15,3952,734,*,*,4484,3097,1387,3596,2296,1300,932,175,67,2422
5/1/2021,VA,Virginia,Greene,51079,4213,3373,840,3739,20,3719,474,11,463,3813,2973,840,2894,2133,761,466,89,15,2324
5/1/2021,VA,Virginia,Greensville,51081,2143,1289,854,1755,22,1733,388,13,375,1993,1139,854,1669,910,759,454,101,18,1096
5/1/2021,VA,Virginia,Halifax,51083,9956,7247,2709,8379,55,8324,1577,55,1522,9344,6635,2709,7728,5229,2499,2080,402,113,5133
5/1/2021,VA,Virginia,Hampton City,51650,26279,16949,9330,22119,231,21888,4160,207,3953,23918,14590,9328,15646,6888,8758,4099,779,136,10632
5/1/2021,VA,Virginia,Hanover,51085,23115,16169,6946,21296,103,21193,1819,51,1768,21112,14169,6943,17607,11621,5986,1532,327,72,15676
5/1/2021,VA,Virginia,Harrisonburg City,51660,5594,4443,1151,4795,21,4774,799,21,778,5084,3933,1151,4160,3129,1031,989,139,39,2993
5/1/2021,VA,Virginia,Henrico,51087,60267,39669,20598,53611,409,53202,6656,291,6365,54620,34022,20598,46159,27505,18654,6933,1434,284,37508
5/1/2021,VA,Virginia,Henry,51089,14869,8767,6102,12089,94,11995,2780,74,2706,14155,8054,6101,12404,6651,5753,2956,745,176,8527
5/1/2021,VA,Virginia,Highland,51091,847,704,143,776,*,*,71,0,71,792,649,143,622,497,125,62,*,*,535
5/1/2021,VA,Virginia,Hopewell City,51670,4539,2975,1564,3596,30,3566,943,27,916,4206,2642,1564,3097,1603,1494,1045,155,26,1871
5/1/2021,VA,Virginia,Isle of Wight,51093,8973,6454,2519,8004,48,7956,969,33,936,8307,5788,2519,6032,3693,2339,988,200,59,4785
5/1/2021,VA,Virginia,James City,51095,22253,17897,4356,21004,73,20931,1249,34,1215,20585,16233,4352,13786,10318,3468,992,227,45,12522
5/1/2021,VA,Virginia,King and Queen,51097,1834,1321,513,1589,*,*,245,*,*,1709,1196,513,1334,877,457,269,*,*,988
5/1/2021,VA,Virginia,King George,51099,4299,3465,834,3790,24,3766,509,18,491,3729,2895,834,2051,1300,751,479,72,20,1480
5/1/2021,VA,Virginia,King William,51101,3705,2687,1018,3226,34,3192,479,27,452,3431,2413,1018,2858,1935,923,427,102,19,2310
5/1/2021,VA,Virginia,Lancaster,51103,4438,3471,967,4135,24,4111,303,12,291,4164,3198,966,3153,2404,749,483,96,11,2563
5/1/2021,VA,Virginia,Lee,51105,6422,2643,3779,4647,15,4632,1775,16,1759,6117,2340,3777,5173,1776,3397,1922,234,56,2961
5/1/2021,VA,Virginia,Lexington City,51678,1335,1066,269,1226,*,*,109,*,*,1227,959,268,976,736,240,169,*,*,768
5/1/2021,VA,Virginia,Loudoun,51107,42895,32405,10490,40537,189,40348,2358,126,2232,35652,25169,10483,25058,16029,9029,3655,686,146,20571
5/1/2021,VA,Virginia,Louisa,51109,9111,6586,2525,7879,56,7823,1232,36,1196,8322,5797,2525,6440,4184,2256,1187,260,49,4944
5/1/2021,VA,Virginia,Lunenburg,51111,3224,2323,901,2724,21,2703,500,*,*,3006,2105,901,2380,1548,832,747,118,38,1477
5/1/2021,VA,Virginia,Lynchburg City,51680,14692,10081,4611,12277,95,12182,2415,98,2317,13657,9047,4610,11535,7263,4272,2906,445,116,8068
5/1/2021,VA,Virginia,Madison,51113,3439,2700,739,3108,12,3096,331,*,*,3189,2450,739,2437,1817,620,411,83,15,1928
5/1/2021,VA,Virginia,Manassas City,51683,4862,3474,1388,4370,25,4345,492,38,454,4103,2715,1388,2995,1776,1219,531,110,25,2329
5/1/2021,VA,Virginia,Manassas Park City,51685,1402,886,516,1229,13,1216,173,11,162,1181,665,516,888,413,475,231,*,*,592
5/1/2021,VA,Virginia,Martinsville City,51690,3797,2204,1593,2920,40,2880,877,32,845,3590,1997,1593,3158,1619,1539,1225,183,41,1709
5/1/2021,VA,Virginia,Mathews,51115,2969,2282,687,2740,11,2729,229,*,*,2793,2106,687,2094,1517,577,288,40,19,1747
5/1/2021,VA,Virginia,Mecklenburg,51117,9532,6699,2833,8102,51,8051,1430,60,1370,8958,6125,2833,7288,4744,2544,1799,383,79,5027
5/1/2021,VA,Virginia,Middlesex,51119,3756,2881,875,3424,17,3407,332,*,*,3526,2651,875,2763,2035,728,444,80,17,2222
5/1/2021,VA,Virginia,Montgomery,51121,14599,10779,3820,12465,67,12398,2134,33,2101,13120,9300,3820,11123,7626,3497,1930,348,84,8761
5/1/2021,VA,Virginia,Nelson,51125,4876,3771,1105,4430,15,4415,446,*,*,4527,3423,1104,3446,2484,962,564,116,24,2742
5/1/2021,VA,Virginia,New Kent,51127,5147,3837,1310,4676,24,4652,471,15,456,4693,3383,1310,3461,2386,1075,324,83,16,3038
5/1/2021,VA,Virginia,Newport News City,51700,29799,19056,10743,25011,228,24783,4788,232,4556,27200,16458,10742,18799,8596,10203,5258,900,169,12472
5/1/2021,VA,Virginia,Norfolk City,51710,34377,21683,12694,28435,307,28128,5942,309,5633,30859,18167,12692,21999,9921,12078,7468,1342,219,12970
5/1/2021,VA,Virginia,Northampton,51131,3857,2728,1129,3425,22,3403,432,17,415,3606,2477,1129,2957,1946,1011,872,88,26,1971
5/1/2021,VA,Virginia,Northumberland,51133,4790,3723,1067,4465,*,*,325,11,314,4466,3399,1067,3178,2367,811,435,89,23,2631
5/1/2021,VA,Virginia,Norton City,51720,1113,538,575,793,*,*,320,*,*,1042,468,574,905,387,518,330,*,*,510
5/1/2021,VA,Virginia,Nottoway,51135,3620,2518,1102,3026,26,3000,594,16,578,3370,2268,1102,2716,1737,979,834,130,39,1713
5/1/2021,VA,Virginia,Orange,51137,9097,7002,2095,8147,52,8095,950,33,917,8309,6214,2095,5920,4202,1718,967,203,49,4701
5/1/2021,VA,Virginia,Page,51139,6406,4961,1445,5392,17,5375,1014,18,996,5984,4539,1445,4576,3292,1284,1089,242,53,3192
5/1/2021,VA,Virginia,Patrick,51141,5535,3679,1856,4678,14,4664,857,*,*,5263,3408,1855,4383,2697,1686,1033,200,58,3092
5/1/2021,VA,Virginia,Petersburg City,51730,7221,4198,3023,5514,95,5419,1707,77,1630,6576,3553,3023,5142,2212,2930,2152,336,49,2605
5/1/2021,VA,Virginia,Pittsylvania,51143,16766,10467,6299,14138,114,14024,2628,67,2561,15795,9496,6299,13506,8477,5029,2991,558,141,9816
5/1/2021,VA,Virginia,Poquoson City,51735,2640,2172,468,2471,*,*,169,*,*,2429,1961,468,1349,926,423,116,*,*,1195
5/1/2021,VA,Virginia,Portsmouth City,51740,18622,11719,6903,14944,199,14745,3678,202,3476,16712,9809,6903,11737,5135,6602,4099,716,97,6825
5/1/2021,VA,Virginia,Powhatan,51145,6611,4873,1738,6049,17,6032,562,13,549,6103,4365,1738,5047,3512,1535,407,117,26,4497
5/1/2021,VA,Virginia,Prince Edward,51147,4787,3325,1462,3974,37,3937,813,27,786,4423,2961,1462,3593,2271,1322,1040,165,41,2347
5/1/2021,VA,Virginia,Prince George,51149,6534,5100,1434,5598,37,5561,936,32,904,6050,4616,1434,3913,2609,1304,633,138,27,3115
5/1/2021,VA,Virginia,Prince William,51153,53453,39255,14198,48608,328,48280,4845,296,4549,45492,31297,14195,28018,15267,12751,5482,1225,198,21113
5/1/2021,VA,Virginia,Pulaski,51155,9229,6607,2622,7547,36,7511,1682,30,1652,8619,5997,2622,7218,4864,2354,1555,280,71,5312
5/1/2021,VA,Virginia,Radford City,51750,2117,1537,580,1758,*,*,359,*,*,1905,1325,580,1641,1101,540,331,47,18,1245
5/1/2021,VA,Virginia,Rappahannock,51157,2074,1728,346,1946,*,*,128,*,*,1864,1519,345,1346,1079,267,157,36,11,1142
5/1/2021,VA,Virginia,Richmond,51159,1996,1436,560,1751,*,*,245,*,*,1857,1297,560,1439,990,449,325,68,11,1035
5/1/2021,VA,Virginia,Richmond City,51760,34806,19805,15001,28558,284,28274,6248,297,5951,31406,16408,14998,27385,13094,14291,8826,1325,240,16994
5/1/2021,VA,Virginia,Roanoke,51161,24488,17008,7480,21992,118,21874,2496,55,2441,22638,15161,7477,18789,12177,6612,2105,471,118,16095
5/1/2021,VA,Virginia,Roanoke City,51770,21347,12675,8672,16859,163,16696,4488,138,4350,19510,10839,8671,16430,8309,8121,4756,915,168,10591
5/1/2021,VA,Virginia,Rockbridge,51163,6573,4943,1630,5722,*,*,851,*,*,6101,4471,1630,4738,3294,1444,843,172,46,3677
5/1/2021,VA,Virginia,Rockingham,51165,18774,15168,3606,16788,52,16736,1986,38,1948,17401,13795,3606,14202,11029,3173,1795,521,129,11757
5/1/2021,VA,Virginia,Russell,51167,8054,4033,4021,5896,17,5879,2158,21,2137,7733,3713,4020,6799,3392,3407,1703,343,109,4644
5/1/2021,VA,Virginia,Salem City,51775,6142,4376,1766,5290,28,5262,852,14,838,5642,3876,1766,4646,3027,1619,804,129,41,3672
5/1/2021,VA,Virginia,Scott,51169,6771,2550,4221,5271,13,5258,1500,13,1487,6500,2279,4221,5778,1768,4010,1511,259,85,3923
5/1/2021,VA,Virginia,Shenandoah,51171,11017,8404,2613,9899,30,9869,1118,18,1100,10319,7707,2612,7747,5521,2226,1254,257,75,6161
5/1/2021,VA,Virginia,Smyth,51173,8690,5328,3362,6698,27,6671,1992,28,1964,8248,4886,3362,6985,3773,3212,2048,359,113,4465
5/1/2021,VA,Virginia,Southampton,51175,4124,3014,1110,3534,30,3504,590,24,566,3814,2704,1110,3060,2057,1003,675,136,26,2223
5/1/2021,VA,Virginia,Spotsylvania,51177,23449,17405,6044,20791,130,20661,2658,101,2557,20783,14740,6043,13395,8073,5322,2216,546,107,10526
5/1/2021,VA,Virginia,Stafford,51179,19462,15388,4074,17507,116,17391,1955,90,1865,17011,12940,4071,9360,5796,3564,1578,397,60,7325
5/1/2021,VA,Virginia,Staunton City,51790,6364,4873,1491,5419,27,5392,945,13,932,5977,4486,1491,4852,3495,1357,1084,165,45,3558
5/1/2021,VA,Virginia,Suffolk City,51800,17782,12289,5493,15000,145,14855,2782,111,2671,16291,10798,5493,11392,6292,5100,2820,509,83,7980
5/1/2021,VA,Virginia,Surry,51181,1799,1221,578,1568,13,1555,231,*,*,1662,1084,578,1261,711,550,232,53,12,964
5/1/2021,VA,Virginia,Sussex,51183,2550,1658,892,2109,29,2080,441,14,427,2378,1486,892,1893,1047,846,510,131,17,1235
5/1/2021,VA,Virginia,Tazewell,51185,11974,6770,5204,9190,40,9150,2784,36,2748,11392,6190,5202,9379,5292,4087,2300,486,111,6482
5/1/2021,VA,Virginia,Unknown,51999,*,*,*,*,*,*,*,*,*,*,*,*,*,*,*,*,*,*,*
5/1/2021,VA,Virginia,Virginia Beach City,51810,77209,57669,19540,69208,402,68806,8001,321,7680,70594,51064,19530,42903,25090,17813,7238,1552,328,33785
5/1/2021,VA,Virginia,Warren,51187,8348,6505,1843,7377,30,7347,971,29,942,7574,5731,1843,5435,3898,1537,936,231,57,4211
5/1/2021,VA,Virginia,Washington,51191,15628,8658,6970,12990,41,12949,2638,33,2605,14755,7786,6969,12516,6042,6474,2392,625,151,9348
5/1/2021,VA,Virginia,Waynesboro City,51820,5094,3834,1260,4285,24,4261,809,23,786,4779,3519,1260,3904,2718,1186,884,126,39,2855
5/1/2021,VA,Virginia,Westmoreland,51193,5309,4074,1235,4756,28,4728,553,16,537,4819,3584,1235,3293,2205,1088,817,144,37,2295
5/1/2021,VA,Virginia,Williamsburg City,51830,2934,2256,678,2697,11,2686,237,*,*,2711,2033,678,1990,1403,587,284,*,*,1660
5/1/2021,VA,Virginia,Winchester City,51840,5638,4377,1261,4909,28,4881,729,21,708,5132,3871,1261,3883,2795,1088,892,140,33,2818
5/1/2021,VA,Virginia,Wise,51195,10627,4547,6080,7544,29,7515,3083,23,3060,10037,3957,6080,8388,3122,5266,2369,486,134,5399
5/1/2021,VA,Virginia,Wythe,51197,7982,5149,2833,6404,39,6365,1578,15,1563,7551,4718,2833,6328,3739,2589,1602,310,79,4337
5/1/2021,VA,Virginia,York,51199,12910,10378,2532,11977,48,11929,933,39,894,11795,9263,2532,6596,4385,2211,734,159,35,5668
11/1/2021,VA,Virginia,Accomack,51001,9463,6983,2480,8321,49,8272,1142,40,1102,8785,6308,2477,6647,4514,2133,1556,373,73,4645
11/1/2021,VA,Virginia,Albemarle,51003,23190,19430,3760,21632,58,21574,1558,48,1510,21002,17244,3758,16663,13417,3246,1680,295,81,14607
11/1/2021,VA,Virginia,Alexandria City,51510,18941,14606,4335,17666,68,17598,1275,65,1210,15378,11044,4334,9975,6023,3952,2198,322,53,7402
11/1/2021,VA,Virginia,Alleghany,51005,4602,3327,1275,3788,15,3773,814,*,*,4361,3086,1275,3628,2523,1105,805,106,37,2680
11/1/2021,VA,Virginia,Amelia,51007,3268,2132,1136,2832,*,*,436,*,*,3013,1877,1136,2465,1402,1063,454,87,22,1902
11/1/2021,VA,Virginia,Amherst,51009,8112,5581,2531,6882,48,6834,1230,31,1199,7564,5033,2531,6326,3994,2332,1270,219,69,4768
11/1/2021,VA,Virginia,Appomattox,51011,4192,2899,1293,3458,17,3441,734,22,712,3933,2640,1293,3301,2101,1200,779,112,42,2368
11/1/2021,VA,Virginia,Arlington,51013,25911,20493,5418,24397,96,24301,1514,77,1437,20469,15052,5417,13174,8193,4981,3053,414,106,9601
11/1/2021,VA,Virginia,Augusta,51015,19323,14955,4368,17035,64,16971,2288,48,2240,18181,13813,4368,14706,10706,4000,1968,407,131,12200
11/1/2021,VA,Virginia,Bath,51017,1309,1073,236,1153,*,*,156,*,*,1238,1002,236,1001,784,217,169,*,*,791
11/1/2021,VA,Virginia,Bedford,51019,21088,15412,5676,18473,67,18406,2615,47,2568,19675,14000,5675,15947,11135,4812,2087,490,153,13217
11/1/2021,VA,Virginia,Bland,51021,1839,1230,609,1492,*,*,347,*,*,1731,1122,609,1391,906,485,228,59,14,1090
11/1/2021,VA,Virginia,Botetourt,51023,9113,6310,2803,8102,41,8061,1011,17,994,8488,5685,2803,6911,4459,2452,743,164,46,5958
11/1/2021,VA,Virginia,Bristol City,51520,4471,2052,2419,3556,*,*,915,14,901,4204,1785,2419,3656,1327,2329,1096,154,36,2370
11/1/2021,VA,Virginia,Brunswick,51025,4143,2712,1431,3515,30,3485,628,14,614,3879,2448,1431,3185,1870,1315,1071,123,32,1959
11/1/2021,VA,Virginia,Buchanan,51027,6964,3189,3775,4677,18,4659,2287,12,2275,6738,2963,3775,5860,2828,3032,1602,380,84,3794
11/1/2021,VA,Virginia,Buckingham,51029,3805,2677,1128,3163,20,3143,642,16,626,3563,2435,1128,2834,1891,943,792,140,38,1864
11/1/2021,VA,Virginia,Buena Vista City,51530,1505,1060,445,1248,*,*,257,*,*,1404,959,445,1116,720,396,303,58,16,739
11/1/2021,VA,Virginia,Campbell,51031,13490,9270,4220,11434,75,11359,2056,52,2004,12636,8416,4220,10573,6723,3850,2112,399,124,7938
11/1/2021,VA,Virginia,Caroline,51033,6331,4393,1938,5457,36,5421,874,31,843,5735,3797,1938,4118,2361,1757,877,206,34,3001
11/1/2021,VA,Virginia,Carroll,51035,8630,6332,2298,7263,31,7232,1367,17,1350,8221,5923,2298,6632,4585,2047,1560,289,96,4687
11/1/2021,VA,Virginia,Charles City,51036,2016,1318,698,1764,19,1745,252,*,*,1850,1152,698,1480,853,627,259,*,*,1131
11/1/2021,VA,Virginia,Charlotte,51037,3266,2327,939,2738,18,2720,528,14,514,3068,2129,939,2513,1648,865,707,133,33,1640
11/1/2021,VA,Virginia,Charlottesville City,51540,6502,5181,1321,5585,24,5561,917,31,886,5835,4516,1319,4866,3630,1236,1213,162,27,3464
11/1/2021,VA,Virginia,Chesapeake City,51550,41740,29428,12312,36743,282,36461,4997,200,4797,37791,25482,12309,24051,12872,11179,4465,971,184,18431
11/1/2021,VA,Virginia,Chesterfield,51041,66819,46009,20810,59710,256,59454,7109,244,6865,60514,39709,20805,48607,29584,19023,6139,1034,222,41212
11/1/2021,VA,Virginia,Clarke,51043,3646,2930,716,3390,*,*,256,*,*,3295,2579,716,2395,1811,584,296,72,30,1997
11/1/2021,VA,Virginia,Colonial Heights City,51570,4122,3049,1073,3560,15,3545,562,*,*,3801,2728,1073,2654,1671,983,524,102,19,2009
11/1/2021,VA,Virginia,Covington City,51580,1555,1115,440,1196,12,1184,359,*,*,1450,1010,440,1211,792,419,342,*,*,813
11/1/2021,VA,Virginia,Craig,51045,1394,913,481,1127,*,*,267,*,*,1299,818,481,1081,643,438,200,*,*,820
11/1/2021,VA,Virginia,Culpeper,51047,10211,7838,2373,9033,37,8996,1178,31,1147,9263,6890,2373,6783,4858,1925,1274,247,70,5192
11/1/2021,VA,Virginia,Cumberland,51049,2411,1607,804,2033,11,2022,378,*,*,2238,1435,803,1847,1115,732,453,101,22,1271
11/1/2021,VA,Virginia,Danville City,51590,11092,6357,4735,8893,85,8808,2199,107,2092,10416,5681,4735,9076,5241,3835,3264,423,114,5275
11/1/2021,VA,Virginia,Dickenson,51051,4848,1975,2873,3291,*,*,1557,*,*,4670,1797,2873,4031,1475,2556,1115,206,50,2660
11/1/2021,VA,Virginia,Dinwiddie,51053,6233,4164,2069,5197,31,5166,1036,30,1006,5766,3697,2069,4514,2566,1948,946,211,43,3314
11/1/2021,VA,Virginia,Emporia City,51595,1302,754,548,1047,13,1034,255,*,*,1220,672,548,1045,544,501,454,65,12,514
11/1/2021,VA,Virginia,Essex,51057,3070,2125,945,2647,17,2630,423,14,409,2851,1906,945,2247,1446,801,486,85,31,1645
11/1/2021,VA,Virginia,Fairfax,51059,164141,123806,40335,156225,583,155642,7916,395,7521,133121,92805,40316,84418,49620,34798,15069,2699,522,66128
11/1/2021,VA,Virginia,Fairfax City,51600,4110,3068,1042,3863,13,3850,247,11,236,3431,2390,1041,2302,1429,873,404,69,13,1816
11/1/2021,VA,Virginia,Falls Church City,51610,2210,1745,465,2141,*,*,69,*,*,1759,1294,465,1148,733,415,130,*,*,1006
11/1/2021,VA,Virginia,Fauquier,51061,13661,11017,2644,12652,71,12581,1009,34,975,12099,9455,2644,8353,6284,2069,1016,192,57,7088
11/1/2021,VA,Virginia,Floyd,51063,4348,3071,1277,3824,*,*,524,*,*,4067,2791,1276,3335,2137,1198,630,108,28,2569
11/1/2021,VA,Virginia,Fluvanna,51065,6646,5254,1392,6024,25,5999,622,15,607,6058,4666,1392,4631,3447,1184,619,113,28,3871
11/1/2021,VA,Virginia,Franklin,51067,15728,10102,5626,13522,56,13466,2206,36,2170,14823,9197,5626,12418,7304,5114,2099,476,124,9719
11/1/2021,VA,Virginia,Franklin City,51620,2197,1525,672,1811,18,1793,386,21,365,2064,1392,672,1719,1089,630,549,70,11,1089
11/1/2021,VA,Virginia,Frederick,51069,18135,14022,4113,16369,65,16304,1766,40,1726,16499,12388,4111,12023,8579,3444,1543,384,114,9982
11/1/2021,VA,Virginia,Fredericksburg City,51630,4335,3176,1159,3679,19,3660,656,25,631,3858,2699,1159,2785,1723,1062,834,83,28,1840
11/1/2021,VA,Virginia,Galax City,51640,1718,1302,416,1394,*,*,324,*,*,1634,1218,416,1379,996,383,557,54,20,748
11/1/2021,VA,Virginia,Giles,51071,4594,3105,1489,3739,19,3720,855,15,840,4337,2848,1489,3673,2456,1217,778,106,30,2759
11/1/2021,VA,Virginia,Gloucester,51073,9371,7046,2325,8253,45,8208,1118,21,1097,8667,6342,2325,5815,3739,2076,1040,187,48,4540
11/1/2021,VA,Virginia,Goochland,51075,6621,4940,1681,6144,30,6114,477,12,465,6066,4385,1681,5165,3704,1461,452,99,21,4593
11/1/2021,VA,Virginia,Grayson,51077,4679,3261,1418,3935,12,3923,744,*,*,4479,3061,1418,3615,2284,1331,934,169,72,2440
11/1/2021,VA,Virginia,Greene,51079,4238,3368,870,3753,17,3736,485,11,474,3851,2981,870,2921,2129,792,481,93,15,2332
11/1/2021,VA,Virginia,Greensville,51081,2184,1300,884,1788,21,1767,396,12,384,2027,1143,884,1688,900,788,469,105,18,1096
11/1/2021,VA,Virginia,Halifax,51083,10013,7134,2879,8400,43,8357,1613,54,1559,9410,6531,2879,7800,5132,2668,2124,396,125,5155
11/1/2021,VA,Virginia,Hampton City,51650,26555,16898,9657,22307,211,22096,4248,208,4040,24216,14560,9656,15864,6820,9044,4231,788,147,10698
11/1/2021,VA,Virginia,Hanover,51085,23439,16352,7087,21587,94,21493,1852,50,1802,21472,14388,7084,17882,11761,6121,1560,325,71,15926
11/1/2021,VA,Virginia,Harrisonburg City,51660,5650,4457,1193,4839,20,4819,811,20,791,5138,3945,1193,4205,3127,1078,1007,137,43,3018
11/1/2021,VA,Virginia,Henrico,51087,60848,39773,21075,54083,371,53712,6765,295,6470,55254,34179,21075,46688,27562,19126,7128,1392,291,37877
11/1/2021,VA,Virginia,Henry,51089,14865,8657,6208,12043,83,11960,2822,72,2750,14157,7950,6207,12398,6547,5851,3013,733,182,8470
11/1/2021,VA,Virginia,Highland,51091,862,715,147,793,*,*,69,0,69,812,665,147,638,510,128,65,*,*,550
11/1/2021,VA,Virginia,Hopewell City,51670,4561,2943,1618,3615,28,3587,946,26,920,4231,2613,1618,3122,1576,1546,1059,163,26,1874
11/1/2021,VA,Virginia,Isle of Wight,51093,9070,6486,2584,8091,43,8048,979,34,945,8368,5784,2584,6096,3705,2391,1003,203,61,4829
11/1/2021,VA,Virginia,James City,51095,22424,17955,4469,21144,66,21078,1280,32,1248,20784,16319,4465,13938,10359,3579,1021,223,54,12640
11/1/2021,VA,Virginia,King and Queen,51097,1857,1320,537,1609,*,*,248,*,*,1737,1200,537,1359,877,482,282,*,*,1002
11/1/2021,VA,Virginia,King George,51099,4378,3488,890,3858,23,3835,520,18,502,3799,2909,890,2095,1287,808,493,73,24,1505
11/1/2021,VA,Virginia,King William,51101,3749,2692,1057,3258,32,3226,491,25,466,3476,2419,1057,2897,1933,964,440,100,19,2338
11/1/2021,VA,Virginia,Lancaster,51103,4440,3467,973,4135,20,4115,305,13,292,4162,3190,972,3159,2387,772,488,100,11,2560
11/1/2021,VA,Virginia,Lee,51105,6399,2566,3833,4611,14,4597,1788,15,1773,6096,2266,3830,5157,1711,3446,1918,230,56,2953
11/1/2021,VA,Virginia,Lexington City,51678,1332,1055,277,1221,*,*,111,*,*,1235,959,276,986,738,248,172,*,*,777
11/1/2021,VA,Virginia,Loudoun,51107,43874,32974,10900,41436,166,41270,2438,129,2309,36511,25618,10893,25686,16247,9439,3835,685,152,21014
11/1/2021,VA,Virginia,Louisa,51109,9258,6652,2606,8005,47,7958,1253,30,1223,8478,5872,2606,6539,4211,2328,1193,253,49,5044
11/1/2021,VA,Virginia,Lunenburg,51111,3252,2268,984,2742,16,2726,510,*,*,3049,2065,984,2421,1509,912,771,117,36,1497
11/1/2021,VA,Virginia,Lynchburg City,51680,14788,9985,4803,12333,84,12249,2455,96,2359,13798,8995,4803,11663,7203,4460,2953,446,117,8147
11/1/2021,VA,Virginia,Madison,51113,3460,2695,765,3122,*,*,338,*,*,3221,2456,765,2457,1808,649,419,82,18,1938
11/1/2021,VA,Virginia,Manassas City,51683,4981,3518,1463,4483,21,4462,498,37,461,4213,2750,1463,3084,1789,1295,557,107,25,2395
11/1/2021,VA,Virginia,Manassas Park City,51685,1428,886,542,1251,*,*,177,11,166,1205,663,542,900,401,499,238,*,*,596
11/1/2021,VA,Virginia,Martinsville City,51690,3825,2165,1660,2926,35,2891,899,35,864,3624,1964,1660,3196,1591,1605,1256,177,44,1719
11/1/2021,VA,Virginia,Mathews,51115,2976,2275,701,2749,11,2738,227,*,*,2808,2107,701,2114,1521,593,288,37,16,1773
11/1/2021,VA,Virginia,Mecklenburg,51117,9538,6603,2935,8089,48,8041,1449,57,1392,8967,6032,2935,7299,4650,2649,1813,386,80,5020
11/1/2021,VA,Virginia,Middlesex,51119,3758,2863,895,3427,16,3411,331,*,*,3534,2639,895,2757,2007,750,449,80,17,2211
11/1/2021,VA,Virginia,Montgomery,51121,14718,10816,3902,12547,58,12489,2171,32,2139,13259,9357,3902,11234,7664,3570,1971,332,88,8843
11/1/2021,VA,Virginia,Nelson,51125,4931,3785,1146,4477,15,4462,454,*,*,4602,3457,1145,3492,2492,1000,583,114,22,2773
11/1/2021,VA,Virginia,New Kent,51127,5249,3887,1362,4755,21,4734,494,16,478,4791,3429,1362,3550,2424,1126,345,86,16,3103
11/1/2021,VA,Virginia,Newport News City,51700,30062,18962,11100,25194,207,24987,4868,221,4647,27500,16401,11099,19012,8498,10514,5397,905,177,12533
11/1/2021,VA,Virginia,Norfolk City,51710,34795,21621,13174,28745,282,28463,6050,300,5750,31308,18136,13172,22300,9781,12519,7695,1343,226,13036
11/1/2021,VA,Virginia,Northampton,51131,3883,2717,1166,3451,20,3431,432,17,415,3635,2469,1166,2976,1926,1050,888,87,26,1975
11/1/2021,VA,Virginia,Northumberland,51133,4814,3731,1083,4484,*,*,330,11,319,4506,3423,1083,3219,2390,829,451,87,25,2656
11/1/2021,VA,Virginia,Norton City,51720,1108,524,584,785,*,*,323,*,*,1042,459,583,902,376,526,335,*,*,505
11/1/2021,VA,Virginia,Nottoway,51135,3638,2490,1148,3035,23,3012,603,15,588,3382,2234,1148,2737,1713,1024,839,139,36,1723
11/1/2021,VA,Virginia,Orange,51137,9169,6996,2173,8193,49,8144,976,37,939,8395,6222,2173,5964,4171,1793,991,209,46,4718
11/1/2021,VA,Virginia,Page,51139,6448,4929,1519,5405,15,5390,1043,20,1023,6030,4511,1519,4639,3280,1359,1110,241,54,3234
11/1/2021,VA,Virginia,Patrick,51141,5548,3633,1915,4678,*,*,870,11,859,5284,3370,1914,4398,2651,1747,1033,195,57,3113
11/1/2021,VA,Virginia,Petersburg City,51730,7247,4085,3162,5503,83,5420,1744,77,1667,6618,3456,3162,5200,2147,3053,2226,334,53,2587
11/1/2021,VA,Virginia,Pittsylvania,51143,16861,10421,6440,14189,96,14093,2672,67,2605,15891,9451,6440,13585,8435,5150,3053,546,140,9846
11/1/2021,VA,Virginia,Poquoson City,51735,2686,2201,485,2509,*,*,177,*,*,2464,1979,485,1373,936,437,117,*,*,1220
11/1/2021,VA,Virginia,Portsmouth City,51740,18772,11601,7171,15016,170,14846,3756,190,3566,16925,9755,7170,11903,5052,6851,4241,707,111,6844
11/1/2021,VA,Virginia,Powhatan,51145,6678,4917,1761,6112,14,6098,566,14,552,6167,4406,1761,5087,3529,1558,407,111,24,4545
11/1/2021,VA,Virginia,Prince Edward,51147,4803,3302,1501,3969,30,3939,834,27,807,4439,2939,1500,3610,2242,1368,1058,165,42,2345
11/1/2021,VA,Virginia,Prince George,51149,6640,5122,1518,5684,32,5652,956,33,923,6137,4619,1518,3953,2577,1376,658,138,31,3126
11/1/2021,VA,Virginia,Prince William,51153,54668,39803,14865,49669,290,49379,4999,290,4709,46653,31791,14862,28744,15364,13380,5769,1231,213,21531
11/1/2021,VA,Virginia,Pulaski,51155,9262,6549,2713,7552,28,7524,1710,30,1680,8653,5940,2713,7252,4810,2442,1585,275,78,5314
11/1/2021,VA,Virginia,Radford City,51750,2105,1513,592,1744,*,*,361,*,*,1893,1301,592,1638,1085,553,336,44,18,1240
11/1/2021,VA,Virginia,Rappahannock,51157,2098,1742,356,1968,*,*,130,*,*,1895,1540,355,1371,1090,281,163,*,*,1162
11/1/2021,VA,Virginia,Richmond,51159,2013,1438,575,1770,*,*,243,*,*,1875,1300,575,1460,995,465,333,70,13,1044
11/1/2021,VA,Virginia,Richmond City,51760,35018,19651,15367,28701,263,28438,6317,286,6031,31703,16339,15364,27595,12948,14647,9033,1296,244,17022
11/1/2021,VA,Virginia,Roanoke,51161,24647,17078,7569,22097,100,21997,2550,53,2497,22808,15242,7566,18980,12292,6688,2137,469,117,16257
11/1/2021,VA,Virginia,Roanoke City,51770,21373,12526,8847,16822,146,16676,4551,138,4413,19592,10746,8846,16500,8214,8286,4878,915,181,10526
11/1/2021,VA,Virginia,Rockbridge,51163,6620,4936,1684,5753,*,*,867,*,*,6156,4472,1684,4801,3301,1500,870,171,53,3707
11/1/2021,VA,Virginia,Rockingham,51165,18866,15155,3711,16839,47,16792,2027,40,1987,17520,13810,3710,14339,11065,3274,1820,499,126,11894
11/1/2021,VA,Virginia,Russell,51167,8022,3964,4058,5850,14,5836,2172,19,2153,7712,3655,4057,6782,3335,3447,1708,327,106,4641
11/1/2021,VA,Virginia,Salem City,51775,6159,4374,1785,5292,27,5265,867,15,852,5646,3861,1785,4644,3006,1638,810,125,40,3669
11/1/2021,VA,Virginia,Scott,51169,6757,2537,4220,5237,11,5226,1520,11,1509,6488,2268,4220,5764,1759,4005,1528,265,84,3887
11/1/2021,VA,Virginia,Shenandoah,51171,11089,8453,2636,9957,24,9933,1132,17,1115,10391,7756,2635,7792,5535,2257,1285,264,70,6173
11/1/2021,VA,Virginia,Smyth,51173,8641,5200,3441,6631,18,6613,2010,26,1984,8195,4754,3441,6966,3679,3287,2054,354,118,4440
11/1/2021,VA,Virginia,Southampton,51175,4196,3033,1163,3589,28,3561,607,22,585,3889,2727,1162,3123,2066,1057,697,136,32,2258
11/1/2021,VA,Virginia,Spotsylvania,51177,23855,17539,6316,21130,112,21018,2725,100,2625,21214,14899,6315,13692,8111,5581,2336,532,113,10711
11/1/2021,VA,Virginia,Stafford,51179,19881,15631,4250,17876,105,17771,2005,92,1913,17425,13178,4247,9560,5826,3734,1634,397,61,7468
11/1/2021,VA,Virginia,Staunton City,51790,6363,4827,1536,5403,24,5379,960,13,947,5994,4458,1536,4848,3443,1405,1112,150,46,3540
11/1/2021,VA,Virginia,Suffolk City,51800,17983,12324,5659,15152,133,15019,2831,110,2721,16478,10819,5659,11482,6222,5260,2855,517,87,8023
11/1/2021,VA,Virginia,Surry,51181,1807,1215,592,1577,11,1566,230,*,*,1667,1075,592,1264,701,563,234,47,11,972
11/1/2021,VA,Virginia,Sussex,51183,2564,1639,925,2117,24,2093,447,14,433,2393,1468,925,1920,1040,880,525,140,19,1236
11/1/2021,VA,Virginia,Tazewell,51185,11970,6699,5271,9161,34,9127,2809,35,2774,11403,6134,5269,9394,5225,4169,2329,476,118,6471
11/1/2021,VA,Virginia,Unknown,51999,*,*,*,*,*,*,*,*,*,*,*,*,*,*,*,*,*,*,*
11/1/2021,VA,Virginia,Virginia Beach City,51810,78222,58125,20097,70052,355,69697,8170,313,7857,71674,51587,20087,43483,25135,18348,7441,1546,345,34151
11/1/2021,VA,Virginia,Warren,51187,8448,6511,1937,7462,28,7434,986,27,959,7678,5741,1937,5518,3903,1615,956,230,63,4269
11/1/2021,VA,Virginia,Washington,51191,15678,8610,7068,12980,35,12945,2698,31,2667,14834,7767,7067,12582,6019,6563,2438,627,158,9359
11/1/2021,VA,Virginia,Waynesboro City,51820,5134,3818,1316,4309,19,4290,825,25,800,4821,3505,1316,3948,2706,1242,915,123,43,2867
11/1/2021,VA,Virginia,Westmoreland,51193,5375,4063,1312,4809,24,4785,566,16,550,4889,3577,1312,3345,2184,1161,837,136,39,2333
11/1/2021,VA,Virginia,Williamsburg City,51830,2949,2262,687,2709,*,*,240,*,*,2731,2044,687,2002,1405,597,293,*,*,1663
11/1/2021,VA,Virginia,Winchester City,51840,5668,4357,1311,4924,25,4899,744,20,724,5178,3867,1311,3930,2793,1137,920,144,34,2832
11/1/2021,VA,Virginia,Wise,51195,10581,4434,6147,7481,25,7456,3100,24,3076,10027,3880,6147,8368,3022,5346,2399,471,135,5363
11/1/2021,VA,Virginia,Wythe,51197,8002,5086,2916,6388,34,6354,1614,13,1601,7591,4675,2916,6386,3711,2675,1633,303,76,4374
11/1/2021,VA,Virginia,York,51199,13103,10532,2571,12144,41,12103,959,37,922,11973,9402,2571,6650,4398,2252,756,162,36,5696
10/1/2021,VA,Virginia,Accomack,51001,9466,6983,2483,8330,51,8279,1136,39,1097,8780,6300,2480,6645,4513,2132,1549,371,72,4653
10/1/2021,VA,Virginia,Albemarle,51003,23166,19413,3753,21606,58,21548,1560,46,1514,20968,17217,3751,16644,13410,3234,1681,299,80,14584
10/1/2021,VA,Virginia,Alexandria City,51510,18935,14609,4326,17655,69,17586,1280,66,1214,15378,11053,4325,9972,6024,3948,2192,321,54,7405
10/1/2021,VA,Virginia,Alleghany,51005,4610,3332,1278,3794,16,3778,816,*,*,4369,3091,1278,3634,2526,1108,806,107,36,2685
10/1/2021,VA,Virginia,Amelia,51007,3255,2116,1139,2823,*,*,432,*,*,3004,1865,1139,2462,1397,1065,449,90,21,1902
10/1/2021,VA,Virginia,Amherst,51009,8117,5584,2533,6889,49,6840,1228,31,1197,7569,5036,2533,6324,3992,2332,1268,218,67,4771
10/1/2021,VA,Virginia,Appomattox,51011,4198,2904,1294,3465,17,3448,733,22,711,3937,2643,1294,3299,2100,1199,779,111,42,2367
10/1/2021,VA,Virginia,Arlington,51013,25874,20479,5395,24363,100,24263,1511,77,1434,20457,15063,5394,13164,8204,4960,3051,417,108,9588
10/1/2021,VA,Virginia,Augusta,51015,19342,14969,4373,17051,64,16987,2291,48,2243,18192,13819,4373,14721,10715,4006,1963,409,132,12217
10/1/2021,VA,Virginia,Bath,51017,1309,1072,237,1152,*,*,157,*,*,1237,1000,237,1005,787,218,168,*,*,796
10/1/2021,VA,Virginia,Bedford,51019,21059,15397,5662,18450,69,18381,2609,47,2562,19656,13995,5661,15936,11139,4797,2076,495,150,13215
10/1/2021,VA,Virginia,Bland,51021,1836,1228,608,1491,*,*,345,*,*,1729,1121,608,1386,901,485,228,59,14,1085
10/1/2021,VA,Virginia,Botetourt,51023,9114,6313,2801,8103,46,8057,1011,19,992,8480,5679,2801,6904,4455,2449,741,167,46,5950
10/1/2021,VA,Virginia,Bristol City,51520,4477,2058,2419,3565,*,*,912,14,898,4212,1793,2419,3659,1331,2328,1098,154,36,2371
10/1/2021,VA,Virginia,Brunswick,51025,4139,2709,1430,3513,31,3482,626,15,611,3876,2446,1430,3184,1871,1313,1070,121,32,1961
10/1/2021,VA,Virginia,Buchanan,51027,6983,3195,3788,4695,19,4676,2288,12,2276,6757,2969,3788,5876,2834,3042,1601,382,82,3811
10/1/2021,VA,Virginia,Buckingham,51029,3807,2681,1126,3166,20,3146,641,16,625,3565,2439,1126,2839,1897,942,791,141,39,1868
10/1/2021,VA,Virginia,Buena Vista City,51530,1510,1063,447,1253,*,*,257,*,*,1407,960,447,1122,723,399,304,58,15,745
10/1/2021,VA,Virginia,Campbell,51031,13504,9295,4209,11452,80,11372,2052,53,1999,12648,8439,4209,10589,6747,3842,2106,400,124,7959
10/1/2021,VA,Virginia,Caroline,51033,6322,4386,1936,5452,37,5415,870,31,839,5728,3792,1936,4112,2359,1753,877,205,35,2995
10/1/2021,VA,Virginia,Carroll,51035,8653,6343,2310,7286,33,7253,1367,17,1350,8247,5937,2310,6647,4589,2058,1568,286,96,4697
10/1/2021,VA,Virginia,Charles City,51036,2011,1316,695,1761,19,1742,250,*,*,1848,1153,695,1476,852,624,257,*,*,1131
10/1/2021,VA,Virginia,Charlotte,51037,3267,2327,940,2739,19,2720,528,14,514,3067,2127,940,2512,1646,866,707,133,33,1639
10/1/2021,VA,Virginia,Charlottesville City,51540,6495,5167,1328,5580,24,5556,915,32,883,5835,4509,1326,4856,3613,1243,1209,159,27,3461
10/1/2021,VA,Virginia,Chesapeake City,51550,41692,29385,12307,36711,288,36423,4981,199,4782,37761,25457,12304,24028,12862,11166,4449,976,181,18422
10/1/2021,VA,Virginia,Chesterfield,51041,66666,45899,20767,59579,265,59314,7087,244,6843,60374,39612,20762,48499,29516,18983,6088,1049,222,41140
10/1/2021,VA,Virginia,Clarke,51043,3649,2938,711,3395,*,*,254,*,*,3292,2581,711,2391,1813,578,296,73,30,1992
10/1/2021,VA,Virginia,Colonial Heights City,51570,4138,3065,1073,3574,15,3559,564,*,*,3816,2743,1073,2665,1683,982,529,101,18,2017
10/1/2021,VA,Virginia,Covington City,51580,1556,1111,445,1198,12,1186,358,*,*,1453,1008,445,1217,792,425,346,*,*,816
10/1/2021,VA,Virginia,Craig,51045,1394,912,482,1125,*,*,269,*,*,1301,819,482,1082,643,439,199,*,*,821
10/1/2021,VA,Virginia,Culpeper,51047,10222,7856,2366,9043,39,9004,1179,32,1147,9263,6897,2366,6792,4873,1919,1277,246,68,5201
10/1/2021,VA,Virginia,Cumberland,51049,2415,1607,808,2036,11,2025,379,*,*,2241,1434,807,1848,1112,736,455,102,20,1271
10/1/2021,VA,Virginia,Danville City,51590,11099,6368,4731,8904,90,8814,2195,108,2087,10426,5695,4731,9088,5251,3837,3270,428,110,5280
10/1/2021,VA,Virginia,Dickenson,51051,4854,1980,2874,3302,*,*,1552,*,*,4677,1803,2874,4036,1481,2555,1116,206,52,2662
10/1/2021,VA,Virginia,Dinwiddie,51053,6238,4173,2065,5202,31,5171,1036,30,1006,5775,3710,2065,4511,2567,1944,937,214,42,3318
10/1/2021,VA,Virginia,Emporia City,51595,1304,759,545,1049,13,1036,255,*,*,1222,677,545,1040,542,498,455,65,12,508
10/1/2021,VA,Virginia,Essex,51057,3066,2124,942,2648,17,2631,418,14,404,2852,1910,942,2248,1450,798,485,85,30,1648
10/1/2021,VA,Virginia,Fairfax,51059,163727,123517,40210,155823,595,155228,7904,397,7507,132818,92628,40190,84202,49531,34671,15002,2715,524,65961
10/1/2021,VA,Virginia,Fairfax City,51600,4101,3059,1042,3854,13,3841,247,11,236,3422,2381,1041,2293,1420,873,402,69,13,1809
10/1/2021,VA,Virginia,Falls Church City,51610,2205,1740,465,2136,*,*,69,*,*,1759,1294,465,1148,733,415,129,*,*,1007
10/1/2021,VA,Virginia,Fauquier,51061,13631,11001,2630,12624,74,12550,1007,35,972,12083,9453,2630,8331,6278,2053,1012,189,56,7074
10/1/2021,VA,Virginia,Floyd,51063,4350,3080,1270,3827,12,3815,523,*,*,4065,2796,1269,3332,2138,1194,628,107,28,2569
10/1/2021,VA,Virginia,Fluvanna,51065,6635,5245,1390,6015,25,5990,620,15,605,6050,4660,1390,4630,3448,1182,615,116,28,3871
10/1/2021,VA,Virginia,Franklin,51067,15711,10082,5629,13515,57,13458,2196,36,2160,14814,9185,5629,12413,7296,5117,2094,477,121,9721
10/1/2021,VA,Virginia,Franklin City,51620,2201,1529,672,1813,18,1795,388,22,366,2068,1396,672,1722,1092,630,549,72,11,1090
10/1/2021,VA,Virginia,Frederick,51069,18143,14023,4120,16384,66,16318,1759,40,1719,16499,12381,4118,12028,8580,3448,1536,378,113,10001
10/1/2021,VA,Virginia,Fredericksburg City,51630,4334,3177,1157,3679,19,3660,655,25,630,3857,2700,1157,2778,1720,1058,828,83,27,1840
10/1/2021,VA,Virginia,Galax City,51640,1725,1307,418,1401,*,*,324,*,*,1641,1223,418,1388,1003,385,562,56,19,751
10/1/2021,VA,Virginia,Giles,51071,4593,3105,1488,3738,19,3719,855,16,839,4341,2853,1488,3675,2459,1216,777,106,32,2760
10/1/2021,VA,Virginia,Gloucester,51073,9355,7028,2327,8237,47,8190,1118,21,1097,8650,6324,2326,5813,3737,2076,1037,186,48,4542
10/1/2021,VA,Virginia,Goochland,51075,6596,4920,1676,6121,30,6091,475,12,463,6048,4372,1676,5148,3693,1455,449,101,21,4577
10/1/2021,VA,Virginia,Grayson,51077,4680,3266,1414,3940,12,3928,740,*,*,4478,3064,1414,3608,2281,1327,930,170,71,2437
10/1/2021,VA,Virginia,Greene,51079,4228,3352,876,3748,17,3731,480,*,*,3840,2964,876,2917,2120,797,474,95,15,2333
10/1/2021,VA,Virginia,Greensville,51081,2181,1297,884,1787,21,1766,394,12,382,2027,1143,884,1689,903,786,470,105,18,1096
10/1/2021,VA,Virginia,Halifax,51083,10013,7139,2874,8408,44,8364,1605,53,1552,9410,6536,2874,7803,5140,2663,2124,398,121,5160
10/1/2021,VA,Virginia,Hampton City,51650,26524,16874,9650,22285,212,22073,4239,209,4030,24188,14540,9648,15858,6814,9044,4204,794,148,10712
10/1/2021,VA,Virginia,Hanover,51085,23415,16323,7092,21559,96,21463,1856,50,1806,21453,14364,7089,17873,11747,6126,1564,322,70,15917
10/1/2021,VA,Virginia,Harrisonburg City,51660,5641,4442,1199,4833,20,4813,808,20,788,5143,3944,1199,4213,3129,1084,1007,140,42,3024
10/1/2021,VA,Virginia,Henrico,51087,60741,39709,21032,54009,381,53628,6732,292,6440,55197,34165,21032,46622,27543,19079,7064,1409,287,37862
10/1/2021,VA,Virginia,Henry,51089,14903,8677,6226,12087,84,12003,2816,73,2743,14201,7976,6225,12438,6571,5867,3017,740,179,8502
10/1/2021,VA,Virginia,Highland,51091,856,709,147,786,*,*,70,0,70,807,660,147,636,507,129,65,*,*,547
10/1/2021,VA,Virginia,Hopewell City,51670,4559,2941,1618,3614,28,3586,945,26,919,4233,2615,1618,3120,1575,1545,1055,162,26,1877
10/1/2021,VA,Virginia,Isle of Wight,51093,9061,6474,2587,8084,45,8039,977,34,943,8377,5790,2587,6097,3703,2394,1002,204,61,4830
10/1/2021,VA,Virginia,James City,51095,22401,17939,4462,21120,67,21053,1281,32,1249,20769,16311,4458,13927,10354,3573,1018,227,55,12627
10/1/2021,VA,Virginia,King and Queen,51097,1854,1322,532,1608,*,*,246,*,*,1734,1202,532,1353,876,477,279,*,*,1000
10/1/2021,VA,Virginia,King George,51099,4370,3484,886,3852,23,3829,518,18,500,3791,2905,886,2088,1284,804,493,72,23,1500
10/1/2021,VA,Virginia,King William,51101,3743,2689,1054,3255,33,3222,488,25,463,3470,2416,1054,2896,1934,962,441,100,19,2336
10/1/2021,VA,Virginia,Lancaster,51103,4436,3459,977,4130,21,4109,306,13,293,4163,3187,976,3164,2391,773,487,96,11,2570
10/1/2021,VA,Virginia,Lee,51105,6402,2568,3834,4614,14,4600,1788,16,1772,6102,2271,3831,5161,1712,3449,1924,229,57,2951
10/1/2021,VA,Virginia,Lexington City,51678,1333,1054,279,1223,*,*,110,*,*,1236,958,278,993,743,250,172,*,*,782
10/1/2021,VA,Virginia,Loudoun,51107,43730,32878,10852,41303,170,41133,2427,128,2299,36431,25586,10845,25591,16200,9391,3782,688,153,20968
10/1/2021,VA,Virginia,Louisa,51109,9250,6653,2597,7999,49,7950,1251,31,1220,8474,5877,2597,6532,4214,2318,1187,256,49,5040
10/1/2021,VA,Virginia,Lunenburg,51111,3254,2269,985,2747,16,2731,507,*,*,3048,2063,985,2424,1509,915,771,118,36,1499
10/1/2021,VA,Virginia,Lynchburg City,51680,14795,9999,4796,12343,87,12256,2452,96,2356,13810,9014,4796,11672,7217,4455,2953,443,117,8159
10/1/2021,VA,Virginia,Madison,51113,3459,2700,759,3123,*,*,336,*,*,3215,2456,759,2450,1807,643,415,84,16,1935
10/1/2021,VA,Virginia,Manassas City,51683,4968,3519,1449,4467,22,4445,501,37,464,4203,2754,1449,3076,1796,1280,557,110,25,2384
10/1/2021,VA,Virginia,Manassas Park City,51685,1427,888,539,1251,11,1240,176,11,165,1202,663,539,902,404,498,235,*,*,600
10/1/2021,VA,Virginia,Martinsville City,51690,3821,2165,1656,2929,37,2892,892,35,857,3620,1964,1656,3190,1589,1601,1243,180,43,1724
10/1/2021,VA,Virginia,Mathews,51115,2977,2278,699,2748,11,2737,229,*,*,2808,2109,699,2110,1519,591,287,37,16,1770
10/1/2021,VA,Virginia,Mecklenburg,51117,9530,6589,2941,8084,49,8035,1446,58,1388,8969,6028,2941,7299,4644,2655,1809,389,80,5021
10/1/2021,VA,Virginia,Middlesex,51119,3760,2862,898,3431,16,3415,329,*,*,3540,2642,898,2758,2009,749,443,80,18,2217
10/1/2021,VA,Virginia,Montgomery,51121,14697,10799,3898,12532,58,12474,2165,31,2134,13257,9359,3898,11229,7659,3570,1965,334,87,8843
10/1/2021,VA,Virginia,Nelson,51125,4922,3786,1136,4469,15,4454,453,*,*,4589,3454,1135,3488,2497,991,581,112,22,2773
10/1/2021,VA,Virginia,New Kent,51127,5226,3869,1357,4735,21,4714,491,16,475,4768,3411,1357,3530,2409,1121,334,87,16,3093
10/1/2021,VA,Virginia,Newport News City,51700,30029,18956,11073,25174,210,24964,4855,221,4634,27481,16409,11072,18986,8499,10487,5365,910,175,12536
10/1/2021,VA,Virginia,Norfolk City,51710,34731,21584,13147,28696,286,28410,6035,302,5733,31260,18115,13145,22249,9752,12497,7629,1358,226,13036
10/1/2021,VA,Virginia,Northampton,51131,3886,2720,1166,3454,21,3433,432,17,415,3640,2474,1166,2979,1928,1051,885,89,26,1979
10/1/2021,VA,Virginia,Northumberland,51133,4819,3734,1085,4489,*,*,330,12,318,4512,3427,1085,3218,2386,832,454,86,25,2653
10/1/2021,VA,Virginia,Norton City,51720,1106,522,584,784,*,*,322,*,*,1040,457,583,903,376,527,334,*,*,509
10/1/2021,VA,Virginia,Nottoway,51135,3639,2494,1145,3034,24,3010,605,15,590,3388,2243,1145,2738,1716,1022,843,137,36,1722
10/1/2021,VA,Virginia,Orange,51137,9170,6997,2173,8201,49,8152,969,36,933,8394,6221,2173,5965,4174,1791,987,213,46,4719
10/1/2021,VA,Virginia,Page,51139,6454,4934,1520,5414,15,5399,1040,20,1020,6035,4515,1520,4630,3269,1361,1106,243,52,3229
10/1/2021,VA,Virginia,Patrick,51141,5552,3638,1914,4683,*,*,869,11,858,5285,3372,1913,4405,2659,1746,1041,194,58,3112
10/1/2021,VA,Virginia,Petersburg City,51730,7255,4099,3156,5513,84,5429,1742,77,1665,6624,3468,3156,5204,2151,3053,2216,335,51,2602
10/1/2021,VA,Virginia,Pittsylvania,51143,16866,10417,6449,14200,99,14101,2666,67,2599,15909,9460,6449,13598,8438,5160,3035,555,145,9863
10/1/2021,VA,Virginia,Poquoson City,51735,2675,2189,486,2498,*,*,177,*,*,2453,1967,486,1370,932,438,117,*,*,1216
10/1/2021,VA,Virginia,Portsmouth City,51740,18765,11611,7154,15021,177,14844,3744,194,3550,16915,9762,7153,11897,5066,6831,4240,703,108,6846
10/1/2021,VA,Virginia,Powhatan,51145,6676,4919,1757,6110,14,6096,566,14,552,6164,4407,1757,5085,3533,1552,408,111,24,4542
10/1/2021,VA,Virginia,Prince Edward,51147,4805,3300,1505,3973,31,3942,832,28,804,4442,2938,1504,3615,2243,1372,1057,164,42,2352
10/1/2021,VA,Virginia,Prince George,51149,6630,5125,1505,5672,34,5638,958,33,925,6131,4626,1505,3948,2582,1366,659,134,30,3125
10/1/2021,VA,Virginia,Prince William,51153,54529,39711,14818,49560,300,49260,4969,290,4679,46570,31755,14815,28669,15334,13335,5718,1229,205,21517
10/1/2021,VA,Virginia,Pulaski,51155,9254,6540,2714,7547,29,7518,1707,30,1677,8648,5934,2714,7253,4810,2443,1574,274,71,5334
10/1/2021,VA,Virginia,Radford City,51750,2104,1509,595,1744,*,*,360,*,*,1895,1300,595,1642,1087,555,338,44,17,1243
10/1/2021,VA,Virginia,Rappahannock,51157,2096,1738,358,1967,*,*,129,*,*,1893,1536,357,1373,1092,281,165,*,*,1163
10/1/2021,VA,Virginia,Richmond,51159,2022,1450,572,1779,*,*,243,*,*,1880,1308,572,1464,1001,463,333,72,13,1046
10/1/2021,VA,Virginia,Richmond City,51760,35020,19653,15367,28699,268,28431,6321,289,6032,31695,16331,15364,27593,12954,14639,9003,1307,241,17042
10/1/2021,VA,Virginia,Roanoke,51161,24619,17062,7557,22072,101,21971,2547,54,2493,22794,15240,7554,18966,12287,6679,2134,471,116,16245
10/1/2021,VA,Virginia,Roanoke City,51770,21385,12537,8848,16840,150,16690,4545,140,4405,19603,10756,8847,16509,8228,8281,4868,919,175,10547
10/1/2021,VA,Virginia,Rockbridge,51163,6620,4935,1685,5753,*,*,867,*,*,6156,4471,1685,4808,3306,1502,873,171,54,3710
10/1/2021,VA,Virginia,Rockingham,51165,18847,15139,3708,16828,49,16779,2019,40,1979,17507,13799,3708,14321,11051,3270,1816,501,124,11880
10/1/2021,VA,Virginia,Russell,51167,8028,3957,4071,5863,15,5848,2165,20,2145,7721,3651,4070,6793,3335,3458,1706,333,107,4647
10/1/2021,VA,Virginia,Salem City,51775,6146,4363,1783,5283,27,5256,863,15,848,5639,3856,1783,4638,3001,1637,802,127,40,3669
10/1/2021,VA,Virginia,Scott,51169,6760,2537,4223,5242,12,5230,1518,11,1507,6489,2266,4223,5768,1757,4011,1530,266,85,3887
10/1/2021,VA,Virginia,Shenandoah,51171,11099,8452,2647,9964,25,9939,1135,17,1118,10402,7756,2646,7809,5547,2262,1282,261,71,6195
10/1/2021,VA,Virginia,Smyth,51173,8661,5213,3448,6657,19,6638,2004,27,1977,8221,4773,3448,6985,3692,3293,2054,356,117,4458
10/1/2021,VA,Virginia,Southampton,51175,4192,3031,1161,3586,28,3558,606,23,583,3890,2729,1161,3123,2068,1055,702,136,32,2253
10/1/2021,VA,Virginia,Spotsylvania,51177,23817,17511,6306,21103,119,20984,2714,100,2614,21188,14883,6305,13664,8095,5569,2309,531,114,10710
10/1/2021,VA,Virginia,Stafford,51179,19821,15595,4226,17825,108,17717,1996,92,1904,17373,13150,4223,9535,5822,3713,1625,398,62,7450
10/1/2021,VA,Virginia,Staunton City,51790,6369,4830,1539,5414,24,5390,955,13,942,5999,4460,1539,4860,3452,1408,1103,156,45,3556
10/1/2021,VA,Virginia,Suffolk City,51800,17979,12347,5632,15150,133,15017,2829,110,2719,16474,10842,5632,11482,6244,5238,2860,518,86,8018
10/1/2021,VA,Virginia,Surry,51181,1804,1211,593,1572,11,1561,232,*,*,1666,1073,593,1265,702,563,236,48,11,970
10/1/2021,VA,Virginia,Sussex,51183,2562,1635,927,2116,25,2091,446,14,432,2389,1462,927,1918,1036,882,523,140,18,1237
10/1/2021,VA,Virginia,Tazewell,51185,11994,6710,5284,9190,35,9155,2804,36,2768,11429,6147,5282,9412,5232,4180,2323,482,117,6490
10/1/2021,VA,Virginia,Unknown,51999,*,*,*,*,*,*,*,*,*,*,*,*,*,*,*,*,*,*,*
10/1/2021,VA,Virginia,Virginia Beach City,51810,78085,58032,20053,69936,367,69569,8149,315,7834,71573,51530,20043,43427,25128,18299,7404,1554,345,34124
10/1/2021,VA,Virginia,Warren,51187,8444,6506,1938,7460,30,7430,984,27,957,7670,5732,1938,5523,3907,1616,967,231,61,4264
10/1/2021,VA,Virginia,Washington,51191,15684,8612,7072,13006,37,12969,2678,31,2647,14831,7760,7071,12582,6014,6568,2417,633,154,9378
10/1/2021,VA,Virginia,Waynesboro City,51820,5136,3823,1313,4309,20,4289,827,24,803,4827,3514,1313,3949,2710,1239,905,124,41,2879
10/1/2021,VA,Virginia,Westmoreland,51193,5364,4061,1303,4802,24,4778,562,16,546,4871,3568,1303,3331,2177,1154,829,140,38,2324
10/1/2021,VA,Virginia,Williamsburg City,51830,2954,2270,684,2712,*,*,242,*,*,2733,2049,684,2003,1409,594,297,*,*,1660
10/1/2021,VA,Virginia,Winchester City,51840,5664,4354,1310,4920,25,4895,744,20,724,5177,3867,1310,3934,2798,1136,917,146,34,2837
10/1/2021,VA,Virginia,Wise,51195,10580,4437,6143,7488,27,7461,3092,24,3068,10030,3887,6143,8371,3030,5341,2398,472,137,5364
10/1/2021,VA,Virginia,Wythe,51197,8016,5093,2923,6406,36,6370,1610,13,1597,7602,4679,2923,6399,3720,2679,1630,306,77,4386
10/1/2021,VA,Virginia,York,51199,13068,10500,2568,12119,44,12075,949,38,911,11950,9382,2568,6645,4396,2249,747,161,34,5703
9/1/2021,VA,Virginia,Accomack,51001,9464,6997,2467,8328,51,8277,1136,40,1096,8778,6314,2464,6629,4512,2117,1543,375,69,4642
9/1/2021,VA,Virginia,Albemarle,51003,23104,19373,3731,21549,58,21491,1555,47,1508,20904,17175,3729,16585,13367,3218,1676,298,80,14531
9/1/2021,VA,Virginia,Alexandria City,51510,18876,14576,4300,17605,69,17536,1271,66,1205,15337,11038,4299,9942,6020,3922,2171,320,54,7397
9/1/2021,VA,Virginia,Alleghany,51005,4614,3335,1279,3796,17,3779,818,*,*,4376,3097,1279,3636,2527,1109,810,108,35,2683
9/1/2021,VA,Virginia,Amelia,51007,3254,2115,1139,2825,*,*,429,*,*,3007,1868,1139,2464,1398,1066,453,87,23,1901
9/1/2021,VA,Virginia,Amherst,51009,8113,5587,2526,6890,50,6840,1223,30,1193,7562,5036,2526,6315,3991,2324,1263,216,69,4767
9/1/2021,VA,Virginia,Appomattox,51011,4205,2910,1295,3472,17,3455,733,22,711,3946,2651,1295,3302,2102,1200,782,110,41,2369
9/1/2021,VA,Virginia,Arlington,51013,25802,20417,5385,24296,101,24195,1506,77,1429,20418,15034,5384,13138,8186,4952,3052,411,109,9566
9/1/2021,VA,Virginia,Augusta,51015,19336,14988,4348,17056,66,16990,2280,47,2233,18188,13840,4348,14702,10718,3984,1948,414,131,12209
9/1/2021,VA,Virginia,Bath,51017,1308,1074,234,1153,*,*,155,*,*,1235,1001,234,999,784,215,167,*,*,791
9/1/2021,VA,Virginia,Bedford,51019,21019,15389,5630,18421,70,18351,2598,47,2551,19608,13979,5629,15903,11142,4761,2071,495,149,13188
9/1/2021,VA,Virginia,Bland,51021,1847,1238,609,1500,*,*,347,*,*,1738,1129,609,1389,903,486,232,58,15,1084
9/1/2021,VA,Virginia,Botetourt,51023,9117,6332,2785,8108,48,8060,1009,20,989,8483,5698,2785,6903,4469,2434,742,167,44,5950
9/1/2021,VA,Virginia,Bristol City,51520,4483,2063,2420,3574,*,*,909,15,894,4215,1795,2420,3664,1332,2332,1092,157,35,2380
9/1/2021,VA,Virginia,Brunswick,51025,4134,2721,1413,3511,31,3480,623,16,607,3874,2461,1413,3172,1875,1297,1071,120,32,1949
9/1/2021,VA,Virginia,Buchanan,51027,7012,3219,3793,4714,19,4695,2298,13,2285,6788,2995,3793,5899,2856,3043,1604,388,81,3826
9/1/2021,VA,Virginia,Buckingham,51029,3798,2677,1121,3159,20,3139,639,16,623,3557,2436,1121,2830,1894,936,787,140,39,1864
9/1/2021,VA,Virginia,Buena Vista City,51530,1505,1058,447,1246,*,*,259,*,*,1404,957,447,1123,725,398,305,60,13,745
9/1/2021,VA,Virginia,Campbell,51031,13485,9307,4178,11445,80,11365,2040,53,1987,12632,8454,4178,10578,6768,3810,2105,401,123,7949
9/1/2021,VA,Virginia,Caroline,51033,6319,4397,1922,5449,37,5412,870,31,839,5723,3801,1922,4106,2364,1742,870,205,33,2998
9/1/2021,VA,Virginia,Carroll,51035,8646,6344,2302,7280,34,7246,1366,17,1349,8244,5942,2302,6647,4599,2048,1568,284,96,4699
9/1/2021,VA,Virginia,Charles City,51036,2016,1325,691,1765,19,1746,251,*,*,1852,1161,691,1473,853,620,257,*,*,1128
9/1/2021,VA,Virginia,Charlotte,51037,3266,2326,940,2738,19,2719,528,14,514,3062,2122,940,2516,1649,867,704,131,32,1649
9/1/2021,VA,Virginia,Charlottesville City,51540,6493,5163,1330,5579,25,5554,914,31,883,5837,4509,1328,4859,3614,1245,1212,159,28,3460
9/1/2021,VA,Virginia,Chesapeake City,51550,41601,29348,12253,36633,289,36344,4968,200,4768,37691,25441,12250,23960,12846,11114,4427,981,178,18374
9/1/2021,VA,Virginia,Chesterfield,51041,66501,45798,20703,59434,271,59163,7067,243,6824,60247,39548,20699,48394,29476,18918,6052,1050,222,41070
9/1/2021,VA,Virginia,Clarke,51043,3634,2924,710,3383,*,*,251,*,*,3286,2576,710,2386,1809,577,299,73,28,1986
9/1/2021,VA,Virginia,Colonial Heights City,51570,4138,3070,1068,3574,15,3559,564,*,*,3813,2745,1068,2659,1681,978,526,101,20,2012
9/1/2021,VA,Virginia,Covington City,51580,1559,1114,445,1199,12,1187,360,*,*,1457,1012,445,1217,792,425,345,*,*,818
9/1/2021,VA,Virginia,Craig,51045,1392,915,477,1125,*,*,267,*,*,1299,822,477,1081,646,435,197,*,*,822
9/1/2021,VA,Virginia,Culpeper,51047,10195,7839,2356,9022,39,8983,1173,31,1142,9236,6880,2356,6761,4857,1904,1275,244,67,5175
9/1/2021,VA,Virginia,Cumberland,51049,2419,1607,812,2039,11,2028,380,*,*,2247,1436,811,1851,1112,739,455,99,20,1277
9/1/2021,VA,Virginia,Danville City,51590,11117,6402,4715,8929,90,8839,2188,109,2079,10438,5723,4715,9088,5267,3821,3271,427,109,5281
9/1/2021,VA,Virginia,Dickenson,51051,4861,1990,2871,3309,11,3298,1552,*,*,4683,1812,2871,4039,1486,2553,1120,208,52,2659
9/1/2021,VA,Virginia,Dinwiddie,51053,6224,4166,2058,5192,31,5161,1032,30,1002,5758,3700,2058,4511,2572,1939,929,215,42,3325
9/1/2021,VA,Virginia,Emporia City,51595,1305,760,545,1053,13,1040,252,*,*,1224,679,545,1044,546,498,452,68,11,513
9/1/2021,VA,Virginia,Essex,51057,3074,2134,940,2654,18,2636,420,15,405,2859,1919,940,2254,1460,794,485,87,29,1653
9/1/2021,VA,Virginia,Fairfax,51059,163132,123192,39940,155255,599,154656,7877,397,7480,132394,92473,39921,83870,49442,34428,14918,2709,521,65722
9/1/2021,VA,Virginia,Fairfax City,51600,4090,3048,1042,3847,14,3833,243,11,232,3414,2373,1041,2291,1420,871,400,68,14,1809
9/1/2021,VA,Virginia,Falls Church City,51610,2196,1734,462,2127,*,*,69,*,*,1753,1291,462,1148,735,413,129,*,*,1007
9/1/2021,VA,Virginia,Fauquier,51061,13601,10994,2607,12597,76,12521,1004,35,969,12053,9446,2607,8310,6280,2030,1013,189,57,7051
9/1/2021,VA,Virginia,Floyd,51063,4343,3085,1258,3821,13,3808,522,*,*,4055,2798,1257,3318,2137,1181,627,109,27,2555
9/1/2021,VA,Virginia,Fluvanna,51065,6609,5227,1382,5987,25,5962,622,16,606,6023,4641,1382,4599,3425,1174,607,116,28,3848
9/1/2021,VA,Virginia,Franklin,51067,15686,10074,5612,13494,61,13433,2192,35,2157,14793,9181,5612,12388,7287,5101,2088,474,120,9706
9/1/2021,VA,Virginia,Franklin City,51620,2205,1531,674,1817,19,1798,388,22,366,2075,1401,674,1728,1097,631,553,74,11,1090
9/1/2021,VA,Virginia,Frederick,51069,18123,14024,4099,16376,68,16308,1747,42,1705,16493,12396,4097,12002,8574,3428,1514,383,114,9991
9/1/2021,VA,Virginia,Fredericksburg City,51630,4323,3186,1137,3668,20,3648,655,25,630,3842,2705,1137,2763,1725,1038,825,83,24,1831
9/1/2021,VA,Virginia,Galax City,51640,1732,1319,413,1408,*,*,324,*,*,1649,1236,413,1397,1014,383,563,58,20,756
9/1/2021,VA,Virginia,Giles,51071,4597,3117,1480,3744,19,3725,853,17,836,4342,2862,1480,3675,2467,1208,769,109,30,2767
9/1/2021,VA,Virginia,Gloucester,51073,9340,7030,2310,8228,49,8179,1112,22,1090,8624,6315,2309,5804,3744,2060,1034,186,47,4537
9/1/2021,VA,Virginia,Goochland,51075,6591,4907,1684,6115,30,6085,476,12,464,6044,4360,1684,5144,3682,1462,447,102,21,4574
9/1/2021,VA,Virginia,Grayson,51077,4687,3279,1408,3946,12,3934,741,*,*,4483,3075,1408,3606,2284,1322,929,173,71,2433
9/1/2021,VA,Virginia,Greene,51079,4229,3363,866,3747,17,3730,482,11,471,3838,2972,866,2913,2127,786,471,95,15,2332
9/1/2021,VA,Virginia,Greensville,51081,2174,1296,878,1781,21,1760,393,12,381,2024,1146,878,1687,905,782,469,106,18,1094
9/1/2021,VA,Virginia,Halifax,51083,10013,7157,2856,8414,47,8367,1599,55,1544,9410,6554,2856,7788,5143,2645,2117,396,119,5156
9/1/2021,VA,Virginia,Hampton City,51650,26501,16895,9606,22276,219,22057,4225,211,4014,24162,14558,9604,15818,6810,9008,4206,800,143,10669
9/1/2021,VA,Virginia,Hanover,51085,23378,16309,7069,21527,98,21429,1851,53,1798,21405,14339,7066,17829,11724,6105,1556,323,70,15880
9/1/2021,VA,Virginia,Harrisonburg City,51660,5630,4441,1189,4823,21,4802,807,20,787,5132,3943,1189,4206,3132,1074,999,143,42,3022
9/1/2021,VA,Virginia,Henrico,51087,60685,39697,20988,53964,387,53577,6721,294,6427,55152,34164,20988,46569,27536,19033,7058,1402,288,37821
9/1/2021,VA,Virginia,Henry,51089,14921,8695,6226,12106,87,12019,2815,73,2742,14214,7989,6225,12456,6589,5867,3017,744,175,8520
9/1/2021,VA,Virginia,Highland,51091,852,706,146,781,*,*,71,0,71,806,660,146,633,505,128,63,*,*,545
9/1/2021,VA,Virginia,Hopewell City,51670,4559,2949,1610,3610,29,3581,949,26,923,4239,2629,1610,3126,1585,1541,1055,164,28,1879
9/1/2021,VA,Virginia,Isle of Wight,51093,9057,6486,2571,8079,46,8033,978,34,944,8376,5805,2571,6092,3710,2382,1002,203,62,4825
9/1/2021,VA,Virginia,James City,51095,22387,17952,4435,21112,69,21043,1275,32,1243,20752,16321,4431,13915,10369,3546,1018,226,53,12618
9/1/2021,VA,Virginia,King and Queen,51097,1849,1325,524,1604,*,*,245,*,*,1729,1205,524,1348,879,469,278,*,*,996
9/1/2021,VA,Virginia,King George,51099,4364,3485,879,3847,23,3824,517,18,499,3790,2911,879,2088,1293,795,493,73,23,1499
9/1/2021,VA,Virginia,King William,51101,3735,2693,1042,3248,33,3215,487,25,462,3462,2420,1042,2882,1933,949,438,100,18,2326
9/1/2021,VA,Virginia,Lancaster,51103,4438,3457,981,4131,21,4110,307,13,294,4160,3180,980,3163,2393,770,486,95,12,2570
9/1/2021,VA,Virginia,Lee,51105,6412,2584,3828,4623,14,4609,1789,16,1773,6116,2291,3825,5169,1725,3444,1930,227,58,2954
9/1/2021,VA,Virginia,Lexington City,51678,1333,1059,274,1224,*,*,109,*,*,1236,963,273,992,746,246,173,*,*,780
9/1/2021,VA,Virginia,Loudoun,51107,43567,32766,10801,41153,174,40979,2414,126,2288,36316,25522,10794,25515,16177,9338,3771,687,151,20906
9/1/2021,VA,Virginia,Louisa,51109,9229,6644,2585,7978,50,7928,1251,33,1218,8460,5875,2585,6525,4218,2307,1187,256,49,5033
9/1/2021,VA,Virginia,Lunenburg,51111,3256,2281,975,2748,16,2732,508,*,*,3049,2074,975,2419,1513,906,767,118,36,1498
9/1/2021,VA,Virginia,Lynchburg City,51680,14779,10020,4759,12344,90,12254,2435,96,2339,13787,9028,4759,11648,7232,4416,2945,439,118,8146
9/1/2021,VA,Virginia,Madison,51113,3452,2696,756,3115,11,3104,337,*,*,3207,2451,756,2443,1805,638,414,84,15,1930
9/1/2021,VA,Virginia,Manassas City,51683,4947,3507,1440,4449,24,4425,498,37,461,4188,2748,1440,3064,1793,1271,552,113,25,2374
9/1/2021,VA,Virginia,Manassas Park City,51685,1424,886,538,1248,13,1235,176,11,165,1205,667,538,905,408,497,238,*,*,601
9/1/2021,VA,Virginia,Martinsville City,51690,3817,2176,1641,2928,38,2890,889,33,856,3611,1970,1641,3179,1594,1585,1238,181,42,1718
9/1/2021,VA,Virginia,Mathews,51115,2980,2282,698,2750,11,2739,230,*,*,2810,2112,698,2110,1518,592,290,38,17,1765
9/1/2021,VA,Virginia,Mecklenburg,51117,9522,6599,2923,8078,49,8029,1444,59,1385,8957,6034,2923,7293,4657,2636,1800,390,81,5022
9/1/2021,VA,Virginia,Middlesex,51119,3769,2864,905,3436,16,3420,333,*,*,3549,2644,905,2772,2017,755,443,80,18,2231
9/1/2021,VA,Virginia,Montgomery,51121,14694,10801,3893,12534,62,12472,2160,31,2129,13259,9366,3893,11238,7671,3567,1963,339,87,8849
9/1/2021,VA,Virginia,Nelson,51125,4913,3780,1133,4460,15,4445,453,*,*,4576,3444,1132,3478,2489,989,578,111,24,2765
9/1/2021,VA,Virginia,New Kent,51127,5211,3865,1346,4726,23,4703,485,16,469,4750,3404,1346,3515,2406,1109,328,84,16,3087
9/1/2021,VA,Virginia,Newport News City,51700,29990,18990,11000,25145,215,24930,4845,225,4620,27436,16437,10999,18936,8512,10424,5342,909,175,12510
9/1/2021,VA,Virginia,Norfolk City,51710,34699,21605,13094,28672,288,28384,6027,305,5722,31249,18157,13092,22244,9795,12449,7617,1358,226,13043
9/1/2021,VA,Virginia,Northampton,51131,3887,2726,1161,3453,21,3432,434,17,417,3641,2480,1161,2983,1938,1045,886,89,27,1981
9/1/2021,VA,Virginia,Northumberland,51133,4824,3736,1088,4496,*,*,328,11,317,4515,3427,1088,3216,2384,832,453,87,25,2651
9/1/2021,VA,Virginia,Norton City,51720,1114,531,583,791,*,*,323,*,*,1047,465,582,907,382,525,333,*,*,512
9/1/2021,VA,Virginia,Nottoway,51135,3637,2493,1144,3035,26,3009,602,15,587,3386,2242,1144,2738,1720,1018,844,137,35,1722
9/1/2021,VA,Virginia,Orange,51137,9159,7000,2159,8195,49,8146,964,35,929,8394,6235,2159,5963,4187,1776,988,212,45,4718
9/1/2021,VA,Virginia,Page,51139,6445,4938,1507,5410,16,5394,1035,20,1015,6025,4518,1507,4627,3278,1349,1099,242,51,3235
9/1/2021,VA,Virginia,Patrick,51141,5546,3649,1897,4682,*,*,864,11,853,5277,3381,1896,4397,2668,1729,1037,196,58,3106
9/1/2021,VA,Virginia,Petersburg City,51730,7253,4111,3142,5510,84,5426,1743,78,1665,6619,3477,3142,5195,2154,3041,2208,336,51,2600
9/1/2021,VA,Virginia,Pittsylvania,51143,16863,10434,6429,14200,107,14093,2663,69,2594,15914,9485,6429,13594,8453,5141,3020,550,146,9878
9/1/2021,VA,Virginia,Poquoson City,51735,2661,2180,481,2484,*,*,177,*,*,2441,1960,481,1358,925,433,113,*,*,1207
9/1/2021,VA,Virginia,Portsmouth City,51740,18742,11642,7100,15002,180,14822,3740,192,3548,16903,9804,7099,11873,5091,6782,4224,708,106,6835
9/1/2021,VA,Virginia,Powhatan,51145,6666,4910,1756,6100,14,6086,566,14,552,6154,4398,1756,5087,3534,1553,409,111,24,4543
9/1/2021,VA,Virginia,Prince Edward,51147,4805,3306,1499,3979,32,3947,826,27,799,4448,2950,1498,3620,2256,1364,1056,164,41,2359
9/1/2021,VA,Virginia,Prince George,51149,6607,5118,1489,5655,34,5621,952,32,920,6113,4624,1489,3942,2589,1353,651,134,30,3127
9/1/2021,VA,Virginia,Prince William,51153,54314,39615,14699,49356,309,49047,4958,293,4665,46389,31693,14696,28536,15312,13224,5692,1223,205,21416
9/1/2021,VA,Virginia,Pulaski,51155,9261,6556,2705,7553,29,7524,1708,31,1677,8661,5956,2705,7250,4815,2435,1574,276,71,5329
9/1/2021,VA,Virginia,Radford City,51750,2106,1515,591,1746,*,*,360,*,*,1900,1309,591,1642,1091,551,337,44,17,1244
9/1/2021,VA,Virginia,Rappahannock,51157,2092,1742,350,1963,*,*,129,*,*,1889,1540,349,1365,1094,271,164,*,*,1156
9/1/2021,VA,Virginia,Richmond,51159,2019,1449,570,1775,*,*,244,*,*,1878,1308,570,1459,1000,459,333,73,11,1042
9/1/2021,VA,Virginia,Richmond City,51760,35019,19698,15321,28698,274,28424,6321,290,6031,31680,16362,15318,27570,12979,14591,8990,1311,236,17033
9/1/2021,VA,Virginia,Roanoke,51161,24607,17058,7549,22065,103,21962,2542,53,2489,22793,15247,7546,18949,12281,6668,2129,468,118,16234
9/1/2021,VA,Virginia,Roanoke City,51770,21389,12581,8808,16857,151,16706,4532,139,4393,19594,10787,8807,16496,8255,8241,4836,918,174,10568
9/1/2021,VA,Virginia,Rockbridge,51163,6617,4940,1677,5752,*,*,865,*,*,6156,4479,1677,4794,3301,1493,860,177,53,3704
9/1/2021,VA,Virginia,Rockingham,51165,18848,15158,3690,16836,50,16786,2012,41,1971,17503,13813,3690,14312,11058,3254,1811,506,126,11869
9/1/2021,VA,Virginia,Russell,51167,8046,3973,4073,5883,17,5866,2163,20,2143,7740,3668,4072,6807,3351,3456,1708,333,110,4656
9/1/2021,VA,Virginia,Salem City,51775,6157,4375,1782,5294,28,5266,863,15,848,5652,3870,1782,4651,3015,1636,807,127,40,3677
9/1/2021,VA,Virginia,Scott,51169,6759,2537,4222,5245,13,5232,1514,12,1502,6490,2268,4222,5773,1763,4010,1527,266,86,3894
9/1/2021,VA,Virginia,Shenandoah,51171,11085,8436,2649,9957,26,9931,1128,17,1111,10387,7739,2648,7797,5534,2263,1271,260,72,6194
9/1/2021,VA,Virginia,Smyth,51173,8682,5242,3440,6675,22,6653,2007,28,1979,8247,4807,3440,6999,3714,3285,2058,356,118,4467
9/1/2021,VA,Virginia,Southampton,51175,4176,3023,1153,3574,29,3545,602,23,579,3873,2720,1153,3107,2060,1047,693,136,30,2248
9/1/2021,VA,Virginia,Spotsylvania,51177,23739,17502,6237,21043,122,20921,2696,101,2595,21121,14885,6236,13599,8096,5503,2284,536,112,10667
9/1/2021,VA,Virginia,Stafford,51179,19742,15540,4202,17762,111,17651,1980,91,1889,17305,13106,4199,9497,5813,3684,1616,394,64,7423
9/1/2021,VA,Virginia,Staunton City,51790,6370,4842,1528,5419,25,5394,951,13,938,6004,4476,1528,4861,3466,1395,1094,157,47,3563
9/1/2021,VA,Virginia,Suffolk City,51800,17955,12331,5624,15130,134,14996,2825,115,2710,16453,10829,5624,11477,6251,5226,2853,513,86,8025
9/1/2021,VA,Virginia,Surry,51181,1805,1214,591,1571,13,1558,234,*,*,1666,1075,591,1263,702,561,232,48,11,972
9/1/2021,VA,Virginia,Sussex,51183,2555,1635,920,2110,26,2084,445,14,431,2380,1460,920,1905,1031,874,517,141,18,1229
9/1/2021,VA,Virginia,Tazewell,51185,11980,6717,5263,9181,35,9146,2799,36,2763,11419,6158,5261,9398,5240,4158,2318,481,115,6484
9/1/2021,VA,Virginia,Unknown,51999,*,*,*,*,*,*,*,*,*,*,*,*,*,*,*,*,*,*,*
9/1/2021,VA,Virginia,Virginia Beach City,51810,77983,58026,19957,69839,376,69463,8144,321,7823,71474,51527,19947,43357,25146,18211,7402,1568,342,34045
9/1/2021,VA,Virginia,Warren,51187,8428,6511,1917,7445,30,7415,983,28,955,7656,5739,1917,5502,3905,1597,955,234,61,4252
9/1/2021,VA,Virginia,Washington,51191,15675,8620,7055,12997,37,12960,2678,30,2648,14827,7773,7054,12581,6030,6551,2407,633,152,9389
9/1/2021,VA,Virginia,Waynesboro City,51820,5137,3829,1308,4315,22,4293,822,23,799,4833,3525,1308,3953,2720,1233,907,126,40,2880
9/1/2021,VA,Virginia,Westmoreland,51193,5364,4071,1293,4804,26,4778,560,16,544,4872,3579,1293,3330,2184,1146,830,142,38,2320
9/1/2021,VA,Virginia,Williamsburg City,51830,2947,2267,680,2707,11,2696,240,*,*,2730,2050,680,2005,1413,592,299,*,*,1660
9/1/2021,VA,Virginia,Winchester City,51840,5659,4358,1301,4919,25,4894,740,20,720,5174,3873,1301,3931,2806,1125,911,144,34,2842
9/1/2021,VA,Virginia,Wise,51195,10588,4460,6128,7499,28,7471,3089,24,3065,10034,3906,6128,8381,3055,5326,2392,475,140,5374
9/1/2021,VA,Virginia,Wythe,51197,8019,5108,2911,6408,37,6371,1611,13,1598,7612,4701,2911,6401,3735,2666,1628,310,78,4385
9/1/2021,VA,Virginia,York,51199,13026,10464,2562,12080,44,12036,946,38,908,11916,9354,2562,6633,4389,2244,748,162,34,5689
4/1/2022,VA,Virginia,Accomack,51001,9593,6704,2889,8478,57,8421,1115,41,1074,8881,5993,2888,6859,4331,2528,1572,373,64,4850
4/1/2022,VA,Virginia,Albemarle,51003,23708,19143,4565,22229,60,22169,1479,47,1432,21457,16894,4563,17203,13166,4037,1713,304,61,15125
4/1/2022,VA,Virginia,Alexandria City,51510,19040,14252,4788,17825,83,17742,1215,71,1144,15437,10651,4786,10265,5872,4393,2213,327,52,7673
4/1/2022,VA,Virginia,Alleghany,51005,4645,3203,1442,3863,20,3843,782,*,*,4392,2950,1442,3702,2431,1271,826,116,30,2730
4/1/2022,VA,Virginia,Amelia,51007,3304,2048,1256,2890,11,2879,414,13,401,3041,1785,1256,2516,1334,1182,471,90,18,1937
4/1/2022,VA,Virginia,Amherst,51009,8168,5256,2912,7013,55,6958,1155,29,1126,7612,4700,2912,6415,3722,2693,1267,234,62,4852
4/1/2022,VA,Virginia,Appomattox,51011,4264,2814,1450,3561,23,3538,703,26,677,3985,2536,1449,3356,2013,1343,793,108,39,2416
4/1/2022,VA,Virginia,Arlington,51013,25956,19826,6130,24516,111,24405,1440,70,1370,20506,14377,6129,13590,7899,5691,3099,414,99,9978
4/1/2022,VA,Virginia,Augusta,51015,19468,14371,5097,17282,74,17208,2186,44,2142,18309,13212,5097,15012,10331,4681,2010,431,120,12451
4/1/2022,VA,Virginia,Bath,51017,1310,1037,273,1175,*,*,135,*,*,1242,969,273,1018,764,254,160,31,12,815
4/1/2022,VA,Virginia,Bedford,51019,21289,14705,6584,18806,74,18732,2483,50,2433,19832,13248,6584,16342,10643,5699,2092,520,138,13592
4/1/2022,VA,Virginia,Bland,51021,1843,1153,690,1518,*,*,325,*,*,1736,1046,690,1415,841,574,223,57,13,1122
4/1/2022,VA,Virginia,Botetourt,51023,9161,6087,3074,8195,49,8146,966,19,947,8546,5472,3074,7010,4321,2689,747,173,34,6056
4/1/2022,VA,Virginia,Bristol City,51520,4491,1921,2570,3625,*,*,866,16,850,4214,1644,2570,3704,1236,2468,1071,159,29,2445
4/1/2022,VA,Virginia,Brunswick,51025,4153,2517,1636,3548,27,3521,605,16,589,3895,2259,1636,3234,1723,1511,1032,135,24,2043
4/1/2022,VA,Virginia,Buchanan,51027,6823,2957,3866,4715,20,4695,2108,12,2096,6583,2717,3866,5769,2623,3146,1553,389,75,3752
4/1/2022,VA,Virginia,Buckingham,51029,3830,2464,1366,3229,26,3203,601,17,584,3584,2219,1365,2902,1710,1192,787,137,33,1945
4/1/2022,VA,Virginia,Buena Vista City,51530,1480,967,513,1220,*,*,260,*,*,1381,868,513,1110,651,459,304,47,17,742
4/1/2022,VA,Virginia,Campbell,51031,13540,8718,4822,11598,77,11521,1942,58,1884,12666,7844,4822,10775,6338,4437,2123,394,115,8143
4/1/2022,VA,Virginia,Caroline,51033,6382,4184,2198,5548,28,5520,834,33,801,5747,3549,2198,4223,2227,1996,875,200,42,3106
4/1/2022,VA,Virginia,Carroll,51035,8715,5924,2791,7405,38,7367,1310,18,1292,8318,5527,2791,6804,4275,2529,1551,303,80,4870
4/1/2022,VA,Virginia,Charles City,51036,2019,1249,770,1774,20,1754,245,*,*,1861,1091,770,1508,811,697,265,*,*,1146
4/1/2022,VA,Virginia,Charlotte,51037,3254,2173,1081,2746,23,2723,508,14,494,3050,1969,1081,2532,1540,992,694,127,24,1687
4/1/2022,VA,Virginia,Charlottesville City,51540,6317,4758,1559,5502,31,5471,815,29,786,5665,4108,1557,4772,3299,1473,1114,156,17,3485
4/1/2022,VA,Virginia,Chesapeake City,51550,42251,28580,13671,37473,299,37174,4778,177,4601,38200,24530,13670,24782,12344,12438,4525,1010,172,19075
4/1/2022,VA,Virginia,Chesterfield,51041,67668,44832,22836,60882,277,60605,6786,238,6548,61276,38445,22831,49734,28815,20919,6225,1055,193,42261
4/1/2022,VA,Virginia,Clarke,51043,3738,2899,839,3501,13,3488,237,*,*,3374,2535,839,2486,1782,704,308,75,25,2078
4/1/2022,VA,Virginia,Colonial Heights City,51570,4096,2923,1173,3557,21,3536,539,*,*,3774,2601,1173,2660,1587,1073,530,110,19,2001
4/1/2022,VA,Virginia,Covington City,51580,1551,1041,510,1204,13,1191,347,*,*,1448,938,510,1216,729,487,347,*,*,805
4/1/2022,VA,Virginia,Craig,51045,1385,848,537,1140,*,*,245,*,*,1299,762,537,1089,602,487,199,*,*,827
4/1/2022,VA,Virginia,Culpeper,51047,10331,7567,2764,9209,48,9161,1122,29,1093,9342,6578,2764,7006,4713,2293,1263,240,59,5444
4/1/2022,VA,Virginia,Cumberland,51049,2404,1500,904,2045,13,2032,359,*,*,2225,1321,904,1857,1032,825,453,99,18,1287
4/1/2022,VA,Virginia,Danville City,51590,11026,5858,5168,8959,90,8869,2067,109,1958,10362,5194,5168,9120,4866,4254,3212,431,97,5380
4/1/2022,VA,Virginia,Dickenson,51051,4831,1841,2990,3371,13,3358,1460,*,*,4650,1660,2990,4038,1372,2666,1102,214,37,2685
4/1/2022,VA,Virginia,Dinwiddie,51053,6287,3947,2340,5293,36,5257,994,29,965,5814,3474,2340,4596,2413,2183,944,220,39,3393
4/1/2022,VA,Virginia,Emporia City,51595,1318,693,625,1076,17,1059,242,*,*,1228,603,625,1068,491,577,457,*,*,541
4/1/2022,VA,Virginia,Essex,51057,3082,2023,1059,2696,15,2681,386,14,372,2868,1809,1059,2287,1366,921,483,84,28,1692
4/1/2022,VA,Virginia,Fairfax,51059,164519,120538,43981,157009,657,156352,7510,396,7114,133257,89295,43962,86818,48394,38424,15384,2717,481,68236
4/1/2022,VA,Virginia,Fairfax City,51600,4193,3063,1130,3953,15,3938,240,*,*,3491,2362,1129,2392,1447,945,405,71,11,1905
4/1/2022,VA,Virginia,Falls Church City,51610,2233,1706,527,2158,*,*,75,*,*,1786,1259,527,1191,725,466,129,*,*,1046
4/1/2022,VA,Virginia,Fauquier,51061,13775,10671,3104,12823,75,12748,952,35,917,12182,9079,3103,8586,6080,2506,1003,193,46,7344
4/1/2022,VA,Virginia,Floyd,51063,4403,2940,1463,3892,14,3878,511,*,*,4114,2652,1462,3404,2033,1371,621,116,27,2640
4/1/2022,VA,Virginia,Fluvanna,51065,6855,5177,1678,6249,30,6219,606,16,590,6253,4575,1678,4844,3385,1459,645,112,23,4064
4/1/2022,VA,Virginia,Franklin,51067,15804,9755,6049,13712,59,13653,2092,36,2056,14862,8813,6049,12552,7037,5515,2070,493,110,9879
4/1/2022,VA,Virginia,Franklin City,51620,2206,1421,785,1839,18,1821,367,16,351,2078,1293,785,1756,1011,745,547,*,*,1132
4/1/2022,VA,Virginia,Frederick,51069,18476,13749,4727,16783,74,16709,1693,43,1650,16761,12036,4725,12377,8357,4020,1525,397,98,10357
4/1/2022,VA,Virginia,Fredericksburg City,51630,4342,3051,1291,3731,23,3708,611,24,587,3858,2568,1290,2810,1614,1196,808,91,28,1883
4/1/2022,VA,Virginia,Galax City,51640,1695,1193,502,1398,*,*,297,*,*,1614,1112,502,1369,899,470,534,54,18,763
4/1/2022,VA,Virginia,Giles,51071,4539,2867,1672,3737,14,3723,802,16,786,4304,2632,1672,3694,2248,1446,748,116,26,2804
4/1/2022,VA,Virginia,Gloucester,51073,9620,6844,2776,8573,45,8528,1047,24,1023,8912,6136,2776,6118,3619,2499,1053,195,46,4824
4/1/2022,VA,Virginia,Goochland,51075,6872,4997,1875,6432,37,6395,440,11,429,6285,4410,1875,5389,3743,1646,445,104,16,4824
4/1/2022,VA,Virginia,Grayson,51077,4701,3100,1601,3983,16,3967,718,*,*,4500,2899,1601,3670,2171,1499,916,175,64,2515
4/1/2022,VA,Virginia,Greene,51079,4313,3243,1070,3845,15,3830,468,*,*,3916,2846,1070,3022,2044,978,478,103,15,2426
4/1/2022,VA,Virginia,Greensville,51081,2211,1224,987,1829,30,1799,382,12,370,2044,1057,987,1735,843,892,463,112,21,1139
4/1/2022,VA,Virginia,Halifax,51083,10042,6734,3308,8500,62,8438,1542,57,1485,9438,6130,3308,7913,4853,3060,2088,397,113,5315
4/1/2022,VA,Virginia,Hampton City,51650,26764,15975,10789,22719,243,22476,4045,198,3847,24400,13613,10787,16387,6353,10034,4262,831,139,11155
4/1/2022,VA,Virginia,Hanover,51085,23801,16049,7752,22051,106,21945,1750,58,1692,21834,14085,7749,18385,11613,6772,1584,328,61,16412
4/1/2022,VA,Virginia,Harrisonburg City,51660,5672,4208,1464,4907,24,4883,765,21,744,5153,3689,1464,4317,2967,1350,984,156,32,3145
4/1/2022,VA,Virginia,Henrico,51087,61386,38632,22754,54899,417,54482,6487,294,6193,55686,32934,22752,47524,26760,20764,7219,1427,264,38614
4/1/2022,VA,Virginia,Henry,51089,14826,8096,6730,12159,97,12062,2667,62,2605,14093,7364,6729,12460,6113,6347,2999,733,160,8568
4/1/2022,VA,Virginia,Highland,51091,879,696,183,803,*,*,76,0,76,835,652,183,666,501,165,77,*,*,564
4/1/2022,VA,Virginia,Hopewell City,51670,4583,2770,1813,3682,35,3647,901,29,872,4239,2426,1813,3197,1465,1732,1052,169,22,1954
4/1/2022,VA,Virginia,Isle of Wight,51093,9200,6287,2913,8255,58,8197,945,36,909,8479,5567,2912,6224,3522,2702,1005,199,61,4959
4/1/2022,VA,Virginia,James City,51095,22727,17573,5154,21514,66,21448,1213,36,1177,21083,15933,5150,14470,10222,4248,1039,226,45,13160
4/1/2022,VA,Virginia,King and Queen,51097,1845,1241,604,1617,11,1606,228,*,*,1739,1135,604,1392,847,545,281,*,*,1036
4/1/2022,VA,Virginia,King George,51099,4430,3398,1032,3950,23,3927,480,17,463,3822,2790,1032,2164,1228,936,489,85,22,1568
4/1/2022,VA,Virginia,King William,51101,3814,2588,1226,3342,34,3308,472,25,447,3524,2298,1226,2973,1840,1133,440,101,15,2417
4/1/2022,VA,Virginia,Lancaster,51103,4472,3346,1126,4170,19,4151,302,13,289,4183,3058,1125,3235,2296,939,490,*,*,2638
4/1/2022,VA,Virginia,Lee,51105,6450,2381,4069,4754,22,4732,1696,17,1679,6145,2079,4066,5235,1569,3666,1930,236,53,3016
4/1/2022,VA,Virginia,Lexington City,51678,1317,996,321,1218,*,*,99,*,*,1218,898,320,983,690,293,169,*,*,778
4/1/2022,VA,Virginia,Loudoun,51107,45013,32900,12113,42684,175,42509,2329,123,2206,37390,25286,12104,26730,16155,10575,3917,710,141,21962
4/1/2022,VA,Virginia,Louisa,51109,9458,6442,3016,8265,48,8217,1193,30,1163,8629,5613,3016,6749,4047,2702,1170,257,50,5272
4/1/2022,VA,Virginia,Lunenburg,51111,3247,2094,1153,2769,19,2750,478,*,*,3046,1893,1153,2457,1386,1071,762,123,25,1547
4/1/2022,VA,Virginia,Lynchburg City,51680,14795,9368,5427,12475,97,12378,2320,80,2240,13796,8369,5427,11784,6730,5054,2947,460,102,8275
4/1/2022,VA,Virginia,Madison,51113,3500,2589,911,3168,*,*,332,*,*,3250,2340,910,2534,1752,782,422,85,18,2009
4/1/2022,VA,Virginia,Manassas City,51683,5050,3436,1614,4591,23,4568,459,32,427,4245,2631,1614,3155,1709,1446,566,112,19,2458
4/1/2022,VA,Virginia,Manassas Park City,51685,1424,820,604,1254,16,1238,170,13,157,1196,592,604,935,378,557,234,*,*,643
4/1/2022,VA,Virginia,Martinsville City,51690,3809,2032,1777,2969,38,2931,840,29,811,3600,1823,1777,3179,1474,1705,1245,168,39,1727
4/1/2022,VA,Virginia,Mathews,51115,3014,2222,792,2789,21,2768,225,*,*,2841,2049,792,2168,1485,683,289,41,12,1826
4/1/2022,VA,Virginia,Mecklenburg,51117,9571,6234,3337,8203,62,8141,1368,48,1320,8976,5639,3337,7368,4324,3044,1763,414,72,5119
4/1/2022,VA,Virginia,Middlesex,51119,3770,2750,1020,3463,18,3445,307,*,*,3541,2521,1020,2792,1912,880,442,83,12,2255
4/1/2022,VA,Virginia,Montgomery,51121,14765,10365,4400,12724,68,12656,2041,30,2011,13288,8888,4400,11374,7296,4078,1956,330,82,9006
4/1/2022,VA,Virginia,Nelson,51125,4937,3608,1329,4504,15,4489,433,*,*,4587,3258,1329,3523,2354,1169,548,113,19,2843
4/1/2022,VA,Virginia,New Kent,51127,5437,3861,1576,4956,25,4931,481,18,463,4981,3405,1576,3740,2425,1315,349,94,18,3279
4/1/2022,VA,Virginia,Newport News City,51700,30153,17858,12295,25535,239,25296,4618,229,4389,27511,15218,12293,19498,7934,11564,5376,937,155,13030
4/1/2022,VA,Virginia,Norfolk City,51710,34874,20344,14530,29175,305,28870,5699,314,5385,31343,16815,14528,22917,9120,13797,7763,1389,211,13554
4/1/2022,VA,Virginia,Northampton,51131,3934,2567,1367,3517,21,3496,417,23,394,3678,2311,1367,3062,1822,1240,888,88,16,2070
4/1/2022,VA,Virginia,Northumberland,51133,4864,3593,1271,4539,17,4522,325,12,313,4537,3266,1271,3316,2281,1035,455,83,21,2757
4/1/2022,VA,Virginia,Norton City,51720,1090,468,622,792,*,*,298,*,*,1029,407,622,900,338,562,338,*,*,503
4/1/2022,VA,Virginia,Nottoway,51135,3641,2387,1254,3070,22,3048,571,14,557,3386,2132,1254,2747,1601,1146,801,140,34,1772
4/1/2022,VA,Virginia,Orange,51137,9314,6745,2569,8379,52,8327,935,27,908,8499,5930,2569,6164,3954,2210,987,214,41,4922
4/1/2022,VA,Virginia,Page,51139,6403,4661,1742,5427,22,5405,976,21,955,5988,4246,1742,4684,3112,1572,1075,253,50,3306
4/1/2022,VA,Virginia,Patrick,51141,5541,3405,2136,4721,16,4705,820,11,809,5264,3130,2134,4431,2457,1974,1020,190,50,3171
4/1/2022,VA,Virginia,Petersburg City,51730,7140,3696,3444,5521,90,5431,1619,77,1542,6520,3076,3444,5225,1952,3273,2189,334,55,2647
4/1/2022,VA,Virginia,Pittsylvania,51143,16924,9897,7027,14363,122,14241,2561,72,2489,15949,8922,7027,13782,8074,5708,3061,558,133,10030
4/1/2022,VA,Virginia,Poquoson City,51735,2694,2146,548,2531,*,*,163,*,*,2475,1927,548,1416,916,500,129,*,*,1252
4/1/2022,VA,Virginia,Portsmouth City,51740,18775,10826,7949,15180,199,14981,3595,192,3403,16892,8943,7949,12144,4595,7549,4212,747,105,7080
4/1/2022,VA,Virginia,Powhatan,51145,6791,4842,1949,6241,17,6224,550,15,535,6257,4308,1949,5213,3470,1743,418,117,23,4655
4/1/2022,VA,Virginia,Prince Edward,51147,4868,3147,1721,4068,37,4031,800,25,775,4506,2786,1720,3718,2121,1597,1071,165,38,2444
4/1/2022,VA,Virginia,Prince George,51149,6708,4960,1748,5777,33,5744,931,35,896,6196,4448,1748,4102,2523,1579,665,145,28,3264
4/1/2022,VA,Virginia,Prince William,51153,55464,39000,16464,50717,322,50395,4747,273,4474,47201,30741,16460,29877,15000,14877,5884,1242,201,22550
4/1/2022,VA,Virginia,Pulaski,51155,9260,5717,3543,7635,33,7602,1625,30,1595,8631,5088,3543,7303,4046,3257,1562,276,68,5397
4/1/2022,VA,Virginia,Radford City,51750,2135,1405,730,1777,*,*,358,*,*,1933,1203,730,1686,1000,686,340,45,18,1283
4/1/2022,VA,Virginia,Rappahannock,51157,2113,1672,441,1992,*,*,121,*,*,1905,1465,440,1405,1047,358,159,37,12,1197
4/1/2022,VA,Virginia,Richmond,51159,2025,1383,642,1802,*,*,223,*,*,1893,1251,642,1484,943,541,336,*,*,1072
4/1/2022,VA,Virginia,Richmond City,51760,34853,18562,16291,28993,302,28691,5860,255,5605,31495,15206,16289,27678,12159,15519,8851,1363,211,17253
4/1/2022,VA,Virginia,Roanoke,51161,24776,16628,8148,22371,114,22257,2405,52,2353,22883,14739,8144,19196,11952,7244,2170,478,116,16432
4/1/2022,VA,Virginia,Roanoke City,51770,21358,11797,9561,17074,166,16908,4284,129,4155,19551,9990,9561,16684,7757,8927,4812,910,157,10805
4/1/2022,VA,Virginia,Rockbridge,51163,6707,4810,1897,5877,17,5860,830,*,*,6235,4338,1897,4932,3218,1714,864,181,53,3834
4/1/2022,VA,Virginia,Rockingham,51165,19059,14469,4590,17151,66,17085,1908,39,1869,17687,13097,4590,14640,10500,4140,1814,488,116,12222
4/1/2022,VA,Virginia,Russell,51167,7964,3748,4216,5954,21,5933,2010,20,1990,7652,3437,4215,6762,3149,3613,1671,321,86,4684
4/1/2022,VA,Virginia,Salem City,51775,6165,4188,1977,5381,29,5352,784,14,770,5658,3681,1977,4702,2882,1820,767,120,33,3782
4/1/2022,VA,Virginia,Scott,51169,6790,2409,4381,5337,15,5322,1453,*,*,6501,2120,4381,5811,1655,4156,1518,269,75,3949
4/1/2022,VA,Virginia,Shenandoah,51171,11164,8095,3069,10097,33,10064,1067,17,1050,10450,7382,3068,7965,5282,2683,1248,282,65,6370
4/1/2022,VA,Virginia,Smyth,51173,8619,4881,3738,6707,20,6687,1912,23,1889,8177,4439,3738,6983,3430,3553,2005,382,104,4492
4/1/2022,VA,Virginia,Southampton,51175,4189,2853,1336,3618,33,3585,571,23,548,3884,2548,1336,3175,1951,1224,681,145,26,2323
4/1/2022,VA,Virginia,Spotsylvania,51177,24172,16995,7177,21582,142,21440,2590,99,2491,21415,14240,7175,14085,7690,6395,2308,538,99,11140
4/1/2022,VA,Virginia,Stafford,51179,20091,15165,4926,18179,136,18043,1912,86,1826,17626,12703,4923,10009,5663,4346,1684,408,65,7852
4/1/2022,VA,Virginia,Staunton City,51790,6415,4630,1785,5522,27,5495,893,16,877,6041,4256,1785,4939,3294,1645,1077,143,45,3674
4/1/2022,VA,Virginia,Suffolk City,51800,18229,11902,6327,15524,152,15372,2705,110,2595,16677,10350,6327,11794,5930,5864,2854,532,77,8331
4/1/2022,VA,Virginia,Surry,51181,1817,1157,660,1599,15,1584,218,*,*,1680,1020,660,1303,677,626,228,51,13,1011
4/1/2022,VA,Virginia,Sussex,51183,2541,1510,1031,2141,20,2121,400,14,386,2369,1338,1031,1920,949,971,500,139,21,1260
4/1/2022,VA,Virginia,Tazewell,51185,11925,6335,5590,9307,40,9267,2618,36,2582,11386,5797,5589,9461,4956,4505,2304,493,115,6549
4/1/2022,VA,Virginia,Unknown,51999,*,*,*,*,*,*,*,*,*,*,*,*,*,*,*,*,*,*,*
4/1/2022,VA,Virginia,Virginia Beach City,51810,78768,56199,22569,71032,430,70602,7736,307,7429,72097,49535,22562,44766,24192,20574,7376,1624,296,35470
4/1/2022,VA,Virginia,Warren,51187,8576,6235,2341,7629,24,7605,947,27,920,7781,5440,2341,5728,3737,1991,960,230,58,4480
4/1/2022,VA,Virginia,Washington,51191,15713,8188,7525,13164,43,13121,2549,27,2522,14873,7349,7524,12738,5780,6958,2402,617,130,9589
4/1/2022,VA,Virginia,Waynesboro City,51820,5134,3646,1488,4389,25,4364,745,19,726,4801,3313,1488,3981,2569,1412,870,132,36,2943
4/1/2022,VA,Virginia,Westmoreland,51193,5474,3976,1498,4935,32,4903,539,19,520,4954,3456,1498,3477,2130,1347,831,135,33,2478
4/1/2022,VA,Virginia,Williamsburg City,51830,3047,2216,831,2802,11,2791,245,*,*,2798,1967,831,2097,1366,731,296,*,*,1754
4/1/2022,VA,Virginia,Winchester City,51840,5666,4170,1496,4946,27,4919,720,18,702,5172,3676,1496,3985,2670,1315,922,152,26,2885
4/1/2022,VA,Virginia,Wise,51195,10596,4101,6495,7668,31,7637,2928,31,2897,10058,3563,6495,8435,2758,5677,2396,472,117,5450
4/1/2022,VA,Virginia,Wythe,51197,8041,4552,3489,6479,40,6439,1562,13,1549,7620,4131,3489,6492,3245,3247,1617,308,70,4497
4/1/2022,VA,Virginia,York,51199,13258,10243,3015,12332,45,12287,926,41,885,12121,9106,3015,6923,4257,2666,757,172,36,5958
8/1/2022,VA,Virginia,Accomack,51001,9679,6709,2970,8544,51,8493,1135,41,1094,8945,5976,2969,6919,4310,2609,1622,361,68,4868
8/1/2022,VA,Virginia,Albemarle,51003,23925,19279,4646,22418,53,22365,1507,50,1457,21662,17018,4644,17384,13260,4124,1766,296,62,15260
8/1/2022,VA,Virginia,Alexandria City,51510,19268,14343,4925,18029,81,17948,1239,73,1166,15641,10718,4923,10385,5857,4528,2257,322,51,7755
8/1/2022,VA,Virginia,Alleghany,51005,4643,3181,1462,3855,19,3836,788,*,*,4408,2946,1462,3724,2431,1293,821,113,31,2759
8/1/2022,VA,Virginia,Amelia,51007,3330,2056,1274,2914,*,*,416,11,405,3079,1805,1274,2538,1337,1201,466,91,18,1963
8/1/2022,VA,Virginia,Amherst,51009,8191,5235,2956,7031,49,6982,1160,29,1131,7660,4704,2956,6447,3707,2740,1287,237,59,4864
8/1/2022,VA,Virginia,Appomattox,51011,4293,2809,1484,3582,20,3562,711,26,685,4022,2538,1484,3397,2022,1375,800,105,37,2455
8/1/2022,VA,Virginia,Arlington,51013,26210,19909,6301,24740,106,24634,1470,69,1401,20772,14472,6300,13749,7890,5859,3145,399,100,10105
8/1/2022,VA,Virginia,Augusta,51015,19627,14417,5210,17414,70,17344,2213,41,2172,18460,13250,5210,15147,10354,4793,2056,427,126,12538
8/1/2022,VA,Virginia,Bath,51017,1320,1035,285,1184,*,*,136,*,*,1252,967,285,1031,769,262,165,33,13,820
8/1/2022,VA,Virginia,Bedford,51019,21432,14699,6733,18918,66,18852,2514,49,2465,20021,13288,6733,16497,10656,5841,2126,514,136,13721
8/1/2022,VA,Virginia,Bland,51021,1843,1150,693,1520,*,*,323,*,*,1732,1039,693,1413,837,576,226,57,13,1117
8/1/2022,VA,Virginia,Botetourt,51023,9225,6114,3111,8252,45,8207,973,18,955,8610,5499,3111,7063,4334,2729,756,175,34,6098
8/1/2022,VA,Virginia,Bristol City,51520,4482,1884,2598,3605,*,*,877,16,861,4218,1620,2598,3712,1216,2496,1075,156,30,2451
8/1/2022,VA,Virginia,Brunswick,51025,4202,2494,1708,3587,26,3561,615,16,599,3946,2238,1708,3270,1692,1578,1045,134,25,2066
8/1/2022,VA,Virginia,Buchanan,51027,6823,2932,3891,4693,18,4675,2130,12,2118,6578,2687,3891,5766,2586,3180,1576,386,76,3728
8/1/2022,VA,Virginia,Buckingham,51029,3866,2463,1403,3256,23,3233,610,16,594,3618,2216,1402,2927,1693,1234,806,142,34,1945
8/1/2022,VA,Virginia,Buena Vista City,51530,1477,949,528,1216,*,*,261,*,*,1380,852,528,1103,627,476,305,47,18,733
8/1/2022,VA,Virginia,Campbell,51031,13623,8658,4965,11664,73,11591,1959,58,1901,12756,7791,4965,10880,6295,4585,2165,379,116,8220
8/1/2022,VA,Virginia,Caroline,51033,6434,4179,2255,5594,26,5568,840,32,808,5815,3560,2255,4271,2228,2043,896,195,40,3140
8/1/2022,VA,Virginia,Carroll,51035,8720,5884,2836,7397,33,7364,1323,18,1305,8342,5506,2836,6817,4241,2576,1560,299,79,4879
8/1/2022,VA,Virginia,Charles City,51036,2023,1250,773,1776,19,1757,247,*,*,1859,1086,773,1502,801,701,264,89,11,1138
8/1/2022,VA,Virginia,Charlotte,51037,3263,2166,1097,2750,21,2729,513,13,500,3068,1971,1097,2539,1532,1007,696,128,23,1692
8/1/2022,VA,Virginia,Charlottesville City,51540,6340,4745,1595,5526,30,5496,814,28,786,5733,4140,1593,4812,3304,1508,1122,154,18,3518
8/1/2022,VA,Virginia,Chesapeake City,51550,42773,28763,14010,37912,290,37622,4861,174,4687,38709,24700,14009,25069,12310,12759,4640,1006,176,19247
8/1/2022,VA,Virginia,Chesterfield,51041,68386,45127,23259,61528,252,61276,6858,232,6626,62026,38771,23255,50294,28970,21324,6347,1034,197,42716
8/1/2022,VA,Virginia,Clarke,51043,3745,2885,860,3508,*,*,237,*,*,3386,2526,860,2482,1759,723,300,71,25,2086
8/1/2022,VA,Virginia,Colonial Heights City,51570,4102,2899,1203,3564,18,3546,538,11,527,3777,2574,1203,2668,1569,1099,524,111,17,2016
8/1/2022,VA,Virginia,Covington City,51580,1551,1023,528,1202,12,1190,349,*,*,1453,925,528,1227,723,504,352,*,*,809
8/1/2022,VA,Virginia,Craig,51045,1399,850,549,1153,*,*,246,*,*,1314,765,549,1102,603,499,198,*,*,843
8/1/2022,VA,Virginia,Culpeper,51047,10424,7600,2824,9286,46,9240,1138,31,1107,9448,6624,2824,7085,4733,2352,1288,239,61,5497
8/1/2022,VA,Virginia,Cumberland,51049,2414,1488,926,2053,13,2040,361,*,*,2242,1316,926,1872,1024,848,461,94,18,1299
8/1/2022,VA,Virginia,Danville City,51590,11044,5761,5283,8959,85,8874,2085,104,1981,10393,5110,5283,9158,4791,4367,3253,423,96,5386
8/1/2022,VA,Virginia,Dickenson,51051,4823,1818,3005,3352,11,3341,1471,*,*,4643,1638,3005,4033,1349,2684,1107,212,37,2677
8/1/2022,VA,Virginia,Dinwiddie,51053,6358,3953,2405,5354,32,5322,1004,30,974,5891,3486,2405,4645,2401,2244,964,216,38,3427
8/1/2022,VA,Virginia,Emporia City,51595,1313,679,634,1069,15,1054,244,11,233,1224,590,634,1064,480,584,460,*,*,537
8/1/2022,VA,Virginia,Essex,51057,3095,2013,1082,2704,15,2689,391,15,376,2890,1808,1082,2306,1360,946,492,82,28,1704
8/1/2022,VA,Virginia,Fairfax,51059,166888,121906,44982,159234,623,158611,7654,391,7263,135462,90498,44964,88103,48696,39407,15724,2690,483,69206
8/1/2022,VA,Virginia,Fairfax City,51600,4253,3085,1168,4011,14,3997,242,11,231,3531,2364,1167,2419,1439,980,411,*,*,1929
8/1/2022,VA,Virginia,Falls Church City,51610,2253,1711,542,2175,*,*,78,*,*,1813,1271,542,1206,727,479,131,*,*,1059
8/1/2022,VA,Virginia,Fauquier,51061,13904,10733,3171,12934,67,12867,970,36,934,12291,9121,3170,8657,6075,2582,1024,195,44,7394
8/1/2022,VA,Virginia,Floyd,51063,4433,2951,1482,3920,14,3906,513,*,*,4144,2663,1481,3431,2041,1390,633,115,27,2656
8/1/2022,VA,Virginia,Fluvanna,51065,6926,5197,1729,6309,28,6281,617,17,600,6334,4605,1729,4906,3396,1510,660,112,23,4111
8/1/2022,VA,Virginia,Franklin,51067,15888,9719,6169,13779,56,13723,2109,34,2075,14964,8795,6169,12665,7041,5624,2088,483,111,9983
8/1/2022,VA,Virginia,Franklin City,51620,2219,1394,825,1849,15,1834,370,16,354,2092,1267,825,1774,989,785,557,*,*,1139
8/1/2022,VA,Virginia,Frederick,51069,18638,13802,4836,16920,67,16853,1718,46,1672,16913,12079,4834,12492,8362,4130,1546,394,100,10452
8/1/2022,VA,Virginia,Fredericksburg City,51630,4387,3053,1334,3763,23,3740,624,27,597,3923,2590,1333,2845,1613,1232,827,92,26,1900
8/1/2022,VA,Virginia,Galax City,51640,1693,1182,511,1394,*,*,299,*,*,1613,1102,511,1368,891,477,533,51,17,767
8/1/2022,VA,Virginia,Giles,51071,4525,2843,1682,3723,12,3711,802,15,787,4282,2600,1682,3681,2224,1457,741,115,26,2799
8/1/2022,VA,Virginia,Gloucester,51073,9707,6887,2820,8648,42,8606,1059,23,1036,9008,6188,2820,6190,3648,2542,1053,194,48,4895
8/1/2022,VA,Virginia,Goochland,51075,6945,5048,1897,6502,34,6468,443,11,432,6354,4457,1897,5455,3785,1670,449,103,17,4886
8/1/2022,VA,Virginia,Grayson,51077,4728,3092,1636,4000,14,3986,728,*,*,4530,2894,1636,3703,2170,1533,932,174,61,2536
8/1/2022,VA,Virginia,Greene,51079,4375,3285,1090,3893,15,3878,482,11,471,3956,2866,1090,3045,2045,1000,490,99,16,2440
8/1/2022,VA,Virginia,Greensville,51081,2223,1220,1003,1838,25,1813,385,12,373,2051,1048,1003,1743,835,908,469,112,20,1142
8/1/2022,VA,Virginia,Halifax,51083,10090,6673,3417,8533,59,8474,1557,55,1502,9500,6083,3417,7947,4782,3165,2094,398,114,5341
8/1/2022,VA,Virginia,Hampton City,51650,27011,15983,11028,22908,229,22679,4103,193,3910,24661,13635,11026,16548,6290,10258,4349,823,137,11239
8/1/2022,VA,Virginia,Hanover,51085,24031,16168,7863,22245,96,22149,1786,53,1733,22057,14197,7860,18566,11673,6893,1624,326,64,16552
8/1/2022,VA,Virginia,Harrisonburg City,51660,5705,4187,1518,4941,22,4919,764,22,742,5217,3699,1518,4372,2969,1403,1003,159,34,3176
8/1/2022,VA,Virginia,Henrico,51087,61841,38736,23105,55266,382,54884,6575,288,6287,56177,33074,23103,47900,26798,21102,7326,1422,265,38887
8/1/2022,VA,Virginia,Henry,51089,14819,7996,6823,12121,90,12031,2698,61,2637,14087,7265,6822,12438,6000,6438,3029,733,155,8521
8/1/2022,VA,Virginia,Highland,51091,890,699,191,814,*,*,76,0,76,847,656,191,677,506,171,77,*,*,574
8/1/2022,VA,Virginia,Hopewell City,51670,4603,2744,1859,3687,33,3654,916,29,887,4272,2413,1859,3221,1449,1772,1080,160,23,1958
8/1/2022,VA,Virginia,Isle of Wight,51093,9280,6323,2957,8318,52,8266,962,32,930,8564,5608,2956,6275,3529,2746,1019,194,58,5004
8/1/2022,VA,Virginia,James City,51095,22857,17635,5222,21630,62,21568,1227,34,1193,21210,15992,5218,14580,10267,4313,1065,222,44,13249
8/1/2022,VA,Virginia,King and Queen,51097,1860,1239,621,1628,11,1617,232,*,*,1749,1128,621,1397,838,559,283,*,*,1039
8/1/2022,VA,Virginia,King George,51099,4471,3395,1076,3982,22,3960,489,18,471,3868,2792,1076,2196,1215,981,494,83,23,1596
8/1/2022,VA,Virginia,King William,51101,3835,2603,1232,3363,30,3333,472,23,449,3544,2312,1232,2981,1846,1135,443,100,16,2422
8/1/2022,VA,Virginia,Lancaster,51103,4479,3348,1131,4175,17,4158,304,13,291,4201,3071,1130,3246,2300,946,485,95,11,2655
8/1/2022,VA,Virginia,Lee,51105,6452,2318,4134,4741,19,4722,1711,17,1694,6151,2021,4130,5249,1524,3725,1930,235,57,3027
8/1/2022,VA,Virginia,Lexington City,51678,1320,999,321,1220,*,*,100,*,*,1223,903,320,981,689,292,171,*,*,773
8/1/2022,VA,Virginia,Loudoun,51107,45652,33231,12421,43296,165,43131,2356,121,2235,37960,25549,12411,27064,16189,10875,3996,691,146,22231
8/1/2022,VA,Virginia,Louisa,51109,9556,6470,3086,8356,44,8312,1200,29,1171,8742,5657,3085,6825,4057,2768,1189,249,53,5334
8/1/2022,VA,Virginia,Lunenburg,51111,3245,2067,1178,2766,18,2748,479,*,*,3052,1874,1178,2457,1364,1093,756,122,26,1553
8/1/2022,VA,Virginia,Lynchburg City,51680,14896,9334,5562,12546,94,12452,2350,81,2269,13892,8330,5562,11880,6687,5193,2985,457,106,8332
8/1/2022,VA,Virginia,Madison,51113,3530,2597,933,3192,*,*,338,*,*,3274,2342,932,2552,1750,802,422,84,18,2028
8/1/2022,VA,Virginia,Manassas City,51683,5108,3452,1656,4650,22,4628,458,32,426,4310,2654,1656,3199,1713,1486,581,105,19,2494
8/1/2022,VA,Virginia,Manassas Park City,51685,1449,835,614,1276,16,1260,173,12,161,1217,603,614,945,374,571,238,*,*,651
8/1/2022,VA,Virginia,Martinsville City,51690,3811,1993,1818,2958,36,2922,853,27,826,3595,1777,1818,3178,1434,1744,1262,162,37,1717
8/1/2022,VA,Virginia,Mathews,51115,3035,2237,798,2803,19,2784,232,*,*,2857,2059,798,2177,1489,688,299,41,12,1825
8/1/2022,VA,Virginia,Mecklenburg,51117,9602,6190,3412,8216,57,8159,1386,47,1339,9015,5603,3412,7393,4275,3118,1779,411,73,5130
8/1/2022,VA,Virginia,Middlesex,51119,3778,2761,1017,3472,16,3456,306,*,*,3545,2528,1017,2796,1919,877,447,76,11,2262
8/1/2022,VA,Virginia,Montgomery,51121,14878,10391,4487,12808,63,12745,2070,30,2040,13424,8937,4487,11498,7331,4167,2006,325,76,9091
8/1/2022,VA,Virginia,Nelson,51125,4958,3595,1363,4521,16,4505,437,*,*,4624,3261,1363,3538,2334,1204,553,112,20,2853
8/1/2022,VA,Virginia,New Kent,51127,5521,3914,1607,5027,25,5002,494,17,477,5060,3453,1607,3792,2443,1349,355,96,18,3323
8/1/2022,VA,Virginia,Newport News City,51700,30468,17855,12613,25777,225,25552,4691,225,4466,27868,15256,12612,19707,7837,11870,5529,923,161,13094
8/1/2022,VA,Virginia,Norfolk City,51710,35272,20356,14916,29499,287,29212,5773,309,5464,31755,16841,14914,23166,9011,14155,7962,1385,213,13606
8/1/2022,VA,Virginia,Northampton,51131,3957,2539,1418,3539,20,3519,418,23,395,3703,2285,1418,3091,1802,1289,896,88,20,2087
8/1/2022,VA,Virginia,Northumberland,51133,4906,3611,1295,4569,15,4554,337,13,324,4569,3274,1295,3348,2285,1063,468,86,16,2778
8/1/2022,VA,Virginia,Norton City,51720,1092,458,634,790,*,*,302,*,*,1030,396,634,905,331,574,344,*,*,503
8/1/2022,VA,Virginia,Nottoway,51135,3661,2370,1291,3082,22,3060,579,15,564,3412,2121,1291,2772,1588,1184,822,140,33,1777
8/1/2022,VA,Virginia,Orange,51137,9353,6715,2638,8404,47,8357,949,24,925,8542,5904,2638,6191,3914,2277,1010,213,39,4929
8/1/2022,VA,Virginia,Page,51139,6436,4657,1779,5456,20,5436,980,19,961,6024,4245,1779,4714,3103,1611,1088,250,48,3328
8/1/2022,VA,Virginia,Patrick,51141,5551,3373,2178,4724,15,4709,827,*,*,5278,3102,2176,4441,2424,2017,1033,190,47,3171
8/1/2022,VA,Virginia,Petersburg City,51730,7163,3653,3510,5533,87,5446,1630,75,1555,6543,3033,3510,5234,1899,3335,2216,319,55,2644
8/1/2022,VA,Virginia,Pittsylvania,51143,17026,9865,7161,14431,108,14323,2595,70,2525,16075,8914,7161,13879,8051,5828,3100,554,132,10093
8/1/2022,VA,Virginia,Poquoson City,51735,2708,2143,565,2546,*,*,162,*,*,2486,1921,565,1424,906,518,131,*,*,1259
8/1/2022,VA,Virginia,Portsmouth City,51740,18876,10794,8082,15237,184,15053,3639,189,3450,17002,8920,8082,12185,4507,7678,4285,749,107,7044
8/1/2022,VA,Virginia,Powhatan,51145,6875,4888,1987,6316,16,6300,559,14,545,6351,4364,1987,5282,3502,1780,440,112,22,4708
8/1/2022,VA,Virginia,Prince Edward,51147,4890,3123,1767,4087,37,4050,803,25,778,4543,2776,1767,3734,2089,1645,1071,166,40,2457
8/1/2022,VA,Virginia,Prince George,51149,6760,4984,1776,5824,31,5793,936,32,904,6239,4463,1776,4131,2524,1607,679,138,29,3285
8/1/2022,VA,Virginia,Prince William,51153,56264,39372,16892,51449,297,51152,4815,270,4545,47921,31033,16888,30350,15058,15292,6056,1227,199,22868
8/1/2022,VA,Virginia,Pulaski,51155,9293,5698,3595,7653,33,7620,1640,30,1610,8661,5066,3595,7334,4030,3304,1588,272,63,5411
8/1/2022,VA,Virginia,Radford City,51750,2152,1411,741,1789,*,*,363,*,*,1944,1203,741,1698,1003,695,343,45,18,1292
8/1/2022,VA,Virginia,Rappahannock,51157,2127,1682,445,2006,*,*,121,*,*,1929,1485,444,1413,1050,363,156,37,12,1208
8/1/2022,VA,Virginia,Richmond,51159,2039,1383,656,1814,*,*,225,*,*,1904,1248,656,1501,945,556,346,*,*,1083
8/1/2022,VA,Virginia,Richmond City,51760,35050,18508,16542,29147,287,28860,5903,253,5650,31715,15175,16540,27841,12077,15764,8978,1350,206,17307
8/1/2022,VA,Virginia,Roanoke,51161,24844,16619,8225,22422,105,22317,2422,51,2371,22982,14761,8221,19280,11950,7330,2198,471,116,16495
8/1/2022,VA,Virginia,Roanoke City,51770,21388,11724,9664,17079,150,16929,4309,127,4182,19618,9954,9664,16721,7685,9036,4860,898,154,10809
8/1/2022,VA,Virginia,Rockbridge,51163,6738,4798,1940,5902,15,5887,836,*,*,6278,4338,1940,4966,3211,1755,884,177,48,3857
8/1/2022,VA,Virginia,Rockingham,51165,19173,14505,4668,17243,56,17187,1930,41,1889,17794,13126,4668,14716,10499,4217,1851,476,112,12277
8/1/2022,VA,Virginia,Russell,51167,7999,3719,4280,5965,19,5946,2034,22,2012,7682,3403,4279,6799,3125,3674,1703,317,82,4697
8/1/2022,VA,Virginia,Salem City,51775,6206,4199,2007,5405,28,5377,801,16,785,5694,3687,2007,4729,2880,1849,780,118,33,3798
8/1/2022,VA,Virginia,Scott,51169,6786,2364,4422,5332,12,5320,1454,*,*,6503,2081,4422,5811,1619,4192,1524,270,76,3941
8/1/2022,VA,Virginia,Shenandoah,51171,11196,8077,3119,10113,29,10084,1083,16,1067,10494,7376,3118,8030,5298,2732,1267,287,63,6413
8/1/2022,VA,Virginia,Smyth,51173,8598,4808,3790,6679,19,6660,1919,20,1899,8157,4367,3790,6973,3380,3593,2002,375,103,4493
8/1/2022,VA,Virginia,Southampton,51175,4219,2845,1374,3637,31,3606,582,23,559,3916,2542,1374,3191,1934,1257,694,147,29,2321
8/1/2022,VA,Virginia,Spotsylvania,51177,24446,17124,7322,21834,132,21702,2612,97,2515,21672,14352,7320,14245,7704,6541,2365,527,105,11248
8/1/2022,VA,Virginia,Stafford,51179,20388,15322,5066,18445,131,18314,1943,87,1856,17895,12833,5062,10101,5627,4474,1727,408,68,7898
8/1/2022,VA,Virginia,Staunton City,51790,6442,4610,1832,5534,25,5509,908,16,892,6069,4237,1832,4974,3279,1695,1096,142,43,3693
8/1/2022,VA,Virginia,Suffolk City,51800,18406,11907,6499,15655,141,15514,2751,111,2640,16871,10372,6499,11912,5876,6036,2898,516,82,8416
8/1/2022,VA,Virginia,Surry,51181,1831,1163,668,1608,14,1594,223,*,*,1687,1019,668,1317,684,633,237,47,13,1020
8/1/2022,VA,Virginia,Sussex,51183,2548,1477,1071,2146,18,2128,402,14,388,2384,1313,1071,1930,925,1005,501,140,20,1269
8/1/2022,VA,Virginia,Tazewell,51185,11926,6268,5658,9282,38,9244,2644,33,2611,11393,5736,5657,9472,4896,4576,2316,497,113,6546
8/1/2022,VA,Virginia,Unknown,51999,*,*,*,*,*,*,*,*,*,*,*,*,*,*,*,*,*,*,*
8/1/2022,VA,Virginia,Virginia Beach City,51810,79545,56476,23069,71727,388,71339,7818,311,7507,72842,49780,23062,45201,24186,21015,7524,1637,308,35732
8/1/2022,VA,Virginia,Warren,51187,8663,6259,2404,7705,21,7684,958,23,935,7868,5464,2404,5777,3722,2055,994,219,62,4502
8/1/2022,VA,Virginia,Washington,51191,15726,8144,7582,13145,37,13108,2581,27,2554,14896,7315,7581,12766,5748,7018,2437,611,124,9594
8/1/2022,VA,Virginia,Waynesboro City,51820,5143,3618,1525,4389,22,4367,754,17,737,4812,3287,1525,3981,2535,1446,872,135,39,2935
8/1/2022,VA,Virginia,Westmoreland,51193,5506,3978,1528,4957,31,4926,549,19,530,4996,3468,1528,3491,2115,1376,837,137,33,2484
8/1/2022,VA,Virginia,Williamsburg City,51830,3080,2227,853,2828,*,*,252,*,*,2836,1983,853,2125,1369,756,306,*,*,1771
8/1/2022,VA,Virginia,Winchester City,51840,5702,4162,1540,4976,26,4950,726,19,707,5211,3671,1540,4005,2648,1357,937,155,27,2886
8/1/2022,VA,Virginia,Wise,51195,10587,4046,6541,7632,27,7605,2955,33,2922,10057,3516,6541,8437,2702,5735,2424,471,115,5427
8/1/2022,VA,Virginia,Wythe,51197,8053,4517,3536,6481,36,6445,1572,13,1559,7629,4093,3536,6502,3213,3289,1618,304,70,4510
8/1/2022,VA,Virginia,York,51199,13375,10293,3082,12433,41,12392,942,41,901,12235,9153,3082,6978,4255,2723,783,168,37,5990
12/1/2022,VA,Virginia,Accomack,51001,9764,6718,3046,8601,48,8553,1163,39,1124,9025,5981,3044,6991,4311,2680,1673,369,71,4878
12/1/2022,VA,Virginia,Albemarle,51003,24059,19375,4684,22530,49,22481,1529,50,1479,21766,17084,4682,17469,13305,4164,1783,290,65,15331
12/1/2022,VA,Virginia,Alexandria City,51510,19420,14421,4999,18154,78,18076,1266,73,1193,15772,10775,4997,10500,5915,4585,2322,325,54,7799
12/1/2022,VA,Virginia,Alleghany,51005,4656,3176,1480,3859,18,3841,797,*,*,4425,2945,1480,3745,2436,1309,840,113,32,2760
12/1/2022,VA,Virginia,Amelia,51007,3355,2056,1299,2931,*,*,424,11,413,3106,1807,1299,2570,1345,1225,483,89,18,1980
12/1/2022,VA,Virginia,Amherst,51009,8247,5243,3004,7066,46,7020,1181,30,1151,7712,4708,3004,6510,3722,2788,1310,238,58,4904
12/1/2022,VA,Virginia,Appomattox,51011,4303,2792,1511,3585,19,3566,718,25,693,4018,2508,1510,3384,1981,1403,801,105,40,2438
12/1/2022,VA,Virginia,Arlington,51013,26447,20031,6416,24961,102,24859,1486,71,1415,20903,14488,6415,13877,7906,5971,3203,402,101,10171
12/1/2022,VA,Virginia,Augusta,51015,19709,14455,5254,17476,63,17413,2233,39,2194,18548,13294,5254,15227,10386,4841,2108,418,133,12568
12/1/2022,VA,Virginia,Bath,51017,1329,1044,285,1187,*,*,142,*,*,1263,978,285,1039,778,261,168,31,13,827
12/1/2022,VA,Virginia,Bedford,51019,21575,14672,6903,19014,59,18955,2561,48,2513,20133,13230,6903,16611,10609,6002,2198,509,137,13767
12/1/2022,VA,Virginia,Bland,51021,1848,1146,702,1519,*,*,329,*,*,1734,1032,702,1411,825,586,229,56,13,1113
12/1/2022,VA,Virginia,Botetourt,51023,9288,6151,3137,8296,44,8252,992,20,972,8660,5523,3137,7119,4353,2766,789,170,37,6123
12/1/2022,VA,Virginia,Bristol City,51520,4453,1873,2580,3571,*,*,882,13,869,4187,1607,2580,3692,1213,2479,1090,157,27,2418
12/1/2022,VA,Virginia,Brunswick,51025,4229,2493,1736,3607,26,3581,622,16,606,3961,2225,1736,3295,1686,1609,1057,138,25,2075
12/1/2022,VA,Virginia,Buchanan,51027,6820,2913,3907,4662,17,4645,2158,*,*,6569,2662,3907,5764,2564,3200,1602,383,80,3699
12/1/2022,VA,Virginia,Buckingham,51029,3889,2461,1428,3270,23,3247,619,16,603,3628,2201,1427,2945,1678,1267,833,144,32,1936
12/1/2022,VA,Virginia,Buena Vista City,51530,1483,943,540,1217,*,*,266,*,*,1383,843,540,1110,622,488,317,46,17,730
12/1/2022,VA,Virginia,Campbell,51031,13670,8586,5084,11683,70,11613,1987,58,1929,12798,7714,5084,10938,6234,4704,2195,387,121,8235
12/1/2022,VA,Virginia,Caroline,51033,6481,4177,2304,5625,22,5603,856,35,821,5854,3551,2303,4304,2214,2090,924,186,41,3153
12/1/2022,VA,Virginia,Carroll,51035,8760,5834,2926,7409,30,7379,1351,16,1335,8380,5454,2926,6872,4200,2672,1595,302,78,4897
12/1/2022,VA,Virginia,Charles City,51036,2043,1260,783,1795,18,1777,248,*,*,1876,1093,783,1516,807,709,276,81,11,1148
12/1/2022,VA,Virginia,Charlotte,51037,3267,2164,1103,2745,18,2727,522,13,509,3057,1954,1103,2535,1525,1010,716,126,21,1672
12/1/2022,VA,Virginia,Charlottesville City,51540,6344,4723,1621,5528,30,5498,816,27,789,5725,4106,1619,4819,3287,1532,1139,151,17,3512
12/1/2022,VA,Virginia,Chesapeake City,51550,43249,29041,14208,38281,264,38017,4968,173,4795,39098,24891,14207,25230,12279,12951,4786,999,173,19272
12/1/2022,VA,Virginia,Chesterfield,51041,68926,45382,23544,61975,231,61744,6951,226,6725,62442,38903,23539,50685,29086,21599,6552,1027,198,42908
12/1/2022,VA,Virginia,Clarke,51043,3765,2901,864,3529,*,*,236,*,*,3399,2535,864,2493,1767,726,299,71,26,2097
12/1/2022,VA,Virginia,Colonial Heights City,51570,4118,2897,1221,3575,17,3558,543,11,532,3779,2558,1221,2676,1561,1115,548,111,17,2000
12/1/2022,VA,Virginia,Covington City,51580,1546,1008,538,1198,*,*,348,*,*,1438,900,538,1219,707,512,359,*,*,798
12/1/2022,VA,Virginia,Craig,51045,1404,848,556,1155,*,*,249,*,*,1319,763,556,1108,603,505,207,*,*,839
12/1/2022,VA,Virginia,Culpeper,51047,10511,7658,2853,9368,44,9324,1143,32,1111,9521,6669,2852,7129,4752,2377,1326,241,64,5498
12/1/2022,VA,Virginia,Cumberland,51049,2422,1490,932,2055,12,2043,367,*,*,2251,1319,932,1872,1022,850,468,90,19,1295
12/1/2022,VA,Virginia,Danville City,51590,11081,5739,5342,8975,81,8894,2106,97,2009,10429,5087,5342,9189,4774,4415,3327,422,91,5349
12/1/2022,VA,Virginia,Dickenson,51051,4817,1802,3015,3324,*,*,1493,*,*,4633,1618,3015,4027,1327,2700,1111,213,36,2667
12/1/2022,VA,Virginia,Dinwiddie,51053,6362,3935,2427,5355,30,5325,1007,31,976,5900,3473,2427,4650,2382,2268,985,212,36,3417
12/1/2022,VA,Virginia,Emporia City,51595,1312,676,636,1065,15,1050,247,11,236,1220,584,636,1060,472,588,463,*,*,531
12/1/2022,VA,Virginia,Essex,51057,3104,2013,1091,2708,15,2693,396,14,382,2891,1800,1091,2306,1352,954,510,79,30,1687
12/1/2022,VA,Virginia,Fairfax,51059,168913,123005,45908,161084,578,160506,7829,384,7445,136910,91021,45889,89307,49071,40236,16209,2660,485,69953
12/1/2022,VA,Virginia,Fairfax City,51600,4313,3130,1183,4072,14,4058,241,11,230,3574,2392,1182,2450,1457,993,427,*,*,1945
12/1/2022,VA,Virginia,Falls Church City,51610,2280,1730,550,2202,*,*,78,*,*,1827,1277,550,1226,741,485,130,*,*,1079
12/1/2022,VA,Virginia,Fauquier,51061,14043,10829,3214,13064,58,13006,979,36,943,12380,9166,3214,8731,6110,2621,1049,192,43,7447
12/1/2022,VA,Virginia,Floyd,51063,4443,2933,1510,3925,12,3913,518,*,*,4144,2635,1509,3437,2020,1417,646,114,26,2651
12/1/2022,VA,Virginia,Fluvanna,51065,6996,5232,1764,6371,24,6347,625,17,608,6387,4624,1763,4963,3416,1547,673,111,25,4154
12/1/2022,VA,Virginia,Franklin,51067,15948,9713,6235,13809,50,13759,2139,32,2107,15021,8786,6235,12700,7012,5688,2150,483,110,9957
12/1/2022,VA,Virginia,Franklin City,51620,2209,1374,835,1830,15,1815,379,17,362,2084,1249,835,1768,973,795,564,*,*,1129
12/1/2022,VA,Virginia,Frederick,51069,18783,13897,4886,17035,62,16973,1748,46,1702,17041,12157,4884,12589,8416,4173,1584,384,96,10525
12/1/2022,VA,Virginia,Fredericksburg City,51630,4428,3064,1364,3791,21,3770,637,27,610,3956,2593,1363,2869,1612,1257,836,95,25,1913
12/1/2022,VA,Virginia,Galax City,51640,1688,1178,510,1388,*,*,300,*,*,1609,1099,510,1363,886,477,536,54,16,757
12/1/2022,VA,Virginia,Giles,51071,4514,2833,1681,3711,12,3699,803,15,788,4269,2588,1681,3678,2217,1461,749,117,27,2785
12/1/2022,VA,Virginia,Gloucester,51073,9774,6917,2857,8701,39,8662,1073,21,1052,9075,6218,2857,6254,3673,2581,1084,191,47,4932
12/1/2022,VA,Virginia,Goochland,51075,7028,5109,1919,6579,32,6547,449,*,*,6445,4526,1919,5528,3830,1698,462,106,15,4945
12/1/2022,VA,Virginia,Grayson,51077,4737,3081,1656,4000,13,3987,737,*,*,4538,2882,1656,3707,2155,1552,950,171,61,2525
12/1/2022,VA,Virginia,Greene,51079,4421,3309,1112,3933,14,3919,488,*,*,4011,2899,1112,3084,2064,1020,509,102,16,2457
12/1/2022,VA,Virginia,Greensville,51081,2237,1213,1024,1844,21,1823,393,12,381,2060,1036,1024,1758,828,930,475,110,21,1152
12/1/2022,VA,Virginia,Halifax,51083,10076,6602,3474,8519,57,8462,1557,52,1505,9477,6003,3474,7942,4719,3223,2114,405,116,5307
12/1/2022,VA,Virginia,Hampton City,51650,27200,15984,11216,23030,216,22814,4170,188,3982,24841,13628,11213,16686,6250,10436,4474,815,132,11265
12/1/2022,VA,Virginia,Hanover,51085,24213,16268,7945,22406,87,22319,1807,53,1754,22200,14258,7942,18679,11699,6980,1653,320,62,16644
12/1/2022,VA,Virginia,Harrisonburg City,51660,5724,4181,1543,4946,22,4924,778,22,756,5246,3703,1543,4417,2987,1430,1039,152,36,3190
12/1/2022,VA,Virginia,Henrico,51087,62180,38778,23402,55534,361,55173,6646,288,6358,56436,33036,23400,48171,26771,21400,7516,1407,259,38989
12/1/2022,VA,Virginia,Henry,51089,14820,7937,6883,12100,82,12018,2720,62,2658,14085,7203,6882,12432,5936,6496,3109,717,163,8443
12/1/2022,VA,Virginia,Highland,51091,892,697,195,817,*,*,75,0,75,849,654,195,678,505,173,80,*,*,573
12/1/2022,VA,Virginia,Hopewell City,51670,4612,2714,1898,3684,29,3655,928,30,898,4276,2378,1898,3240,1426,1814,1108,156,25,1951
12/1/2022,VA,Virginia,Isle of Wight,51093,9341,6366,2975,8357,50,8307,984,31,953,8610,5636,2974,6308,3535,2773,1061,190,59,4998
12/1/2022,VA,Virginia,James City,51095,23007,17740,5267,21760,56,21704,1247,33,1214,21321,16058,5263,14653,10290,4363,1112,215,44,13282
12/1/2022,VA,Virginia,King and Queen,51097,1876,1240,636,1635,*,*,241,*,*,1763,1127,636,1404,830,574,293,*,*,1039
12/1/2022,VA,Virginia,King George,51099,4522,3431,1091,4024,19,4005,498,19,479,3909,2818,1091,2195,1198,997,500,83,24,1588
12/1/2022,VA,Virginia,King William,51101,3861,2608,1253,3384,28,3356,477,20,457,3573,2320,1253,3003,1845,1158,450,98,15,2440
12/1/2022,VA,Virginia,Lancaster,51103,4480,3332,1148,4172,17,4155,308,13,295,4196,3049,1147,3249,2285,964,489,97,11,2652
12/1/2022,VA,Virginia,Lee,51105,6449,2290,4159,4724,20,4704,1725,18,1707,6150,1993,4157,5248,1494,3754,1921,238,61,3028
12/1/2022,VA,Virginia,Lexington City,51678,1324,1003,321,1221,*,*,103,*,*,1223,903,320,977,685,292,175,*,*,765
12/1/2022,VA,Virginia,Loudoun,51107,46267,33576,12691,43857,152,43705,2410,118,2292,38409,25727,12682,27463,16342,11121,4115,699,154,22495
12/1/2022,VA,Virginia,Louisa,51109,9670,6542,3128,8441,43,8398,1229,26,1203,8852,5724,3128,6908,4101,2807,1234,238,52,5384
12/1/2022,VA,Virginia,Lunenburg,51111,3260,2048,1212,2773,16,2757,487,*,*,3064,1852,1212,2474,1347,1127,776,122,26,1550
12/1/2022,VA,Virginia,Lynchburg City,51680,14905,9282,5623,12532,88,12444,2373,79,2294,13886,8263,5623,11869,6619,5250,3024,445,106,8294
12/1/2022,VA,Virginia,Madison,51113,3563,2620,943,3221,*,*,342,*,*,3300,2358,942,2573,1761,812,424,85,19,2045
12/1/2022,VA,Virginia,Manassas City,51683,5181,3485,1696,4709,21,4688,472,34,438,4378,2682,1696,3258,1733,1525,624,101,17,2516
12/1/2022,VA,Virginia,Manassas Park City,51685,1468,838,630,1294,16,1278,174,12,162,1228,598,630,961,372,589,252,*,*,654
12/1/2022,VA,Virginia,Martinsville City,51690,3805,1972,1833,2956,32,2924,849,28,821,3594,1761,1833,3174,1414,1760,1275,156,33,1710
12/1/2022,VA,Virginia,Mathews,51115,3067,2266,801,2830,18,2812,237,*,*,2877,2076,801,2187,1492,695,307,41,12,1827
12/1/2022,VA,Virginia,Mecklenburg,51117,9620,6162,3458,8220,49,8171,1400,43,1357,9034,5576,3458,7415,4257,3158,1803,416,75,5121
12/1/2022,VA,Virginia,Middlesex,51119,3787,2756,1031,3471,12,3459,316,*,*,3559,2528,1031,2804,1916,888,459,76,11,2258
12/1/2022,VA,Virginia,Montgomery,51121,14895,10348,4547,12816,60,12756,2079,28,2051,13461,8915,4546,11541,7318,4223,2035,326,74,9106
12/1/2022,VA,Virginia,Nelson,51125,4999,3612,1387,4550,14,4536,449,*,*,4668,3281,1387,3580,2347,1233,575,109,20,2876
12/1/2022,VA,Virginia,New Kent,51127,5580,3952,1628,5078,24,5054,502,17,485,5101,3473,1628,3831,2463,1368,366,96,16,3353
12/1/2022,VA,Virginia,Newport News City,51700,30670,17874,12796,25927,214,25713,4743,217,4526,28066,15271,12795,19874,7825,12049,5664,923,161,13126
12/1/2022,VA,Virginia,Norfolk City,51710,35466,20276,15190,29634,273,29361,5832,307,5525,31954,16766,15188,23406,8993,14413,8183,1363,222,13638
12/1/2022,VA,Virginia,Northampton,51131,4007,2564,1443,3581,17,3564,426,24,402,3744,2301,1443,3126,1813,1313,916,87,21,2102
12/1/2022,VA,Virginia,Northumberland,51133,4927,3607,1320,4584,14,4570,343,13,330,4580,3260,1320,3364,2278,1086,476,83,17,2788
12/1/2022,VA,Virginia,Norton City,51720,1096,450,646,792,*,*,304,*,*,1028,382,646,903,316,587,351,*,*,497
12/1/2022,VA,Virginia,Nottoway,51135,3657,2361,1296,3077,19,3058,580,15,565,3407,2111,1296,2758,1570,1188,835,137,33,1753
12/1/2022,VA,Virginia,Orange,51137,9375,6701,2674,8418,43,8375,957,23,934,8546,5872,2674,6208,3899,2309,1035,215,37,4921
12/1/2022,VA,Virginia,Page,51139,6456,4669,1787,5462,19,5443,994,19,975,6033,4246,1787,4721,3103,1618,1115,248,47,3311
12/1/2022,VA,Virginia,Patrick,51141,5574,3386,2188,4731,15,4716,843,*,*,5291,3105,2186,4448,2416,2032,1057,186,48,3157
12/1/2022,VA,Virginia,Petersburg City,51730,7148,3608,3540,5504,79,5425,1644,75,1569,6546,3006,3540,5238,1872,3366,2253,307,55,2623
12/1/2022,VA,Virginia,Pittsylvania,51143,17074,9836,7238,14437,102,14335,2637,69,2568,16134,8896,7238,13949,8068,5881,3175,544,136,10094
12/1/2022,VA,Virginia,Poquoson City,51735,2717,2141,576,2556,*,*,161,*,*,2489,1913,576,1425,896,529,132,*,*,1259
12/1/2022,VA,Virginia,Portsmouth City,51740,18991,10775,8216,15301,172,15129,3690,182,3508,17123,8907,8216,12309,4499,7810,4398,754,109,7048
12/1/2022,VA,Virginia,Powhatan,51145,6966,4949,2017,6398,14,6384,568,13,555,6426,4409,2017,5354,3542,1812,453,110,22,4769
12/1/2022,VA,Virginia,Prince Edward,51147,4875,3084,1791,4068,32,4036,807,22,785,4528,2737,1791,3733,2064,1669,1098,165,39,2431
12/1/2022,VA,Virginia,Prince George,51149,6800,5006,1794,5854,29,5825,946,31,915,6270,4476,1794,4146,2522,1624,693,135,30,3288
12/1/2022,VA,Virginia,Prince William,51153,57048,39769,17279,52125,277,51848,4923,266,4657,48568,31293,17275,30804,15144,15660,6370,1211,197,23026
12/1/2022,VA,Virginia,Pulaski,51155,9275,5654,3621,7618,29,7589,1657,30,1627,8637,5016,3621,7315,3986,3329,1603,271,67,5374
12/1/2022,VA,Virginia,Radford City,51750,2161,1414,747,1794,*,*,367,*,*,1955,1208,747,1706,1003,703,348,47,18,1293
12/1/2022,VA,Virginia,Rappahannock,51157,2148,1703,445,2026,*,*,122,*,*,1943,1499,444,1419,1056,363,160,38,11,1210
12/1/2022,VA,Virginia,Richmond,51159,2041,1375,666,1817,*,*,224,*,*,1905,1239,666,1505,936,569,357,*,*,1074
12/1/2022,VA,Virginia,Richmond City,51760,35217,18521,16696,29289,279,29010,5928,249,5679,31869,15175,16694,28022,12096,15926,9238,1316,204,17264
12/1/2022,VA,Virginia,Roanoke,51161,24934,16615,8319,22478,91,22387,2456,49,2407,23044,14729,8315,19322,11890,7432,2243,464,115,16500
12/1/2022,VA,Virginia,Roanoke City,51770,21382,11642,9740,17052,134,16918,4330,126,4204,19616,9876,9740,16763,7641,9122,4974,894,156,10739
12/1/2022,VA,Virginia,Rockbridge,51163,6784,4812,1972,5928,14,5914,856,*,*,6328,4356,1972,5001,3213,1788,909,176,51,3865
12/1/2022,VA,Virginia,Rockingham,51165,19250,14514,4736,17299,50,17249,1951,38,1913,17875,13139,4736,14822,10532,4290,1884,467,114,12357
12/1/2022,VA,Virginia,Russell,51167,7972,3675,4297,5925,19,5906,2047,22,2025,7664,3369,4295,6769,3085,3684,1719,312,81,4657
12/1/2022,VA,Virginia,Salem City,51775,6179,4159,2020,5377,25,5352,802,17,785,5659,3639,2020,4720,2857,1863,786,115,33,3786
12/1/2022,VA,Virginia,Scott,51169,6760,2347,4413,5284,11,5273,1476,12,1464,6478,2065,4413,5786,1606,4180,1532,264,77,3913
12/1/2022,VA,Virginia,Shenandoah,51171,11260,8104,3156,10160,27,10133,1100,16,1084,10539,7384,3155,8068,5301,2767,1320,286,62,6400
12/1/2022,VA,Virginia,Smyth,51173,8568,4759,3809,6644,18,6626,1924,19,1905,8129,4320,3809,6959,3347,3612,2039,363,101,4456
12/1/2022,VA,Virginia,Southampton,51175,4243,2857,1386,3656,27,3629,587,22,565,3937,2551,1386,3205,1935,1270,710,145,28,2322
12/1/2022,VA,Virginia,Spotsylvania,51177,24679,17232,7447,22033,126,21907,2646,96,2550,21892,14447,7445,14397,7740,6657,2453,517,107,11320
12/1/2022,VA,Virginia,Stafford,51179,20666,15471,5195,18686,118,18568,1980,87,1893,18119,12929,5190,10217,5618,4599,1777,410,68,7962
12/1/2022,VA,Virginia,Staunton City,51790,6432,4588,1844,5513,23,5490,919,17,902,6058,4214,1844,4975,3268,1707,1122,138,44,3671
12/1/2022,VA,Virginia,Suffolk City,51800,18560,11991,6569,15763,133,15630,2797,116,2681,16988,10420,6568,11953,5850,6103,2955,509,86,8403
12/1/2022,VA,Virginia,Surry,51181,1845,1165,680,1618,14,1604,227,*,*,1700,1020,680,1330,685,645,249,46,14,1021
12/1/2022,VA,Virginia,Sussex,51183,2547,1459,1088,2140,15,2125,407,14,393,2390,1302,1088,1946,924,1022,517,136,20,1273
12/1/2022,VA,Virginia,Tazewell,51185,11891,6253,5638,9223,33,9190,2668,31,2637,11352,5715,5637,9431,4852,4579,2346,494,109,6482
12/1/2022,VA,Virginia,Unknown,51999,*,*,*,*,*,*,*,*,*,*,*,*,*,*,*,*,*,*,*
12/1/2022,VA,Virginia,Virginia Beach City,51810,80266,56878,23388,72321,362,71959,7945,309,7636,73493,50113,23380,45610,24289,21321,7772,1629,308,35901
12/1/2022,VA,Virginia,Warren,51187,8767,6312,2455,7786,20,7766,981,22,959,7968,5513,2455,5836,3734,2102,1022,214,63,4537
12/1/2022,VA,Virginia,Washington,51191,15693,8082,7611,13092,29,13063,2601,26,2575,14850,7240,7610,12735,5681,7054,2475,596,128,9536
12/1/2022,VA,Virginia,Waynesboro City,51820,5168,3623,1545,4400,22,4378,768,16,752,4844,3299,1545,4015,2546,1469,900,130,36,2949
12/1/2022,VA,Virginia,Westmoreland,51193,5527,3981,1546,4973,29,4944,554,19,535,5018,3472,1546,3498,2105,1393,846,143,31,2478
12/1/2022,VA,Virginia,Williamsburg City,51830,3088,2226,862,2830,*,*,258,*,*,2844,1982,862,2127,1362,765,314,*,*,1768
12/1/2022,VA,Virginia,Winchester City,51840,5684,4127,1557,4948,21,4927,736,21,715,5187,3630,1557,4006,2624,1382,944,150,29,2883
12/1/2022,VA,Virginia,Wise,51195,10571,4003,6568,7587,25,7562,2984,31,2953,10027,3460,6567,8429,2657,5772,2456,466,115,5392
12/1/2022,VA,Virginia,Wythe,51197,8055,4490,3565,6450,32,6418,1605,14,1591,7631,4066,3565,6494,3174,3320,1646,308,71,4469
12/1/2022,VA,Virginia,York,51199,13500,10358,3142,12527,37,12490,973,41,932,12333,9191,3142,7044,4260,2784,820,163,36,6025
2/1/2022,VA,Virginia,Accomack,51001,9571,6726,2845,8462,58,8404,1109,42,1067,8864,6021,2843,6860,4384,2476,1569,380,72,4839
2/1/2022,VA,Virginia,Albemarle,51003,23613,19102,4511,22144,61,22083,1469,46,1423,21385,16876,4509,17169,13195,3974,1696,312,73,15088
2/1/2022,VA,Virginia,Alexandria City,51510,18964,14242,4722,17759,85,17674,1205,71,1134,15405,10685,4720,10224,5895,4329,2181,338,53,7652
2/1/2022,VA,Virginia,Alleghany,51005,4634,3208,1426,3857,20,3837,777,*,*,4383,2957,1426,3691,2435,1256,811,118,35,2727
2/1/2022,VA,Virginia,Amelia,51007,3293,2035,1258,2885,11,2874,408,13,395,3030,1772,1258,2520,1335,1185,463,92,24,1941
2/1/2022,VA,Virginia,Amherst,51009,8154,5293,2861,6998,56,6942,1156,30,1126,7608,4747,2861,6418,3774,2644,1257,238,62,4861
2/1/2022,VA,Virginia,Appomattox,51011,4242,2825,1417,3545,24,3521,697,26,671,3970,2554,1416,3346,2033,1313,789,111,44,2402
2/1/2022,VA,Virginia,Arlington,51013,25849,19771,6078,24406,118,24288,1443,72,1371,20444,14367,6077,13551,7907,5644,3079,416,114,9942
2/1/2022,VA,Virginia,Augusta,51015,19425,14394,5031,17251,79,17172,2174,44,2130,18295,13264,5031,14997,10380,4617,1991,436,127,12443
2/1/2022,VA,Virginia,Bath,51017,1311,1045,266,1177,*,*,134,*,*,1244,978,266,1021,775,246,161,31,12,817
2/1/2022,VA,Virginia,Bedford,51019,21237,14726,6511,18766,77,18689,2471,48,2423,19782,13272,6510,16315,10701,5614,2065,521,153,13576
2/1/2022,VA,Virginia,Bland,51021,1841,1157,684,1516,*,*,325,*,*,1731,1047,684,1412,842,570,221,57,15,1119
2/1/2022,VA,Virginia,Botetourt,51023,9138,6083,3055,8190,49,8141,948,16,932,8523,5468,3055,7001,4330,2671,743,176,40,6042
2/1/2022,VA,Virginia,Bristol City,51520,4513,1952,2561,3651,*,*,862,16,846,4243,1682,2561,3726,1268,2458,1071,164,37,2454
2/1/2022,VA,Virginia,Brunswick,51025,4164,2549,1615,3563,31,3532,601,16,585,3908,2293,1615,3245,1750,1495,1043,131,30,2041
2/1/2022,VA,Virginia,Buchanan,51027,6850,2995,3855,4743,21,4722,2107,12,2095,6616,2761,3855,5800,2670,3130,1558,388,90,3764
2/1/2022,VA,Virginia,Buckingham,51029,3821,2476,1345,3224,28,3196,597,17,580,3576,2231,1345,2906,1730,1176,785,141,35,1945
2/1/2022,VA,Virginia,Buena Vista City,51530,1484,980,504,1227,*,*,257,*,*,1388,884,504,1116,665,451,305,47,17,747
2/1/2022,VA,Virginia,Campbell,51031,13531,8774,4757,11601,82,11519,1930,58,1872,12662,7905,4757,10772,6398,4374,2116,397,125,8134
2/1/2022,VA,Virginia,Caroline,51033,6356,4190,2166,5531,29,5502,825,33,792,5733,3567,2166,4200,2236,1964,857,209,46,3088
2/1/2022,VA,Virginia,Carroll,51035,8707,5961,2746,7404,40,7364,1303,18,1285,8307,5561,2746,6797,4317,2480,1544,308,86,4859
2/1/2022,VA,Virginia,Charles City,51036,2010,1249,761,1765,20,1745,245,*,*,1854,1093,761,1506,817,689,266,*,*,1146
2/1/2022,VA,Virginia,Charlotte,51037,3261,2193,1068,2759,24,2735,502,14,488,3059,1991,1068,2544,1567,977,695,131,32,1686
2/1/2022,VA,Virginia,Charlottesville City,51540,6308,4765,1543,5503,32,5471,805,30,775,5657,4116,1541,4768,3315,1453,1111,156,25,3476
2/1/2022,VA,Virginia,Chesapeake City,51550,42104,28544,13560,37370,313,37057,4734,178,4556,38106,24548,13558,24731,12417,12314,4472,1022,188,19049
2/1/2022,VA,Virginia,Chesterfield,51041,67386,44780,22606,60647,293,60354,6739,241,6498,61072,38471,22601,49585,28894,20691,6176,1068,219,42122
2/1/2022,VA,Virginia,Clarke,51043,3712,2884,828,3475,13,3462,237,*,*,3352,2524,828,2474,1780,694,304,76,27,2067
2/1/2022,VA,Virginia,Colonial Heights City,51570,4090,2928,1162,3553,21,3532,537,*,*,3768,2606,1162,2655,1594,1061,524,111,21,1999
2/1/2022,VA,Virginia,Covington City,51580,1549,1061,488,1205,14,1191,344,*,*,1446,958,488,1217,750,467,347,*,*,807
2/1/2022,VA,Virginia,Craig,51045,1383,854,529,1136,*,*,247,*,*,1295,766,529,1088,606,482,200,*,*,826
2/1/2022,VA,Virginia,Culpeper,51047,10318,7586,2732,9195,48,9147,1123,29,1094,9337,6605,2732,6991,4731,2260,1252,244,62,5433
2/1/2022,VA,Virginia,Cumberland,51049,2405,1507,898,2051,13,2038,354,*,*,2226,1328,898,1856,1038,818,449,97,21,1289
2/1/2022,VA,Virginia,Danville City,51590,11055,5961,5094,8991,94,8897,2064,111,1953,10383,5289,5094,9127,4950,4177,3217,440,108,5362
2/1/2022,VA,Virginia,Dickenson,51051,4834,1860,2974,3386,13,3373,1448,*,*,4655,1681,2974,4049,1397,2652,1095,223,42,2689
2/1/2022,VA,Virginia,Dinwiddie,51053,6267,3963,2304,5284,38,5246,983,31,952,5798,3494,2304,4593,2440,2153,937,220,45,3391
2/1/2022,VA,Virginia,Emporia City,51595,1321,705,616,1077,17,1060,244,11,233,1231,615,616,1072,505,567,457,64,11,540
2/1/2022,VA,Virginia,Essex,51057,3067,2045,1022,2683,16,2667,384,15,369,2856,1834,1022,2270,1386,884,475,85,29,1681
2/1/2022,VA,Virginia,Fairfax,51059,163447,119974,43473,155997,683,155314,7450,393,7057,132632,89178,43454,86329,48413,37916,15200,2754,506,67869
2/1/2022,VA,Virginia,Fairfax City,51600,4175,3046,1129,3936,15,3921,239,*,*,3483,2355,1128,2387,1442,945,401,74,13,1899
2/1/2022,VA,Virginia,Falls Church City,51610,2218,1688,530,2145,*,*,73,*,*,1782,1252,530,1195,726,469,130,*,*,1048
2/1/2022,VA,Virginia,Fauquier,51061,13709,10646,3063,12761,79,12682,948,36,912,12144,9082,3062,8562,6096,2466,992,195,48,7327
2/1/2022,VA,Virginia,Floyd,51063,4398,2941,1457,3886,14,3872,512,*,*,4120,2664,1456,3415,2050,1365,622,114,25,2654
2/1/2022,VA,Virginia,Fluvanna,51065,6813,5146,1667,6208,30,6178,605,17,588,6221,4554,1667,4825,3379,1446,639,114,27,4045
2/1/2022,VA,Virginia,Franklin,51067,15804,9763,6041,13716,63,13653,2088,37,2051,14862,8821,6041,12562,7052,5510,2062,502,119,9879
2/1/2022,VA,Virginia,Franklin City,51620,2203,1432,771,1842,19,1823,361,16,345,2082,1311,771,1755,1026,729,539,*,*,1134
2/1/2022,VA,Virginia,Frederick,51069,18409,13735,4674,16738,83,16655,1671,44,1627,16725,12053,4672,12352,8389,3963,1509,401,110,10332
2/1/2022,VA,Virginia,Fredericksburg City,51630,4327,3056,1271,3723,24,3699,604,24,580,3847,2577,1270,2811,1635,1176,798,95,28,1890
2/1/2022,VA,Virginia,Galax City,51640,1693,1204,489,1398,*,*,295,*,*,1612,1123,489,1365,908,457,533,53,18,761
2/1/2022,VA,Virginia,Giles,51071,4563,2898,1665,3763,17,3746,800,15,785,4327,2662,1665,3712,2280,1432,754,113,27,2818
2/1/2022,VA,Virginia,Gloucester,51073,9587,6829,2758,8543,45,8498,1044,24,1020,8882,6124,2758,6113,3634,2479,1047,197,47,4822
2/1/2022,VA,Virginia,Goochland,51075,6836,4976,1860,6398,37,6361,438,11,427,6271,4411,1860,5380,3748,1632,437,106,18,4819
2/1/2022,VA,Virginia,Grayson,51077,4698,3112,1586,3982,17,3965,716,*,*,4503,2917,1586,3679,2193,1486,916,180,70,2513
2/1/2022,VA,Virginia,Greene,51079,4306,3240,1066,3844,18,3826,462,*,*,3906,2840,1066,3028,2050,978,474,98,17,2439
2/1/2022,VA,Virginia,Greensville,51081,2204,1229,975,1821,30,1791,383,12,371,2046,1071,975,1733,852,881,465,113,18,1137
2/1/2022,VA,Virginia,Halifax,51083,10025,6773,3252,8488,64,8424,1537,56,1481,9418,6166,3252,7890,4883,3007,2069,410,121,5290
2/1/2022,VA,Virginia,Hampton City,51650,26678,16010,10668,22663,250,22413,4015,196,3819,24344,13677,10667,16360,6435,9925,4198,847,153,11162
2/1/2022,VA,Virginia,Hanover,51085,23787,16097,7690,22044,113,21931,1743,57,1686,21825,14138,7687,18372,11663,6709,1583,344,67,16378
2/1/2022,VA,Virginia,Harrisonburg City,51660,5651,4214,1437,4888,27,4861,763,21,742,5140,3703,1437,4308,2985,1323,975,158,38,3137
2/1/2022,VA,Virginia,Henrico,51087,61229,38610,22619,54766,425,54341,6463,292,6171,55635,33018,22617,47510,26887,20623,7168,1451,291,38600
2/1/2022,VA,Virginia,Henry,51089,14863,8181,6682,12199,104,12095,2664,63,2601,14141,7460,6681,12490,6193,6297,3001,749,184,8556
2/1/2022,VA,Virginia,Highland,51091,882,696,186,808,*,*,74,0,74,838,652,186,670,503,167,73,*,*,570
2/1/2022,VA,Virginia,Hopewell City,51670,4572,2784,1788,3675,36,3639,897,28,869,4234,2446,1788,3206,1494,1712,1044,174,29,1959
2/1/2022,VA,Virginia,Isle of Wight,51093,9182,6291,2891,8249,58,8191,933,35,898,8469,5578,2891,6228,3552,2676,1000,204,62,4962
2/1/2022,VA,Virginia,James City,51095,22646,17522,5124,21446,75,21371,1200,35,1165,21011,15891,5120,14410,10197,4213,1026,230,51,13103
2/1/2022,VA,Virginia,King and Queen,51097,1838,1242,596,1612,11,1601,226,*,*,1732,1136,596,1390,851,539,277,*,*,1037
2/1/2022,VA,Virginia,King George,51099,4399,3380,1019,3918,23,3895,481,18,463,3818,2799,1019,2168,1248,920,487,83,24,1574
2/1/2022,VA,Virginia,King William,51101,3804,2598,1206,3337,36,3301,467,25,442,3515,2309,1206,2965,1851,1114,437,105,20,2403
2/1/2022,VA,Virginia,Lancaster,51103,4461,3351,1110,4164,20,4144,297,14,283,4173,3064,1109,3229,2309,920,480,96,11,2642
2/1/2022,VA,Virginia,Lee,51105,6460,2410,4050,4770,22,4748,1690,16,1674,6156,2109,4047,5250,1605,3645,1934,245,60,3011
2/1/2022,VA,Virginia,Lexington City,51678,1318,1002,316,1221,*,*,97,*,*,1223,908,315,989,701,288,167,28,11,783
2/1/2022,VA,Virginia,Loudoun,51107,44693,32690,12003,42376,184,42192,2317,124,2193,37253,25259,11994,26621,16156,10465,3864,719,151,21887
2/1/2022,VA,Virginia,Louisa,51109,9415,6434,2981,8225,51,8174,1190,31,1159,8604,5623,2981,6739,4075,2664,1155,262,54,5268
2/1/2022,VA,Virginia,Lunenburg,51111,3247,2102,1145,2772,21,2751,475,*,*,3044,1899,1145,2465,1403,1062,761,127,30,1547
2/1/2022,VA,Virginia,Lynchburg City,51680,14803,9439,5364,12486,98,12388,2317,84,2233,13820,8456,5364,11803,6810,4993,2934,472,114,8283
2/1/2022,VA,Virginia,Madison,51113,3486,2587,899,3157,*,*,329,*,*,3239,2341,898,2526,1756,770,414,88,18,2006
2/1/2022,VA,Virginia,Manassas City,51683,4976,3394,1582,4527,23,4504,449,31,418,4199,2617,1582,3128,1712,1416,543,112,21,2452
2/1/2022,VA,Virginia,Manassas Park City,51685,1408,810,598,1241,16,1225,167,13,154,1187,589,598,927,374,553,231,*,*,635
2/1/2022,VA,Virginia,Martinsville City,51690,3816,2060,1756,2978,41,2937,838,30,808,3604,1848,1756,3185,1503,1682,1236,170,46,1733
2/1/2022,VA,Virginia,Mathews,51115,3011,2233,778,2788,21,2767,223,*,*,2832,2054,778,2162,1488,674,289,40,13,1820
2/1/2022,VA,Virginia,Mecklenburg,51117,9564,6277,3287,8204,67,8137,1360,48,1312,8976,5689,3287,7374,4378,2996,1760,417,78,5119
2/1/2022,VA,Virginia,Middlesex,51119,3764,2747,1017,3459,18,3441,305,*,*,3530,2513,1017,2783,1908,875,439,85,14,2245
2/1/2022,VA,Virginia,Montgomery,51121,14743,10383,4360,12705,71,12634,2038,31,2007,13301,8941,4360,11396,7356,4040,1956,336,88,9016
2/1/2022,VA,Virginia,Nelson,51125,4933,3608,1325,4501,16,4485,432,*,*,4590,3265,1325,3537,2374,1163,549,118,23,2847
2/1/2022,VA,Virginia,New Kent,51127,5419,3863,1556,4942,27,4915,477,17,460,4962,3406,1556,3714,2415,1299,339,95,17,3263
2/1/2022,VA,Virginia,Newport News City,51700,30070,17911,12159,25489,240,25249,4581,229,4352,27479,15322,12157,19450,8003,11447,5331,943,174,13002
2/1/2022,VA,Virginia,Norfolk City,51710,34763,20411,14352,29103,317,28786,5660,313,5347,31268,16917,14351,22844,9227,13617,7688,1392,240,13524
2/1/2022,VA,Virginia,Northampton,51131,3922,2569,1353,3516,21,3495,406,23,383,3672,2319,1353,3056,1831,1225,872,91,23,2070
2/1/2022,VA,Virginia,Northumberland,51133,4845,3590,1255,4526,17,4509,319,12,307,4525,3270,1255,3307,2296,1011,454,84,25,2744
2/1/2022,VA,Virginia,Norton City,51720,1092,474,618,794,*,*,298,*,*,1028,410,618,900,343,557,339,*,*,501
2/1/2022,VA,Virginia,Nottoway,51135,3649,2401,1248,3081,25,3056,568,14,554,3395,2147,1248,2763,1629,1134,803,142,34,1784
2/1/2022,VA,Virginia,Orange,51137,9281,6760,2521,8355,54,8301,926,27,899,8472,5951,2521,6141,3980,2161,987,215,49,4890
2/1/2022,VA,Virginia,Page,51139,6406,4683,1723,5438,23,5415,968,23,945,5997,4274,1723,4695,3142,1553,1076,255,55,3309
2/1/2022,VA,Virginia,Patrick,51141,5558,3431,2127,4744,16,4728,814,12,802,5282,3157,2125,4444,2484,1960,1018,194,59,3173
2/1/2022,VA,Virginia,Petersburg City,51730,7144,3770,3374,5533,91,5442,1611,78,1533,6527,3153,3374,5220,2005,3215,2168,335,55,2662
2/1/2022,VA,Virginia,Pittsylvania,51143,16913,9961,6952,14367,125,14242,2546,71,2475,15958,9006,6952,13788,8161,5627,3042,577,140,10029
2/1/2022,VA,Virginia,Poquoson City,51735,2690,2143,547,2526,*,*,164,*,*,2466,1919,547,1411,914,497,126,*,*,1250
2/1/2022,VA,Virginia,Portsmouth City,51740,18756,10912,7844,15185,209,14976,3571,190,3381,16894,9050,7844,12128,4681,7447,4173,759,112,7084
2/1/2022,VA,Virginia,Powhatan,51145,6764,4813,1951,6218,17,6201,546,15,531,6236,4285,1951,5191,3452,1739,419,120,27,4625
2/1/2022,VA,Virginia,Prince Edward,51147,4891,3179,1712,4091,40,4051,800,25,775,4525,2814,1711,3742,2159,1583,1088,169,40,2445
2/1/2022,VA,Virginia,Prince George,51149,6690,4956,1734,5767,34,5733,923,36,887,6185,4451,1734,4090,2522,1568,660,147,32,3251
2/1/2022,VA,Virginia,Prince William,51153,55089,38807,16282,50368,339,50029,4721,278,4443,46939,30660,16279,29754,15062,14692,5824,1265,226,22439
2/1/2022,VA,Virginia,Pulaski,51155,9269,5732,3537,7650,37,7613,1619,31,1588,8655,5118,3537,7343,4090,3253,1580,285,78,5400
2/1/2022,VA,Virginia,Radford City,51750,2142,1421,721,1785,*,*,357,*,*,1941,1220,721,1694,1018,676,339,45,19,1291
2/1/2022,VA,Virginia,Rappahannock,51157,2098,1669,429,1978,*,*,120,*,*,1892,1464,428,1397,1050,347,158,38,11,1190
2/1/2022,VA,Virginia,Richmond,51159,2029,1400,629,1806,*,*,223,*,*,1895,1266,629,1485,960,525,330,*,*,1073
2/1/2022,VA,Virginia,Richmond City,51760,34758,18619,16139,28925,308,28617,5833,257,5576,31450,15313,16137,27664,12287,15377,8787,1347,243,17287
2/1/2022,VA,Virginia,Roanoke,51161,24704,16597,8107,22319,121,22198,2385,50,2335,22861,14758,8103,19181,11983,7198,2160,481,123,16417
2/1/2022,VA,Virginia,Roanoke City,51770,21353,11852,9501,17088,174,16914,4265,127,4138,19568,10067,9501,16696,7829,8867,4796,924,177,10799
2/1/2022,VA,Virginia,Rockbridge,51163,6668,4801,1867,5846,17,5829,822,*,*,6214,4347,1867,4922,3240,1682,862,184,53,3823
2/1/2022,VA,Virginia,Rockingham,51165,19015,14480,4535,17110,66,17044,1905,40,1865,17667,13133,4534,14621,10537,4084,1798,502,131,12190
2/1/2022,VA,Virginia,Russell,51167,7981,3781,4200,5979,21,5958,2002,20,1982,7670,3471,4199,6775,3181,3594,1669,327,104,4675
2/1/2022,VA,Virginia,Salem City,51775,6153,4194,1959,5377,32,5345,776,14,762,5639,3680,1959,4704,2896,1808,764,121,38,3781
2/1/2022,VA,Virginia,Scott,51169,6790,2415,4375,5341,15,5326,1449,*,*,6511,2136,4375,5815,1663,4152,1522,274,86,3933
2/1/2022,VA,Virginia,Shenandoah,51171,11145,8123,3022,10083,33,10050,1062,18,1044,10433,7412,3021,7932,5297,2635,1237,285,71,6339
2/1/2022,VA,Virginia,Smyth,51173,8641,4935,3706,6734,20,6714,1907,25,1882,8198,4492,3706,7003,3479,3524,2013,383,112,4495
2/1/2022,VA,Virginia,Southampton,51175,4185,2860,1325,3623,36,3587,562,22,540,3873,2548,1325,3167,1954,1213,671,144,31,2321
2/1/2022,VA,Virginia,Spotsylvania,51177,24051,16940,7111,21474,145,21329,2577,100,2477,21353,14244,7109,14054,7725,6329,2277,551,117,11109
2/1/2022,VA,Virginia,Stafford,51179,20013,15149,4864,18118,139,17979,1895,84,1811,17576,12715,4861,9966,5677,4289,1666,407,68,7825
2/1/2022,VA,Virginia,Staunton City,51790,6410,4654,1756,5515,28,5487,895,16,879,6035,4279,1756,4937,3323,1614,1079,147,49,3662
2/1/2022,VA,Virginia,Suffolk City,51800,18175,11910,6265,15482,163,15319,2693,110,2583,16640,10375,6265,11782,5975,5807,2852,523,87,8320
2/1/2022,VA,Virginia,Surry,51181,1808,1154,654,1591,16,1575,217,*,*,1675,1021,654,1298,677,621,230,52,13,1003
2/1/2022,VA,Virginia,Sussex,51183,2542,1512,1030,2142,24,2118,400,14,386,2372,1342,1030,1931,955,976,504,142,21,1264
2/1/2022,VA,Virginia,Tazewell,51185,11943,6361,5582,9331,42,9289,2612,36,2576,11403,5823,5580,9486,4999,4487,2297,501,123,6565
2/1/2022,VA,Virginia,Unknown,51999,*,*,*,*,*,*,*,*,*,*,*,*,*,*,*,*,*,*,*
2/1/2022,VA,Virginia,Virginia Beach City,51810,78578,56220,22358,70863,443,70420,7715,308,7407,71972,49621,22351,44722,24348,20374,7326,1638,332,35426
2/1/2022,VA,Virginia,Warren,51187,8555,6249,2306,7614,27,7587,941,28,913,7764,5458,2306,5709,3755,1954,952,241,62,4454
2/1/2022,VA,Virginia,Washington,51191,15707,8217,7490,13163,45,13118,2544,29,2515,14873,7384,7489,12729,5801,6928,2386,633,157,9553
2/1/2022,VA,Virginia,Waynesboro City,51820,5141,3663,1478,4393,25,4368,748,21,727,4820,3342,1478,4005,2602,1403,868,139,42,2956
2/1/2022,VA,Virginia,Westmoreland,51193,5451,3967,1484,4919,34,4885,532,17,515,4935,3451,1484,3452,2122,1330,824,137,40,2451
2/1/2022,VA,Virginia,Williamsburg City,51830,3045,2220,825,2805,11,2794,240,*,*,2807,1982,825,2102,1379,723,297,*,*,1757
2/1/2022,VA,Virginia,Winchester City,51840,5642,4171,1471,4929,29,4900,713,18,695,5154,3683,1471,3966,2680,1286,916,156,28,2866
2/1/2022,VA,Virginia,Wise,51195,10607,4147,6460,7694,32,7662,2913,32,2881,10071,3611,6460,8448,2809,5639,2391,483,130,5444
2/1/2022,VA,Virginia,Wythe,51197,8044,4609,3435,6488,43,6445,1556,13,1543,7625,4190,3435,6497,3302,3195,1634,313,76,4474
2/1/2022,VA,Virginia,York,51199,13201,10215,2986,12288,46,12242,913,44,869,12091,9105,2986,6907,4268,2639,745,178,39,5945
1/1/2022,VA,Virginia,Accomack,51001,9583,6752,2831,8477,59,8418,1106,43,1063,8879,6050,2829,6864,4400,2464,1564,384,73,4843
1/1/2022,VA,Virginia,Albemarle,51003,23576,19063,4513,22107,63,22044,1469,47,1422,21350,16839,4511,17126,13153,3973,1693,311,74,15048
1/1/2022,VA,Virginia,Alexandria City,51510,18938,14233,4705,17730,89,17641,1208,71,1137,15384,10681,4703,10201,5891,4310,2183,335,51,7632
1/1/2022,VA,Virginia,Alleghany,51005,4635,3216,1419,3860,21,3839,775,*,*,4384,2965,1419,3682,2434,1248,810,117,36,2719
1/1/2022,VA,Virginia,Amelia,51007,3298,2048,1250,2893,12,2881,405,13,392,3032,1782,1250,2521,1344,1177,461,92,23,1945
1/1/2022,VA,Virginia,Amherst,51009,8151,5307,2844,7004,58,6946,1147,30,1117,7603,4759,2844,6406,3784,2622,1245,235,63,4863
1/1/2022,VA,Virginia,Appomattox,51011,4239,2825,1414,3542,24,3518,697,26,671,3974,2561,1413,3353,2040,1313,794,111,47,2401
1/1/2022,VA,Virginia,Arlington,51013,25815,19756,6059,24367,124,24243,1448,72,1376,20439,14381,6058,13516,7894,5622,3084,415,113,9904
1/1/2022,VA,Virginia,Augusta,51015,19466,14422,5044,17296,81,17215,2170,45,2125,18339,13295,5044,15019,10392,4627,1993,436,126,12464
1/1/2022,VA,Virginia,Bath,51017,1314,1053,261,1180,*,*,134,*,*,1247,986,261,1022,783,239,158,31,12,821
1/1/2022,VA,Virginia,Bedford,51019,21230,14746,6484,18760,80,18680,2470,48,2422,19782,13299,6483,16287,10703,5584,2067,519,155,13546
1/1/2022,VA,Virginia,Bland,51021,1844,1164,680,1520,*,*,324,*,*,1735,1055,680,1412,848,564,222,57,15,1118
1/1/2022,VA,Virginia,Botetourt,51023,9123,6085,3038,8172,49,8123,951,17,934,8504,5466,3038,6989,4332,2657,744,175,41,6029
1/1/2022,VA,Virginia,Bristol City,51520,4521,1972,2549,3661,*,*,860,15,845,4249,1700,2549,3730,1283,2447,1068,166,39,2457
1/1/2022,VA,Virginia,Brunswick,51025,4171,2563,1608,3576,31,3545,595,17,578,3913,2305,1608,3245,1756,1489,1046,131,30,2038
1/1/2022,VA,Virginia,Buchanan,51027,6866,3004,3862,4764,22,4742,2102,12,2090,6632,2770,3862,5810,2677,3133,1558,390,89,3773
1/1/2022,VA,Virginia,Buckingham,51029,3836,2494,1342,3238,29,3209,598,17,581,3592,2250,1342,2917,1742,1175,798,139,37,1943
1/1/2022,VA,Virginia,Buena Vista City,51530,1488,985,503,1232,*,*,256,*,*,1389,886,503,1117,667,450,303,47,16,751
1/1/2022,VA,Virginia,Campbell,51031,13564,8842,4722,11636,83,11553,1928,60,1868,12695,7973,4722,10789,6452,4337,2117,402,122,8148
1/1/2022,VA,Virginia,Caroline,51033,6358,4205,2153,5536,33,5503,822,32,790,5739,3586,2153,4195,2244,1951,856,209,46,3084
1/1/2022,VA,Virginia,Carroll,51035,8707,5968,2739,7410,40,7370,1297,18,1279,8309,5570,2739,6796,4320,2476,1549,307,89,4851
1/1/2022,VA,Virginia,Charles City,51036,2011,1247,764,1767,21,1746,244,*,*,1855,1091,764,1505,815,690,263,*,*,1149
1/1/2022,VA,Virginia,Charlotte,51037,3265,2208,1057,2763,25,2738,502,14,488,3061,2004,1057,2543,1576,967,693,131,33,1686
1/1/2022,VA,Virginia,Charlottesville City,51540,6316,4780,1536,5509,32,5477,807,31,776,5660,4126,1534,4772,3326,1446,1116,154,25,3477
1/1/2022,VA,Virginia,Chesapeake City,51550,42060,28550,13510,37345,320,37025,4715,180,4535,38093,24585,13508,24704,12446,12258,4465,1017,189,19033
1/1/2022,VA,Virginia,Chesterfield,51041,67373,44808,22565,60652,294,60358,6721,243,6478,61066,38506,22560,49564,28911,20653,6160,1066,223,42115
1/1/2022,VA,Virginia,Clarke,51043,3719,2897,822,3482,13,3469,237,*,*,3364,2542,822,2476,1791,685,309,76,27,2064
1/1/2022,VA,Virginia,Colonial Heights City,51570,4105,2934,1171,3569,21,3548,536,*,*,3783,2612,1171,2676,1608,1068,521,112,20,2023
1/1/2022,VA,Virginia,Covington City,51580,1556,1060,496,1214,14,1200,342,*,*,1455,959,496,1223,748,475,348,*,*,812
1/1/2022,VA,Virginia,Craig,51045,1389,868,521,1142,*,*,247,*,*,1300,779,521,1084,610,474,201,*,*,823
1/1/2022,VA,Virginia,Culpeper,51047,10328,7600,2728,9204,50,9154,1124,29,1095,9359,6631,2728,6985,4736,2249,1260,245,63,5417
1/1/2022,VA,Virginia,Cumberland,51049,2409,1512,897,2058,14,2044,351,*,*,2235,1338,897,1868,1050,818,450,98,22,1298
1/1/2022,VA,Virginia,Danville City,51590,11080,5996,5084,9020,98,8922,2060,114,1946,10405,5321,5084,9143,4976,4167,3219,443,109,5372
1/1/2022,VA,Virginia,Dickenson,51051,4842,1866,2976,3396,13,3383,1446,*,*,4663,1687,2976,4061,1406,2655,1096,224,46,2695
1/1/2022,VA,Virginia,Dinwiddie,51053,6275,3970,2305,5291,39,5252,984,33,951,5808,3503,2305,4611,2455,2156,944,216,46,3405
1/1/2022,VA,Virginia,Emporia City,51595,1325,711,614,1086,17,1069,239,*,*,1236,622,614,1074,510,564,464,60,11,539
1/1/2022,VA,Virginia,Essex,51057,3075,2048,1027,2691,17,2674,384,15,369,2862,1835,1027,2273,1388,885,472,87,31,1683
1/1/2022,VA,Virginia,Fairfax,51059,163102,119867,43235,155672,696,154976,7430,394,7036,132444,89227,43217,86004,48339,37665,15151,2747,509,67597
1/1/2022,VA,Virginia,Fairfax City,51600,4164,3049,1115,3924,15,3909,240,11,229,3474,2360,1114,2376,1446,930,404,76,13,1883
1/1/2022,VA,Virginia,Falls Church City,51610,2217,1689,528,2144,*,*,73,*,*,1779,1251,528,1187,720,467,130,*,*,1041
1/1/2022,VA,Virginia,Fauquier,51061,13689,10659,3030,12749,82,12667,940,36,904,12141,9112,3029,8533,6101,2432,988,198,51,7296
1/1/2022,VA,Virginia,Floyd,51063,4404,2945,1459,3891,14,3877,513,*,*,4127,2669,1458,3419,2052,1367,627,112,28,2652
1/1/2022,VA,Virginia,Fluvanna,51065,6794,5134,1660,6191,32,6159,603,16,587,6213,4553,1660,4819,3380,1439,632,114,27,4046
1/1/2022,VA,Virginia,Franklin,51067,15825,9781,6044,13742,64,13678,2083,38,2045,14886,8842,6044,12566,7054,5512,2064,495,123,9884
1/1/2022,VA,Virginia,Franklin City,51620,2202,1438,764,1844,20,1824,358,16,342,2082,1318,764,1752,1031,721,539,*,*,1130
1/1/2022,VA,Virginia,Frederick,51069,18392,13735,4657,16719,85,16634,1673,45,1628,16717,12062,4655,12339,8393,3946,1506,396,111,10326
1/1/2022,VA,Virginia,Fredericksburg City,51630,4333,3056,1277,3730,25,3705,603,24,579,3858,2582,1276,2814,1639,1175,800,97,28,1889
1/1/2022,VA,Virginia,Galax City,51640,1699,1213,486,1400,*,*,299,*,*,1617,1131,486,1369,915,454,540,53,18,758
1/1/2022,VA,Virginia,Giles,51071,4573,2910,1663,3774,18,3756,799,15,784,4329,2666,1663,3710,2289,1421,761,113,29,2807
1/1/2022,VA,Virginia,Gloucester,51073,9580,6828,2752,8545,48,8497,1035,23,1012,8878,6126,2752,6106,3633,2473,1043,196,46,4821
1/1/2022,VA,Virginia,Goochland,51075,6831,4975,1856,6394,37,6357,437,11,426,6274,4418,1856,5368,3742,1626,433,104,21,4810
1/1/2022,VA,Virginia,Grayson,51077,4706,3123,1583,3993,17,3976,713,*,*,4508,2925,1583,3677,2195,1482,914,178,70,2515
1/1/2022,VA,Virginia,Greene,51079,4299,3246,1053,3838,20,3818,461,*,*,3902,2849,1053,3027,2060,967,471,98,17,2441
1/1/2022,VA,Virginia,Greensville,51081,2205,1230,975,1824,30,1794,381,13,368,2045,1070,975,1727,846,881,461,116,18,1132
1/1/2022,VA,Virginia,Halifax,51083,10040,6782,3258,8508,64,8444,1532,54,1478,9435,6177,3258,7909,4894,3015,2083,408,121,5297
1/1/2022,VA,Virginia,Hampton City,51650,26661,16045,10616,22648,260,22388,4013,198,3815,24347,13732,10615,16326,6462,9864,4188,839,150,11149
1/1/2022,VA,Virginia,Hanover,51085,23809,16100,7709,22070,116,21954,1739,55,1684,21844,14138,7706,18390,11671,6719,1583,344,69,16394
1/1/2022,VA,Virginia,Harrisonburg City,51660,5652,4225,1427,4892,28,4864,760,21,739,5150,3723,1427,4315,3001,1314,977,161,40,3137
1/1/2022,VA,Virginia,Henrico,51087,61243,38681,22562,54793,440,54353,6450,295,6155,55682,33121,22561,47502,26946,20556,7133,1444,291,38634
1/1/2022,VA,Virginia,Henry,51089,14907,8221,6686,12252,108,12144,2655,63,2592,14183,7498,6685,12527,6231,6296,3016,752,186,8573
1/1/2022,VA,Virginia,Highland,51091,882,696,186,808,*,*,74,0,74,838,652,186,668,501,167,75,*,*,566
1/1/2022,VA,Virginia,Hopewell City,51670,4581,2793,1788,3685,36,3649,896,27,869,4239,2451,1788,3205,1495,1710,1039,173,30,1963
1/1/2022,VA,Virginia,Isle of Wight,51093,9187,6302,2885,8260,58,8202,927,35,892,8478,5593,2885,6241,3571,2670,1001,202,63,4975
1/1/2022,VA,Virginia,James City,51095,22650,17537,5113,21450,78,21372,1200,34,1166,21010,15901,5109,14394,10191,4203,1020,231,50,13093
1/1/2022,VA,Virginia,King and Queen,51097,1846,1251,595,1619,11,1608,227,*,*,1734,1139,595,1387,848,539,278,*,*,1032
1/1/2022,VA,Virginia,King George,51099,4395,3378,1017,3917,24,3893,478,17,461,3816,2799,1017,2162,1245,917,480,80,26,1576
1/1/2022,VA,Virginia,King William,51101,3799,2588,1211,3333,37,3296,466,25,441,3516,2305,1211,2964,1851,1113,443,106,19,2396
1/1/2022,VA,Virginia,Lancaster,51103,4466,3360,1106,4173,20,4153,293,14,279,4182,3077,1105,3233,2316,917,478,*,*,2647
1/1/2022,VA,Virginia,Lee,51105,6464,2418,4046,4779,22,4757,1685,16,1669,6162,2119,4043,5254,1614,3640,1937,248,63,3006
1/1/2022,VA,Virginia,Lexington City,51678,1315,999,316,1219,*,*,96,*,*,1219,904,315,985,697,288,165,27,11,782
1/1/2022,VA,Virginia,Loudoun,51107,44618,32657,11961,42305,188,42117,2313,127,2186,37233,25281,11952,26571,16158,10413,3860,722,147,21842
1/1/2022,VA,Virginia,Louisa,51109,9419,6437,2982,8230,51,8179,1189,31,1158,8610,5628,2982,6746,4080,2666,1155,266,56,5269
1/1/2022,VA,Virginia,Lunenburg,51111,3247,2112,1135,2771,21,2750,476,*,*,3043,1908,1135,2466,1413,1053,762,124,30,1550
1/1/2022,VA,Virginia,Lynchburg City,51680,14823,9482,5341,12512,103,12409,2311,84,2227,13852,8511,5341,11822,6855,4967,2925,470,114,8313
1/1/2022,VA,Virginia,Madison,51113,3490,2596,894,3161,*,*,329,*,*,3245,2352,893,2526,1763,763,416,87,18,2005
1/1/2022,VA,Virginia,Manassas City,51683,4964,3389,1575,4515,24,4491,449,31,418,4186,2611,1575,3118,1712,1406,538,111,21,2448
1/1/2022,VA,Virginia,Manassas Park City,51685,1400,810,590,1235,17,1218,165,12,153,1186,596,590,923,377,546,232,*,*,630
1/1/2022,VA,Virginia,Martinsville City,51690,3816,2071,1745,2982,41,2941,834,32,802,3605,1860,1745,3190,1520,1670,1238,169,46,1737
1/1/2022,VA,Virginia,Mathews,51115,3006,2235,771,2784,21,2763,222,*,*,2829,2058,771,2154,1485,669,282,39,13,1820
1/1/2022,VA,Virginia,Mecklenburg,51117,9573,6288,3285,8217,67,8150,1356,48,1308,8986,5701,3285,7382,4389,2993,1769,419,77,5117
1/1/2022,VA,Virginia,Middlesex,51119,3772,2760,1012,3468,18,3450,304,*,*,3536,2524,1012,2786,1916,870,437,86,15,2248
1/1/2022,VA,Virginia,Montgomery,51121,14742,10388,4354,12704,71,12633,2038,31,2007,13309,8955,4354,11400,7365,4035,1954,341,92,9013
1/1/2022,VA,Virginia,Nelson,51125,4934,3617,1317,4504,17,4487,430,*,*,4596,3279,1317,3533,2378,1155,551,119,23,2840
1/1/2022,VA,Virginia,New Kent,51127,5409,3854,1555,4935,27,4908,474,18,456,4952,3397,1555,3705,2406,1299,340,95,16,3254
1/1/2022,VA,Virginia,Newport News City,51700,30054,17936,12118,25483,245,25238,4571,231,4340,27471,15354,12117,19424,8011,11413,5314,944,173,12993
1/1/2022,VA,Virginia,Norfolk City,51710,34777,20520,14257,29129,321,28808,5648,317,5331,31298,17042,14256,22809,9285,13524,7664,1390,237,13518
1/1/2022,VA,Virginia,Northampton,51131,3915,2574,1341,3512,23,3489,403,23,380,3666,2325,1341,3051,1840,1211,870,91,23,2067
1/1/2022,VA,Virginia,Northumberland,51133,4840,3596,1244,4523,15,4508,317,12,305,4522,3278,1244,3298,2300,998,454,84,23,2737
1/1/2022,VA,Virginia,Norton City,51720,1090,472,618,793,*,*,297,*,*,1026,408,618,897,340,557,340,*,*,497
1/1/2022,VA,Virginia,Nottoway,51135,3657,2401,1256,3088,25,3063,569,15,554,3401,2145,1256,2772,1629,1143,809,142,34,1787
1/1/2022,VA,Virginia,Orange,51137,9290,6779,2511,8367,57,8310,923,27,896,8485,5974,2511,6141,3991,2150,987,216,49,4889
1/1/2022,VA,Virginia,Page,51139,6422,4691,1731,5453,23,5430,969,23,946,6012,4281,1731,4708,3148,1560,1074,254,57,3323
1/1/2022,VA,Virginia,Patrick,51141,5572,3450,2122,4757,16,4741,815,12,803,5297,3177,2120,4459,2505,1954,1024,196,57,3182
1/1/2022,VA,Virginia,Petersburg City,51730,7157,3791,3366,5543,93,5450,1614,79,1535,6544,3178,3366,5229,2021,3208,2170,332,54,2673
1/1/2022,VA,Virginia,Pittsylvania,51143,16952,9981,6971,14408,128,14280,2544,71,2473,15984,9013,6971,13811,8178,5633,3045,580,143,10043
1/1/2022,VA,Virginia,Poquoson City,51735,2690,2138,552,2526,*,*,164,*,*,2465,1913,552,1409,908,501,127,*,*,1246
1/1/2022,VA,Virginia,Portsmouth City,51740,18768,10957,7811,15198,215,14983,3570,191,3379,16911,9100,7811,12142,4730,7412,4184,756,109,7093
1/1/2022,VA,Virginia,Powhatan,51145,6753,4804,1949,6209,17,6192,544,16,528,6222,4273,1949,5179,3446,1733,421,119,28,4611
1/1/2022,VA,Virginia,Prince Edward,51147,4895,3197,1698,4097,40,4057,798,25,773,4531,2834,1697,3737,2170,1567,1086,167,41,2443
1/1/2022,VA,Virginia,Prince George,51149,6681,4961,1720,5761,37,5724,920,36,884,6173,4453,1720,4085,2529,1556,655,147,32,3251
1/1/2022,VA,Virginia,Prince William,51153,54951,38762,16189,50251,347,49904,4700,276,4424,46876,30690,16186,29665,15070,14595,5795,1263,225,22382
1/1/2022,VA,Virginia,Pulaski,51155,9274,5735,3539,7658,38,7620,1616,33,1583,8660,5121,3539,7343,4092,3251,1585,285,78,5395
1/1/2022,VA,Virginia,Radford City,51750,2148,1425,723,1793,*,*,355,*,*,1948,1225,723,1697,1019,678,337,46,18,1296
1/1/2022,VA,Virginia,Rappahannock,51157,2103,1673,430,1985,*,*,118,*,*,1895,1466,429,1402,1055,347,157,*,*,1197
1/1/2022,VA,Virginia,Richmond,51159,2031,1402,629,1810,*,*,221,*,*,1894,1265,629,1480,956,524,329,*,*,1069
1/1/2022,VA,Virginia,Richmond City,51760,34788,18674,16114,28955,313,28642,5833,261,5572,31487,15375,16112,27676,12327,15349,8788,1355,243,17290
1/1/2022,VA,Virginia,Roanoke,51161,24706,16580,8126,22321,123,22198,2385,51,2334,22877,14755,8122,19191,11978,7213,2157,484,123,16427
1/1/2022,VA,Virginia,Roanoke City,51770,21378,11906,9472,17115,180,16935,4263,130,4133,19599,10127,9472,16710,7871,8839,4787,922,178,10823
1/1/2022,VA,Virginia,Rockbridge,51163,6664,4802,1862,5844,17,5827,820,*,*,6212,4350,1862,4915,3239,1676,854,186,54,3821
1/1/2022,VA,Virginia,Rockingham,51165,19040,14500,4540,17130,68,17062,1910,41,1869,17697,13158,4539,14632,10549,4083,1801,508,131,12192
1/1/2022,VA,Virginia,Russell,51167,7988,3791,4197,5995,21,5974,1993,21,1972,7672,3476,4196,6788,3198,3590,1671,327,105,4685
1/1/2022,VA,Virginia,Salem City,51775,6163,4202,1961,5391,35,5356,772,13,759,5653,3692,1961,4712,2903,1809,763,122,39,3788
1/1/2022,VA,Virginia,Scott,51169,6797,2420,4377,5352,15,5337,1445,*,*,6524,2147,4377,5827,1673,4154,1522,276,86,3943
1/1/2022,VA,Virginia,Shenandoah,51171,11148,8126,3022,10085,34,10051,1063,17,1046,10432,7411,3021,7947,5312,2635,1244,285,71,6347
1/1/2022,VA,Virginia,Smyth,51173,8664,4963,3701,6759,20,6739,1905,25,1880,8219,4518,3701,7025,3508,3517,2017,379,112,4517
1/1/2022,VA,Virginia,Southampton,51175,4194,2876,1318,3634,37,3597,560,22,538,3886,2568,1318,3165,1963,1202,668,145,30,2322
1/1/2022,VA,Virginia,Spotsylvania,51177,24071,16967,7104,21494,149,21345,2577,100,2477,21379,14277,7102,14079,7754,6325,2284,555,117,11123
1/1/2022,VA,Virginia,Stafford,51179,19980,15145,4835,18093,143,17950,1887,88,1799,17549,12717,4832,9925,5669,4256,1647,407,67,7804
1/1/2022,VA,Virginia,Staunton City,51790,6431,4674,1757,5534,29,5505,897,16,881,6060,4303,1757,4952,3336,1616,1082,150,48,3672
1/1/2022,VA,Virginia,Suffolk City,51800,18195,11963,6232,15510,167,15343,2685,111,2574,16666,10434,6232,11796,6020,5776,2854,525,90,8327
1/1/2022,VA,Virginia,Surry,51181,1811,1161,650,1595,16,1579,216,*,*,1675,1025,650,1294,678,616,232,51,13,998
1/1/2022,VA,Virginia,Sussex,51183,2546,1525,1021,2144,25,2119,402,14,388,2376,1355,1021,1930,962,968,502,142,21,1265
1/1/2022,VA,Virginia,Tazewell,51185,11959,6385,5574,9351,43,9308,2608,36,2572,11412,5840,5572,9489,5012,4477,2288,503,122,6576
1/1/2022,VA,Virginia,Unknown,51999,*,*,*,*,*,*,*,*,*,*,*,*,*,*,*,*,*,*,*
1/1/2022,VA,Virginia,Virginia Beach City,51810,78577,56252,22325,70894,460,70434,7683,311,7372,71988,49670,22318,44736,24392,20344,7347,1632,336,35421
1/1/2022,VA,Virginia,Warren,51187,8565,6270,2295,7628,27,7601,937,27,910,7769,5474,2295,5683,3748,1935,948,236,60,4439
1/1/2022,VA,Virginia,Washington,51191,15723,8241,7482,13184,46,13138,2539,30,2509,14880,7399,7481,12736,5813,6923,2383,634,160,9559
1/1/2022,VA,Virginia,Waynesboro City,51820,5156,3682,1474,4407,25,4382,749,22,727,4831,3357,1474,4001,2604,1397,866,138,42,2955
1/1/2022,VA,Virginia,Westmoreland,51193,5448,3966,1482,4916,35,4881,532,18,514,4941,3459,1482,3457,2128,1329,827,138,40,2452
1/1/2022,VA,Virginia,Williamsburg City,51830,3039,2217,822,2801,11,2790,238,*,*,2805,1983,822,2100,1377,723,294,*,*,1758
1/1/2022,VA,Virginia,Winchester City,51840,5646,4179,1467,4937,31,4906,709,18,691,5159,3692,1467,3966,2684,1282,912,156,28,2870
1/1/2022,VA,Virginia,Wise,51195,10624,4188,6436,7712,32,7680,2912,32,2880,10074,3638,6436,8455,2839,5616,2392,483,131,5449
1/1/2022,VA,Virginia,Wythe,51197,8052,4627,3425,6493,43,6450,1559,14,1545,7640,4215,3425,6507,3324,3183,1637,316,76,4478
1/1/2022,VA,Virginia,York,51199,13188,10215,2973,12282,47,12235,906,43,863,12067,9094,2973,6887,4268,2619,742,175,38,5932
7/1/2022,VA,Virginia,Accomack,51001,9657,6703,2954,8525,52,8473,1132,41,1091,8925,5972,2953,6898,4306,2592,1609,362,68,4859
7/1/2022,VA,Virginia,Albemarle,51003,23896,19259,4637,22394,55,22339,1502,50,1452,21641,17006,4635,17342,13231,4111,1763,298,63,15218
7/1/2022,VA,Virginia,Alexandria City,51510,19222,14335,4887,17986,81,17905,1236,73,1163,15621,10736,4885,10360,5869,4491,2240,320,51,7749
7/1/2022,VA,Virginia,Alleghany,51005,4650,3195,1455,3864,19,3845,786,*,*,4413,2958,1455,3726,2441,1285,826,114,30,2756
7/1/2022,VA,Virginia,Amelia,51007,3325,2055,1270,2911,*,*,414,11,403,3074,1804,1270,2537,1338,1199,468,91,18,1960
7/1/2022,VA,Virginia,Amherst,51009,8196,5253,2943,7038,53,6985,1158,29,1129,7662,4719,2943,6443,3715,2728,1278,235,59,4871
7/1/2022,VA,Virginia,Appomattox,51011,4289,2804,1485,3582,20,3562,707,26,681,4021,2537,1484,3390,2012,1378,800,105,38,2447
7/1/2022,VA,Virginia,Arlington,51013,26149,19888,6261,24688,107,24581,1461,69,1392,20742,14482,6260,13710,7894,5816,3136,399,100,10075
7/1/2022,VA,Virginia,Augusta,51015,19605,14414,5191,17393,74,17319,2212,41,2171,18436,13245,5191,15111,10341,4770,2035,433,127,12516
7/1/2022,VA,Virginia,Bath,51017,1316,1037,279,1180,*,*,136,*,*,1248,969,279,1024,768,256,163,33,13,815
7/1/2022,VA,Virginia,Bedford,51019,21402,14698,6704,18896,68,18828,2506,49,2457,19995,13291,6704,16471,10658,5813,2113,519,136,13703
7/1/2022,VA,Virginia,Bland,51021,1841,1152,689,1518,*,*,323,*,*,1730,1041,689,1411,838,573,225,56,13,1117
7/1/2022,VA,Virginia,Botetourt,51023,9202,6095,3107,8231,47,8184,971,18,953,8597,5490,3107,7054,4333,2721,762,173,34,6085
7/1/2022,VA,Virginia,Bristol City,51520,4488,1899,2589,3615,*,*,873,16,857,4224,1635,2589,3710,1223,2487,1074,158,31,2447
7/1/2022,VA,Virginia,Brunswick,51025,4191,2501,1690,3582,26,3556,609,16,593,3935,2245,1690,3260,1697,1563,1037,137,24,2062
7/1/2022,VA,Virginia,Buchanan,51027,6821,2932,3889,4702,18,4684,2119,12,2107,6579,2690,3889,5765,2592,3173,1566,391,75,3733
7/1/2022,VA,Virginia,Buckingham,51029,3862,2468,1394,3256,23,3233,606,16,590,3611,2218,1393,2922,1698,1224,807,140,33,1942
7/1/2022,VA,Virginia,Buena Vista City,51530,1481,957,524,1220,*,*,261,*,*,1382,858,524,1108,635,473,304,47,17,740
7/1/2022,VA,Virginia,Campbell,51031,13604,8676,4928,11653,74,11579,1951,59,1892,12743,7815,4928,10852,6306,4546,2156,382,114,8200
7/1/2022,VA,Virginia,Caroline,51033,6423,4179,2244,5587,26,5561,836,32,804,5797,3553,2244,4259,2226,2033,888,199,40,3132
7/1/2022,VA,Virginia,Carroll,51035,8718,5894,2824,7399,35,7364,1319,17,1302,8336,5512,2824,6812,4251,2561,1555,297,81,4879
7/1/2022,VA,Virginia,Charles City,51036,2015,1244,771,1771,20,1751,244,*,*,1853,1082,771,1500,802,698,260,88,11,1141
7/1/2022,VA,Virginia,Charlotte,51037,3250,2164,1086,2741,21,2720,509,13,496,3059,1973,1086,2529,1534,995,691,129,22,1687
7/1/2022,VA,Virginia,Charlottesville City,51540,6338,4751,1587,5521,31,5490,817,29,788,5725,4140,1585,4802,3301,1501,1116,156,18,3512
7/1/2022,VA,Virginia,Chesapeake City,51550,42623,28707,13916,37783,294,37489,4840,175,4665,38604,24689,13915,24986,12320,12666,4608,1009,171,19198
7/1/2022,VA,Virginia,Chesterfield,51041,68217,45014,23203,61384,257,61127,6833,234,6599,61906,38707,23199,50180,28902,21278,6313,1040,195,42632
7/1/2022,VA,Virginia,Clarke,51043,3740,2878,862,3503,*,*,237,*,*,3383,2521,862,2483,1759,724,302,72,25,2084
7/1/2022,VA,Virginia,Colonial Heights City,51570,4098,2901,1197,3558,18,3540,540,11,529,3781,2584,1197,2667,1570,1097,528,110,17,2012
7/1/2022,VA,Virginia,Covington City,51580,1552,1029,523,1205,12,1193,347,*,*,1457,934,523,1229,730,499,354,*,*,810
7/1/2022,VA,Virginia,Craig,51045,1397,848,549,1151,*,*,246,*,*,1312,763,549,1099,600,499,196,*,*,842
7/1/2022,VA,Virginia,Culpeper,51047,10404,7586,2818,9269,48,9221,1135,31,1104,9439,6621,2818,7073,4727,2346,1288,240,60,5485
7/1/2022,VA,Virginia,Cumberland,51049,2419,1494,925,2058,13,2045,361,*,*,2247,1322,925,1870,1024,846,457,96,18,1299
7/1/2022,VA,Virginia,Danville City,51590,11038,5784,5254,8958,86,8872,2080,105,1975,10395,5141,5254,9148,4813,4335,3248,423,97,5380
7/1/2022,VA,Virginia,Dickenson,51051,4825,1821,3004,3358,12,3346,1467,*,*,4648,1644,3004,4041,1359,2682,1105,214,36,2686
7/1/2022,VA,Virginia,Dinwiddie,51053,6336,3944,2392,5334,33,5301,1002,30,972,5872,3480,2392,4632,2399,2233,962,216,37,3417
7/1/2022,VA,Virginia,Emporia City,51595,1318,683,635,1076,16,1060,242,11,231,1230,595,635,1069,484,585,460,*,*,541
7/1/2022,VA,Virginia,Essex,51057,3094,2019,1075,2704,15,2689,390,14,376,2887,1812,1075,2302,1365,937,490,82,28,1702
7/1/2022,VA,Virginia,Fairfax,51059,166286,121544,44742,158685,632,158053,7601,392,7209,135099,90375,44724,87789,48620,39169,15610,2687,484,69008
7/1/2022,VA,Virginia,Fairfax City,51600,4241,3082,1159,3999,14,3985,242,11,231,3520,2362,1158,2409,1436,973,409,*,*,1920
7/1/2022,VA,Virginia,Falls Church City,51610,2242,1706,536,2164,*,*,78,*,*,1805,1269,536,1199,726,473,130,*,*,1053
7/1/2022,VA,Virginia,Fauquier,51061,13883,10723,3160,12916,69,12847,967,36,931,12267,9108,3159,8644,6074,2570,1021,193,46,7384
7/1/2022,VA,Virginia,Floyd,51063,4421,2942,1479,3907,14,3893,514,*,*,4131,2653,1478,3421,2035,1386,634,114,27,2646
7/1/2022,VA,Virginia,Fluvanna,51065,6913,5193,1720,6297,28,6269,616,17,599,6321,4601,1720,4892,3392,1500,656,111,22,4103
7/1/2022,VA,Virginia,Franklin,51067,15861,9727,6134,13760,56,13704,2101,35,2066,14940,8806,6134,12630,7041,5589,2080,484,114,9952
7/1/2022,VA,Virginia,Franklin City,51620,2212,1394,818,1843,15,1828,369,16,353,2088,1270,818,1766,988,778,554,*,*,1134
7/1/2022,VA,Virginia,Frederick,51069,18604,13808,4796,16897,70,16827,1707,46,1661,16887,12093,4794,12462,8374,4088,1539,391,98,10434
7/1/2022,VA,Virginia,Fredericksburg City,51630,4370,3052,1318,3748,23,3725,622,26,596,3902,2585,1317,2824,1606,1218,821,92,26,1885
7/1/2022,VA,Virginia,Galax City,51640,1695,1184,511,1400,*,*,295,*,*,1615,1104,511,1372,894,478,533,52,17,770
7/1/2022,VA,Virginia,Giles,51071,4523,2841,1682,3720,12,3708,803,16,787,4285,2603,1682,3682,2224,1458,745,113,26,2798
7/1/2022,VA,Virginia,Gloucester,51073,9687,6878,2809,8631,44,8587,1056,23,1033,8991,6182,2809,6168,3636,2532,1046,192,46,4884
7/1/2022,VA,Virginia,Goochland,51075,6932,5037,1895,6488,36,6452,444,11,433,6349,4454,1895,5444,3777,1667,449,102,17,4876
7/1/2022,VA,Virginia,Grayson,51077,4724,3094,1630,3997,14,3983,727,*,*,4531,2901,1630,3700,2174,1526,933,173,60,2534
7/1/2022,VA,Virginia,Greene,51079,4359,3277,1082,3882,15,3867,477,11,466,3947,2865,1082,3035,2045,990,486,101,16,2432
7/1/2022,VA,Virginia,Greensville,51081,2219,1221,998,1835,26,1809,384,12,372,2050,1052,998,1739,836,903,471,112,20,1136
7/1/2022,VA,Virginia,Halifax,51083,10087,6698,3389,8537,61,8476,1550,55,1495,9499,6110,3389,7944,4805,3139,2096,397,113,5338
7/1/2022,VA,Virginia,Hampton City,51650,26930,15979,10951,22846,235,22611,4084,193,3891,24603,13654,10949,16480,6299,10181,4315,824,138,11203
7/1/2022,VA,Virginia,Hanover,51085,23991,16138,7853,22215,98,22117,1776,53,1723,22032,14182,7850,18532,11658,6874,1621,326,62,16523
7/1/2022,VA,Virginia,Harrisonburg City,51660,5707,4202,1505,4940,22,4918,767,22,745,5211,3706,1505,4364,2976,1388,1000,159,32,3173
7/1/2022,VA,Virginia,Henrico,51087,61746,38719,23027,55191,394,54797,6555,289,6266,56117,33092,23025,47820,26793,21027,7293,1428,265,38834
7/1/2022,VA,Virginia,Henry,51089,14818,8005,6813,12124,91,12033,2694,61,2633,14093,7281,6812,12436,6008,6428,3017,733,156,8530
7/1/2022,VA,Virginia,Highland,51091,889,699,190,813,*,*,76,0,76,846,656,190,675,505,170,76,*,*,573
7/1/2022,VA,Virginia,Hopewell City,51670,4585,2738,1847,3675,33,3642,910,29,881,4255,2408,1847,3206,1443,1763,1068,161,23,1954
7/1/2022,VA,Virginia,Isle of Wight,51093,9265,6313,2952,8307,54,8253,958,35,923,8560,5609,2951,6270,3530,2740,1018,196,59,4997
7/1/2022,VA,Virginia,James City,51095,22840,17623,5217,21619,62,21557,1221,36,1185,21200,15987,5213,14566,10259,4307,1051,222,44,13249
7/1/2022,VA,Virginia,King and Queen,51097,1853,1235,618,1622,11,1611,231,*,*,1745,1127,618,1395,839,556,281,*,*,1038
7/1/2022,VA,Virginia,King George,51099,4461,3393,1068,3975,23,3952,486,18,468,3862,2794,1068,2192,1219,973,487,84,23,1598
7/1/2022,VA,Virginia,King William,51101,3829,2600,1229,3360,32,3328,469,23,446,3543,2314,1229,2972,1838,1134,439,99,15,2419
7/1/2022,VA,Virginia,Lancaster,51103,4485,3357,1128,4182,18,4164,303,13,290,4204,3077,1127,3247,2303,944,490,95,11,2651
7/1/2022,VA,Virginia,Lee,51105,6450,2339,4111,4746,20,4726,1704,17,1687,6147,2039,4108,5237,1535,3702,1925,237,57,3018
7/1/2022,VA,Virginia,Lexington City,51678,1321,1002,319,1221,*,*,100,*,*,1223,905,318,982,692,290,169,*,*,776
7/1/2022,VA,Virginia,Loudoun,51107,45513,33152,12361,43165,168,42997,2348,123,2225,37881,25529,12352,26975,16158,10817,3972,695,144,22164
7/1/2022,VA,Virginia,Louisa,51109,9536,6472,3064,8336,45,8291,1200,30,1170,8725,5662,3063,6796,4051,2745,1184,249,53,5310
7/1/2022,VA,Virginia,Lunenburg,51111,3234,2069,1165,2759,18,2741,475,*,*,3041,1876,1165,2447,1367,1080,757,121,26,1543
7/1/2022,VA,Virginia,Lynchburg City,51680,14867,9331,5536,12521,95,12426,2346,82,2264,13869,8333,5536,11865,6697,5168,2982,459,106,8318
7/1/2022,VA,Virginia,Madison,51113,3521,2590,931,3184,*,*,337,*,*,3270,2340,930,2546,1746,800,419,82,18,2027
7/1/2022,VA,Virginia,Manassas City,51683,5092,3442,1650,4633,22,4611,459,32,427,4299,2649,1650,3186,1705,1481,576,108,19,2483
7/1/2022,VA,Virginia,Manassas Park City,51685,1444,829,615,1273,16,1257,171,12,159,1217,602,615,947,376,571,238,*,*,652
7/1/2022,VA,Virginia,Martinsville City,51690,3808,1998,1810,2957,36,2921,851,29,822,3595,1785,1810,3174,1438,1736,1258,163,38,1715
7/1/2022,VA,Virginia,Mathews,51115,3022,2226,796,2789,19,2770,233,*,*,2849,2053,796,2170,1484,686,298,42,12,1818
7/1/2022,VA,Virginia,Mecklenburg,51117,9592,6199,3393,8210,57,8153,1382,47,1335,9004,5611,3393,7383,4286,3097,1776,412,73,5122
7/1/2022,VA,Virginia,Middlesex,51119,3775,2751,1024,3467,17,3450,308,*,*,3550,2526,1024,2801,1918,883,448,80,11,2262
7/1/2022,VA,Virginia,Montgomery,51121,14847,10375,4472,12790,66,12724,2057,30,2027,13402,8930,4472,11460,7312,4148,1994,327,78,9061
7/1/2022,VA,Virginia,Nelson,51125,4958,3602,1356,4521,16,4505,437,*,*,4619,3263,1356,3537,2339,1198,551,111,20,2855
7/1/2022,VA,Virginia,New Kent,51127,5494,3892,1602,5006,25,4981,488,17,471,5040,3438,1602,3783,2441,1342,352,95,18,3318
7/1/2022,VA,Virginia,Newport News City,51700,30399,17849,12550,25724,232,25492,4675,227,4448,27812,15263,12549,19672,7864,11808,5487,923,160,13102
7/1/2022,VA,Virginia,Norfolk City,51710,35147,20310,14837,29398,288,29110,5749,311,5438,31663,16828,14835,23101,9021,14080,7891,1377,213,13620
7/1/2022,VA,Virginia,Northampton,51131,3956,2546,1410,3538,21,3517,418,23,395,3702,2292,1410,3084,1803,1281,895,88,19,2082
7/1/2022,VA,Virginia,Northumberland,51133,4887,3606,1281,4552,15,4537,335,12,323,4552,3271,1281,3331,2282,1049,462,85,17,2767
7/1/2022,VA,Virginia,Norton City,51720,1091,461,630,790,*,*,301,*,*,1030,400,630,904,335,569,343,*,*,503
7/1/2022,VA,Virginia,Nottoway,51135,3661,2374,1287,3083,22,3061,578,15,563,3414,2127,1287,2770,1591,1179,821,140,33,1776
7/1/2022,VA,Virginia,Orange,51137,9341,6712,2629,8396,48,8348,945,24,921,8533,5904,2629,6181,3912,2269,1005,212,39,4925
7/1/2022,VA,Virginia,Page,51139,6425,4659,1766,5446,20,5426,979,21,958,6015,4249,1766,4708,3110,1598,1085,252,48,3323
7/1/2022,VA,Virginia,Patrick,51141,5548,3369,2179,4724,16,4708,824,*,*,5274,3097,2177,4439,2423,2016,1031,189,48,3171
7/1/2022,VA,Virginia,Petersburg City,51730,7161,3670,3491,5530,88,5442,1631,77,1554,6542,3051,3491,5230,1917,3313,2208,325,54,2643
7/1/2022,VA,Virginia,Pittsylvania,51143,16999,9870,7129,14408,111,14297,2591,72,2519,16053,8924,7129,13865,8069,5796,3088,553,132,10092
7/1/2022,VA,Virginia,Poquoson City,51735,2715,2152,563,2553,*,*,162,*,*,2496,1933,563,1432,917,515,129,*,*,1269
7/1/2022,VA,Virginia,Portsmouth City,51740,18836,10795,8041,15213,187,15026,3623,191,3432,16972,8931,8041,12161,4520,7641,4254,752,109,7046
7/1/2022,VA,Virginia,Powhatan,51145,6851,4872,1979,6294,16,6278,557,14,543,6334,4355,1979,5263,3493,1770,432,113,22,4696
7/1/2022,VA,Virginia,Prince Edward,51147,4874,3123,1751,4075,37,4038,799,25,774,4523,2772,1751,3724,2096,1628,1068,166,39,2451
7/1/2022,VA,Virginia,Prince George,51149,6757,4975,1782,5823,32,5791,934,32,902,6244,4462,1782,4133,2521,1612,671,141,29,3292
7/1/2022,VA,Virginia,Prince William,51153,56051,39283,16768,51264,302,50962,4787,271,4516,47811,31047,16764,30215,15037,15178,6008,1231,199,22777
7/1/2022,VA,Virginia,Pulaski,51155,9280,5693,3587,7644,33,7611,1636,30,1606,8650,5063,3587,7321,4023,3298,1580,275,64,5402
7/1/2022,VA,Virginia,Radford City,51750,2145,1408,737,1783,*,*,362,*,*,1940,1203,737,1692,1001,691,340,47,19,1286
7/1/2022,VA,Virginia,Rappahannock,51157,2123,1678,445,2002,*,*,121,*,*,1925,1481,444,1411,1048,363,157,37,12,1205
7/1/2022,VA,Virginia,Richmond,51159,2037,1383,654,1812,*,*,225,*,*,1902,1248,654,1499,945,554,345,*,*,1081
7/1/2022,VA,Virginia,Richmond City,51760,34994,18531,16463,29106,293,28813,5888,256,5632,31675,15214,16461,27784,12091,15693,8911,1355,208,17310
7/1/2022,VA,Virginia,Roanoke,51161,24818,16613,8205,22397,107,22290,2421,50,2371,22964,14763,8201,19250,11939,7311,2183,473,115,16479
7/1/2022,VA,Virginia,Roanoke City,51770,21403,11768,9635,17095,155,16940,4308,126,4182,19623,9988,9635,16711,7717,8994,4852,903,155,10801
7/1/2022,VA,Virginia,Rockbridge,51163,6733,4810,1923,5898,15,5883,835,*,*,6273,4350,1923,4952,3211,1741,876,177,48,3851
7/1/2022,VA,Virginia,Rockingham,51165,19162,14510,4652,17237,58,17179,1925,40,1885,17784,13132,4652,14700,10497,4203,1845,480,114,12261
7/1/2022,VA,Virginia,Russell,51167,7983,3727,4256,5956,19,5937,2027,22,2005,7668,3413,4255,6780,3130,3650,1690,319,82,4689
7/1/2022,VA,Virginia,Salem City,51775,6190,4191,1999,5393,28,5365,797,16,781,5689,3690,1999,4719,2878,1841,774,120,32,3793
7/1/2022,VA,Virginia,Scott,51169,6787,2368,4419,5338,13,5325,1449,*,*,6508,2089,4419,5811,1623,4188,1525,271,76,3939
7/1/2022,VA,Virginia,Shenandoah,51171,11171,8057,3114,10092,29,10063,1079,16,1063,10479,7366,3113,8010,5283,2727,1255,290,63,6402
7/1/2022,VA,Virginia,Smyth,51173,8602,4827,3775,6685,19,6666,1917,21,1896,8162,4387,3775,6976,3398,3578,2006,379,104,4487
7/1/2022,VA,Virginia,Southampton,51175,4215,2853,1362,3637,31,3606,578,23,555,3913,2551,1362,3186,1941,1245,690,147,28,2321
7/1/2022,VA,Virginia,Spotsylvania,51177,24389,17110,7279,21779,135,21644,2610,98,2512,21637,14360,7277,14217,7719,6498,2365,528,103,11221
7/1/2022,VA,Virginia,Stafford,51179,20333,15295,5038,18398,134,18264,1935,87,1848,17862,12828,5034,10093,5644,4449,1723,407,66,7897
7/1/2022,VA,Virginia,Staunton City,51790,6435,4616,1819,5531,27,5504,904,16,888,6062,4243,1819,4959,3278,1681,1093,144,43,3679
7/1/2022,VA,Virginia,Suffolk City,51800,18370,11916,6454,15632,144,15488,2738,110,2628,16845,10391,6454,11874,5887,5987,2887,525,81,8381
7/1/2022,VA,Virginia,Surry,51181,1835,1167,668,1610,14,1596,225,*,*,1690,1022,668,1323,689,634,242,49,13,1019
7/1/2022,VA,Virginia,Sussex,51183,2546,1480,1066,2146,18,2128,400,14,386,2380,1314,1066,1926,927,999,501,138,19,1268
7/1/2022,VA,Virginia,Tazewell,51185,11923,6274,5649,9290,37,9253,2633,33,2600,11391,5743,5648,9466,4904,4562,2310,497,113,6546
7/1/2022,VA,Virginia,Unknown,51999,*,*,*,*,*,*,*,*,*,*,*,*,*,*,*,*,*,*,*
7/1/2022,VA,Virginia,Virginia Beach City,51810,79381,56430,22951,71583,395,71188,7798,306,7492,72731,49787,22944,45098,24189,20909,7471,1636,305,35686
7/1/2022,VA,Virginia,Warren,51187,8628,6242,2386,7675,22,7653,953,24,929,7844,5458,2386,5769,3733,2036,987,223,62,4497
7/1/2022,VA,Virginia,Washington,51191,15733,8159,7574,13152,38,13114,2581,26,2555,14903,7330,7573,12767,5759,7008,2419,608,127,9613
7/1/2022,VA,Virginia,Waynesboro City,51820,5143,3626,1517,4390,24,4366,753,17,736,4810,3293,1517,3984,2545,1439,874,135,38,2937
7/1/2022,VA,Virginia,Westmoreland,51193,5490,3971,1519,4946,31,4915,544,19,525,4980,3461,1519,3482,2114,1368,835,132,32,2483
7/1/2022,VA,Virginia,Williamsburg City,51830,3074,2225,849,2825,*,*,249,*,*,2827,1978,849,2122,1370,752,305,*,*,1770
7/1/2022,VA,Virginia,Winchester City,51840,5696,4160,1536,4972,27,4945,724,18,706,5199,3663,1536,4005,2650,1355,935,157,26,2887
7/1/2022,VA,Virginia,Wise,51195,10582,4053,6529,7639,28,7611,2943,32,2911,10057,3528,6529,8443,2720,5723,2420,473,115,5435
7/1/2022,VA,Virginia,Wythe,51197,8047,4522,3525,6478,38,6440,1569,12,1557,7623,4098,3525,6499,3220,3279,1623,303,70,4503
7/1/2022,VA,Virginia,York,51199,13363,10288,3075,12422,43,12379,941,41,900,12218,9143,3075,6974,4256,2718,779,169,35,5991
6/1/2022,VA,Virginia,Accomack,51001,9632,6707,2925,8504,55,8449,1128,41,1087,8901,5977,2924,6864,4300,2564,1595,366,65,4838
6/1/2022,VA,Virginia,Albemarle,51003,23808,19205,4603,22313,58,22255,1495,51,1444,21534,16933,4601,17271,13195,4076,1742,300,61,15168
6/1/2022,VA,Virginia,Alexandria City,51510,19151,14315,4836,17928,82,17846,1223,71,1152,15487,10653,4834,10299,5856,4443,2239,318,52,7690
6/1/2022,VA,Virginia,Alleghany,51005,4657,3211,1446,3871,19,3852,786,*,*,4407,2961,1446,3716,2442,1274,828,115,30,2743
6/1/2022,VA,Virginia,Amelia,51007,3328,2064,1264,2911,*,*,417,12,405,3066,1802,1264,2533,1342,1191,471,88,19,1955
6/1/2022,VA,Virginia,Amherst,51009,8178,5248,2930,7022,53,6969,1156,29,1127,7626,4696,2930,6425,3713,2712,1273,240,59,4853
6/1/2022,VA,Virginia,Appomattox,51011,4283,2811,1472,3579,20,3559,704,26,678,4004,2533,1471,3373,2009,1364,797,105,38,2433
6/1/2022,VA,Virginia,Arlington,51013,26079,19888,6191,24627,110,24517,1452,70,1382,20551,14361,6190,13631,7882,5749,3124,401,101,10005
6/1/2022,VA,Virginia,Augusta,51015,19567,14412,5155,17364,74,17290,2203,43,2160,18381,13226,5155,15081,10350,4731,2032,431,126,12492
6/1/2022,VA,Virginia,Bath,51017,1315,1038,277,1179,*,*,136,*,*,1244,967,277,1020,764,256,161,31,13,815
6/1/2022,VA,Virginia,Bedford,51019,21364,14718,6646,18863,69,18794,2501,50,2451,19907,13261,6646,16415,10658,5757,2102,518,137,13658
6/1/2022,VA,Virginia,Bland,51021,1837,1153,684,1513,*,*,324,*,*,1727,1043,684,1407,836,571,221,57,14,1115
6/1/2022,VA,Virginia,Botetourt,51023,9198,6101,3097,8229,47,8182,969,18,951,8580,5483,3097,7042,4331,2711,756,173,35,6078
6/1/2022,VA,Virginia,Bristol City,51520,4494,1915,2579,3621,*,*,873,16,857,4222,1643,2579,3708,1231,2477,1077,157,31,2443
6/1/2022,VA,Virginia,Brunswick,51025,4173,2505,1668,3564,26,3538,609,16,593,3912,2244,1668,3253,1710,1543,1035,138,23,2057
6/1/2022,VA,Virginia,Buchanan,51027,6822,2945,3877,4710,19,4691,2112,12,2100,6575,2698,3877,5762,2602,3160,1561,390,76,3735
6/1/2022,VA,Virginia,Buckingham,51029,3852,2473,1379,3245,24,3221,607,16,591,3597,2219,1378,2904,1697,1207,798,138,32,1936
6/1/2022,VA,Virginia,Buena Vista City,51530,1482,963,519,1222,*,*,260,*,*,1380,861,519,1108,640,468,303,47,17,741
6/1/2022,VA,Virginia,Campbell,51031,13577,8687,4890,11631,74,11557,1946,58,1888,12699,7809,4890,10821,6313,4508,2146,384,116,8175
6/1/2022,VA,Virginia,Caroline,51033,6416,4190,2226,5582,27,5555,834,32,802,5771,3545,2226,4251,2235,2016,876,200,43,3132
6/1/2022,VA,Virginia,Carroll,51035,8722,5907,2815,7401,36,7365,1321,17,1304,8330,5515,2815,6816,4262,2554,1557,297,81,4881
6/1/2022,VA,Virginia,Charles City,51036,2015,1247,768,1770,20,1750,245,*,*,1854,1086,768,1502,807,695,265,*,*,1140
6/1/2022,VA,Virginia,Charlotte,51037,3247,2165,1082,2737,22,2715,510,13,497,3045,1963,1082,2527,1535,992,687,129,22,1689
6/1/2022,VA,Virginia,Charlottesville City,51540,6337,4764,1573,5520,31,5489,817,30,787,5705,4134,1571,4796,3308,1488,1118,157,18,3503
6/1/2022,VA,Virginia,Chesapeake City,51550,42505,28704,13801,37679,294,37385,4826,177,4649,38355,24555,13800,24869,12312,12557,4573,1008,171,19117
6/1/2022,VA,Virginia,Chesterfield,51041,67992,44943,23049,61186,265,60921,6806,231,6575,61512,38468,23044,49928,28794,21134,6273,1049,194,42412
6/1/2022,VA,Virginia,Clarke,51043,3736,2884,852,3501,12,3489,235,*,*,3369,2517,852,2478,1763,715,303,73,25,2077
6/1/2022,VA,Virginia,Colonial Heights City,51570,4089,2897,1192,3550,19,3531,539,*,*,3763,2571,1192,2663,1571,1092,524,112,17,2010
6/1/2022,VA,Virginia,Covington City,51580,1551,1034,517,1205,12,1193,346,*,*,1451,934,517,1225,732,493,352,*,*,807
6/1/2022,VA,Virginia,Craig,51045,1394,848,546,1149,*,*,245,*,*,1310,764,546,1098,603,495,196,*,*,841
6/1/2022,VA,Virginia,Culpeper,51047,10369,7577,2792,9239,48,9191,1130,30,1100,9364,6572,2792,7031,4710,2321,1271,239,61,5460
6/1/2022,VA,Virginia,Cumberland,51049,2413,1494,919,2051,13,2038,362,*,*,2237,1318,919,1864,1025,839,459,96,18,1291
6/1/2022,VA,Virginia,Danville City,51590,11039,5819,5220,8964,86,8878,2075,107,1968,10370,5150,5220,9127,4829,4298,3217,428,95,5387
6/1/2022,VA,Virginia,Dickenson,51051,4823,1837,2986,3359,12,3347,1464,*,*,4641,1655,2986,4030,1366,2664,1099,214,36,2681
6/1/2022,VA,Virginia,Dinwiddie,51053,6313,3954,2359,5313,33,5280,1000,29,971,5826,3467,2359,4602,2403,2199,961,217,37,3387
6/1/2022,VA,Virginia,Emporia City,51595,1317,690,627,1075,16,1059,242,*,*,1227,600,627,1069,491,578,462,*,*,538
6/1/2022,VA,Virginia,Essex,51057,3090,2022,1068,2700,15,2685,390,14,376,2875,1807,1068,2297,1369,928,493,83,28,1693
6/1/2022,VA,Virginia,Fairfax,51059,165670,121275,44395,158104,639,157465,7566,393,7173,133905,89528,44377,87309,48477,38832,15474,2697,485,68653
6/1/2022,VA,Virginia,Fairfax City,51600,4211,3065,1146,3970,14,3956,241,*,*,3482,2337,1145,2386,1426,960,405,*,*,1901
6/1/2022,VA,Virginia,Falls Church City,51610,2236,1703,533,2159,*,*,77,*,*,1787,1254,533,1194,723,471,128,*,*,1050
6/1/2022,VA,Virginia,Fauquier,51061,13829,10702,3127,12865,72,12793,964,35,929,12202,9076,3126,8613,6079,2534,1014,189,45,7365
6/1/2022,VA,Virginia,Floyd,51063,4415,2941,1474,3902,14,3888,513,*,*,4125,2652,1473,3411,2028,1383,631,117,26,2637
6/1/2022,VA,Virginia,Fluvanna,51065,6888,5198,1690,6275,28,6247,613,16,597,6284,4594,1690,4866,3394,1472,651,113,22,4080
6/1/2022,VA,Virginia,Franklin,51067,15849,9765,6084,13750,58,13692,2099,35,2064,14900,8816,6084,12588,7047,5541,2073,493,113,9909
6/1/2022,VA,Virginia,Franklin City,51620,2206,1399,807,1837,15,1822,369,16,353,2079,1272,807,1756,989,767,553,*,*,1127
6/1/2022,VA,Virginia,Frederick,51069,18553,13788,4765,16851,71,16780,1702,45,1657,16815,12052,4763,12401,8345,4056,1533,391,97,10380
6/1/2022,VA,Virginia,Fredericksburg City,51630,4355,3046,1309,3736,23,3713,619,26,593,3876,2568,1308,2820,1607,1213,816,93,27,1884
6/1/2022,VA,Virginia,Galax City,51640,1696,1188,508,1401,*,*,295,*,*,1614,1106,508,1373,898,475,530,54,18,771
6/1/2022,VA,Virginia,Giles,51071,4535,2853,1682,3730,12,3718,805,16,789,4297,2615,1682,3689,2231,1458,746,114,26,2803
6/1/2022,VA,Virginia,Gloucester,51073,9669,6866,2803,8616,45,8571,1053,24,1029,8939,6136,2803,6138,3615,2523,1047,193,46,4852
6/1/2022,VA,Virginia,Goochland,51075,6905,5022,1883,6463,37,6426,442,11,431,6308,4425,1883,5412,3757,1655,446,105,17,4844
6/1/2022,VA,Virginia,Grayson,51077,4720,3098,1622,3997,14,3983,723,11,712,4515,2893,1622,3686,2167,1519,925,174,62,2525
6/1/2022,VA,Virginia,Greene,51079,4337,3252,1085,3864,15,3849,473,*,*,3929,2844,1085,3036,2043,993,484,100,15,2437
6/1/2022,VA,Virginia,Greensville,51081,2214,1219,995,1830,26,1804,384,12,372,2042,1047,995,1733,834,899,466,111,21,1135
6/1/2022,VA,Virginia,Halifax,51083,10071,6716,3355,8521,61,8460,1550,56,1494,9451,6096,3355,7927,4822,3105,2090,393,110,5334
6/1/2022,VA,Virginia,Hampton City,51650,26855,15974,10881,22792,238,22554,4063,193,3870,24459,13580,10879,16422,6312,10110,4305,831,138,11148
6/1/2022,VA,Virginia,Hanover,51085,23902,16106,7796,22137,103,22034,1765,54,1711,21917,14124,7793,18453,11635,6818,1609,321,63,16460
6/1/2022,VA,Virginia,Harrisonburg City,51660,5699,4205,1494,4933,22,4911,766,22,744,5176,3682,1494,4341,2962,1379,996,161,32,3152
6/1/2022,VA,Virginia,Henrico,51087,61632,38728,22904,55090,406,54684,6542,292,6250,55836,32934,22902,47647,26734,20913,7255,1425,269,38698
6/1/2022,VA,Virginia,Henry,51089,14811,8035,6776,12125,94,12031,2686,62,2624,14066,7291,6775,12440,6048,6392,3018,736,158,8528
6/1/2022,VA,Virginia,Highland,51091,889,699,190,812,*,*,77,0,77,845,655,190,674,504,170,79,*,*,569
6/1/2022,VA,Virginia,Hopewell City,51670,4587,2757,1830,3677,34,3643,910,29,881,4239,2409,1830,3194,1448,1746,1067,165,24,1938
6/1/2022,VA,Virginia,Isle of Wight,51093,9250,6307,2943,8296,56,8240,954,35,919,8525,5583,2942,6255,3523,2732,1018,197,58,4982
6/1/2022,VA,Virginia,James City,51095,22798,17598,5200,21579,64,21515,1219,36,1183,21132,15936,5196,14520,10233,4287,1048,225,45,13202
6/1/2022,VA,Virginia,King and Queen,51097,1849,1239,610,1618,11,1607,231,*,*,1736,1126,610,1390,840,550,280,*,*,1034
6/1/2022,VA,Virginia,King George,51099,4451,3398,1053,3966,23,3943,485,18,467,3836,2783,1053,2176,1217,959,487,83,23,1583
6/1/2022,VA,Virginia,King William,51101,3827,2599,1228,3358,33,3325,469,24,445,3536,2308,1228,2975,1841,1134,440,101,15,2419
6/1/2022,VA,Virginia,Lancaster,51103,4476,3349,1127,4174,18,4156,302,13,289,4184,3058,1126,3237,2296,941,487,96,11,2643
6/1/2022,VA,Virginia,Lee,51105,6439,2354,4085,4740,20,4720,1699,17,1682,6135,2053,4082,5229,1550,3679,1928,233,56,3012
6/1/2022,VA,Virginia,Lexington City,51678,1319,998,321,1220,*,*,99,*,*,1219,899,320,982,689,293,168,*,*,776
6/1/2022,VA,Virginia,Loudoun,51107,45327,33087,12240,42986,170,42816,2341,123,2218,37552,25321,12231,26852,16159,10693,3950,697,145,22060
6/1/2022,VA,Virginia,Louisa,51109,9510,6468,3042,8311,46,8265,1199,30,1169,8683,5642,3041,6770,4044,2726,1181,251,52,5286
6/1/2022,VA,Virginia,Lunenburg,51111,3240,2077,1163,2763,18,2745,477,*,*,3039,1876,1163,2452,1373,1079,763,122,26,1541
6/1/2022,VA,Virginia,Lynchburg City,51680,14859,9362,5497,12515,95,12420,2344,81,2263,13852,8355,5497,11838,6711,5127,2985,456,104,8293
6/1/2022,VA,Virginia,Madison,51113,3511,2587,924,3176,*,*,335,*,*,3257,2334,923,2538,1743,795,416,85,18,2019
6/1/2022,VA,Virginia,Manassas City,51683,5086,3445,1641,4624,23,4601,462,32,430,4274,2633,1641,3177,1706,1471,573,111,19,2474
6/1/2022,VA,Virginia,Manassas Park City,51685,1437,828,609,1265,16,1249,172,12,160,1201,592,609,938,374,564,236,*,*,644
6/1/2022,VA,Virginia,Martinsville City,51690,3797,2009,1788,2950,37,2913,847,29,818,3583,1795,1788,3160,1446,1714,1246,165,36,1713
6/1/2022,VA,Virginia,Mathews,51115,3019,2224,795,2790,19,2771,229,*,*,2845,2050,795,2171,1486,685,294,42,12,1823
6/1/2022,VA,Virginia,Mecklenburg,51117,9579,6209,3370,8201,58,8143,1378,48,1330,8978,5608,3370,7374,4300,3074,1768,413,74,5119
6/1/2022,VA,Virginia,Middlesex,51119,3777,2759,1018,3469,18,3451,308,*,*,3541,2523,1018,2792,1914,878,448,81,11,2252
6/1/2022,VA,Virginia,Montgomery,51121,14809,10365,4444,12757,66,12691,2052,31,2021,13321,8877,4444,11418,7295,4123,1989,324,78,9027
6/1/2022,VA,Virginia,Nelson,51125,4949,3609,1340,4516,16,4500,433,*,*,4599,3259,1340,3532,2352,1180,548,111,20,2853
6/1/2022,VA,Virginia,New Kent,51127,5485,3889,1596,4999,25,4974,486,17,469,5020,3424,1596,3770,2434,1336,349,94,18,3309
6/1/2022,VA,Virginia,Newport News City,51700,30296,17859,12437,25634,235,25399,4662,228,4434,27630,15195,12435,19576,7870,11706,5430,924,159,13063
6/1/2022,VA,Virginia,Norfolk City,51710,35044,20327,14717,29309,295,29014,5735,313,5422,31450,16735,14715,23006,9033,13973,7839,1387,215,13565
6/1/2022,VA,Virginia,Northampton,51131,3945,2560,1385,3530,21,3509,415,23,392,3688,2303,1385,3074,1814,1260,889,88,19,2078
6/1/2022,VA,Virginia,Northumberland,51133,4887,3607,1280,4553,15,4538,334,12,322,4543,3263,1280,3328,2282,1046,453,87,18,2770
6/1/2022,VA,Virginia,Norton City,51720,1088,464,624,786,*,*,302,*,*,1026,402,624,898,335,563,343,*,*,498
6/1/2022,VA,Virginia,Nottoway,51135,3650,2378,1272,3077,22,3055,573,15,558,3388,2116,1272,2755,1591,1164,814,141,33,1767
6/1/2022,VA,Virginia,Orange,51137,9324,6719,2605,8380,50,8330,944,25,919,8494,5889,2605,6171,3925,2246,1000,213,40,4918
6/1/2022,VA,Virginia,Page,51139,6416,4661,1755,5438,21,5417,978,21,957,6002,4247,1755,4697,3112,1585,1077,251,48,3321
6/1/2022,VA,Virginia,Patrick,51141,5549,3384,2165,4729,16,4713,820,*,*,5266,3103,2163,4434,2432,2002,1028,189,48,3169
6/1/2022,VA,Virginia,Petersburg City,51730,7152,3682,3470,5525,89,5436,1627,77,1550,6516,3046,3470,5208,1915,3293,2195,327,53,2633
6/1/2022,VA,Virginia,Pittsylvania,51143,16978,9897,7081,14406,115,14291,2572,71,2501,15997,8916,7081,13821,8068,5753,3079,558,132,10052
6/1/2022,VA,Virginia,Poquoson City,51735,2710,2150,560,2547,*,*,163,*,*,2488,1928,560,1426,914,512,127,*,*,1264
6/1/2022,VA,Virginia,Portsmouth City,51740,18816,10814,8002,15202,194,15008,3614,192,3422,16900,8898,8002,12136,4537,7599,4238,750,107,7041
6/1/2022,VA,Virginia,Powhatan,51145,6830,4875,1955,6276,16,6260,554,15,539,6291,4336,1955,5242,3494,1748,429,115,22,4676
6/1/2022,VA,Virginia,Prince Edward,51147,4876,3133,1743,4070,37,4033,806,25,781,4513,2770,1743,3720,2102,1618,1070,165,40,2445
6/1/2022,VA,Virginia,Prince George,51149,6765,4989,1776,5830,33,5797,935,32,903,6240,4464,1776,4125,2519,1606,666,144,28,3287
6/1/2022,VA,Virginia,Prince William,51153,55846,39220,16626,51071,308,50763,4775,271,4504,47393,30771,16622,30042,15006,15036,5959,1236,200,22647
6/1/2022,VA,Virginia,Pulaski,51155,9274,5701,3573,7641,33,7608,1633,29,1604,8640,5067,3573,7316,4030,3286,1576,277,68,5395
6/1/2022,VA,Virginia,Radford City,51750,2147,1414,733,1786,*,*,361,*,*,1942,1209,733,1695,1007,688,340,48,19,1288
6/1/2022,VA,Virginia,Rappahannock,51157,2111,1670,441,1989,*,*,122,*,*,1909,1469,440,1400,1041,359,156,37,12,1195
6/1/2022,VA,Virginia,Richmond,51159,2033,1386,647,1808,*,*,225,*,*,1895,1248,647,1489,944,545,341,*,*,1073
6/1/2022,VA,Virginia,Richmond City,51760,34927,18536,16391,29040,297,28743,5887,256,5631,31527,15138,16389,27711,12083,15628,8870,1365,208,17268
6/1/2022,VA,Virginia,Roanoke,51161,24782,16604,8178,22363,108,22255,2419,52,2367,22892,14718,8174,19204,11923,7281,2184,474,113,16433
6/1/2022,VA,Virginia,Roanoke City,51770,21396,11800,9596,17094,160,16934,4302,127,4175,19576,9980,9596,16690,7729,8961,4856,911,152,10771
6/1/2022,VA,Virginia,Rockbridge,51163,6712,4797,1915,5880,15,5865,832,*,*,6233,4318,1915,4931,3198,1733,867,179,48,3837
6/1/2022,VA,Virginia,Rockingham,51165,19127,14495,4632,17210,61,17149,1917,39,1878,17719,13087,4632,14681,10497,4184,1835,484,114,12248
6/1/2022,VA,Virginia,Russell,51167,7980,3746,4234,5954,20,5934,2026,21,2005,7658,3425,4233,6766,3136,3630,1681,323,82,4680
6/1/2022,VA,Virginia,Salem City,51775,6186,4200,1986,5392,29,5363,794,16,778,5667,3681,1986,4707,2879,1828,772,119,33,3783
6/1/2022,VA,Virginia,Scott,51169,6790,2392,4398,5337,13,5324,1453,*,*,6499,2101,4398,5806,1636,4170,1527,271,74,3934
6/1/2022,VA,Virginia,Shenandoah,51171,11155,8062,3093,10082,31,10051,1073,16,1057,10444,7352,3092,7983,5279,2704,1246,289,61,6387
6/1/2022,VA,Virginia,Smyth,51173,8604,4847,3757,6688,19,6669,1916,21,1895,8155,4398,3757,6976,3412,3564,2011,381,106,4478
6/1/2022,VA,Virginia,Southampton,51175,4206,2864,1342,3628,31,3597,578,23,555,3892,2550,1342,3175,1946,1229,687,147,28,2313
6/1/2022,VA,Virginia,Spotsylvania,51177,24302,17071,7231,21697,138,21559,2605,101,2504,21514,14285,7229,14151,7700,6451,2338,533,103,11177
6/1/2022,VA,Virginia,Stafford,51179,20252,15245,5007,18326,135,18191,1926,86,1840,17734,12731,5003,10065,5644,4421,1725,407,65,7868
6/1/2022,VA,Virginia,Staunton City,51790,6434,4631,1803,5532,27,5505,902,16,886,6053,4250,1803,4956,3291,1665,1092,142,45,3677
6/1/2022,VA,Virginia,Suffolk City,51800,18313,11900,6413,15594,146,15448,2719,109,2610,16739,10326,6413,11831,5887,5944,2868,528,78,8357
6/1/2022,VA,Virginia,Surry,51181,1826,1161,665,1605,14,1591,221,*,*,1684,1019,665,1316,685,631,238,49,14,1015
6/1/2022,VA,Virginia,Sussex,51183,2542,1487,1055,2141,19,2122,401,14,387,2374,1319,1055,1926,936,990,503,140,19,1264
6/1/2022,VA,Virginia,Tazewell,51185,11931,6313,5618,9302,38,9264,2629,34,2595,11387,5770,5617,9460,4929,4531,2294,493,116,6557
6/1/2022,VA,Virginia,Unknown,51999,*,*,*,*,*,*,*,*,*,*,*,*,*,*,*,*,*,*,*
6/1/2022,VA,Virginia,Virginia Beach City,51810,79149,56359,22790,71381,411,70970,7768,305,7463,72342,49559,22783,44940,24166,20774,7425,1632,304,35579
6/1/2022,VA,Virginia,Warren,51187,8605,6241,2364,7653,23,7630,952,26,926,7795,5431,2364,5749,3734,2015,977,224,59,4489
6/1/2022,VA,Virginia,Washington,51191,15718,8160,7558,13147,39,13108,2571,26,2545,14869,7312,7557,12741,5753,6988,2412,614,128,9587
6/1/2022,VA,Virginia,Waynesboro City,51820,5150,3645,1505,4398,25,4373,752,17,735,4811,3306,1505,3988,2562,1426,878,135,38,2937
6/1/2022,VA,Virginia,Westmoreland,51193,5472,3966,1506,4929,31,4898,543,19,524,4949,3443,1506,3471,2115,1356,828,134,32,2477
6/1/2022,VA,Virginia,Williamsburg City,51830,3074,2229,845,2824,11,2813,250,*,*,2823,1978,845,2115,1368,747,301,*,*,1768
6/1/2022,VA,Virginia,Winchester City,51840,5680,4161,1519,4958,27,4931,722,17,705,5169,3650,1519,3991,2654,1337,930,158,26,2877
6/1/2022,VA,Virginia,Wise,51195,10572,4072,6500,7640,28,7612,2932,31,2901,10033,3533,6500,8410,2724,5686,2396,470,116,5428
6/1/2022,VA,Virginia,Wythe,51197,8054,4546,3508,6484,39,6445,1570,12,1558,7619,4111,3508,6500,3236,3264,1622,307,70,4501
6/1/2022,VA,Virginia,York,51199,13321,10269,3052,12388,45,12343,933,41,892,12162,9110,3052,6947,4249,2698,766,173,34,5974
3/1/2022,VA,Virginia,Accomack,51001,9575,6710,2865,8465,59,8406,1110,41,1069,8866,6003,2863,6862,4363,2499,1569,379,71,4843
3/1/2022,VA,Virginia,Albemarle,51003,23648,19104,4544,22175,60,22115,1473,46,1427,21417,16875,4542,17200,13188,4012,1707,311,73,15109
3/1/2022,VA,Virginia,Alexandria City,51510,18984,14247,4737,17774,85,17689,1210,71,1139,15412,10677,4735,10241,5896,4345,2189,335,56,7661
3/1/2022,VA,Virginia,Alleghany,51005,4632,3196,1436,3854,20,3834,778,*,*,4379,2943,1436,3694,2428,1266,822,118,36,2718
3/1/2022,VA,Virginia,Amelia,51007,3301,2041,1260,2890,11,2879,411,13,398,3038,1778,1260,2520,1334,1186,465,92,24,1939
3/1/2022,VA,Virginia,Amherst,51009,8160,5267,2893,7003,55,6948,1157,29,1128,7612,4719,2893,6419,3746,2673,1264,241,63,4851
3/1/2022,VA,Virginia,Appomattox,51011,4249,2818,1431,3550,23,3527,699,26,673,3975,2545,1430,3347,2021,1326,790,110,44,2403
3/1/2022,VA,Virginia,Arlington,51013,25883,19804,6079,24442,114,24328,1441,70,1371,20444,14366,6078,13550,7905,5645,3090,418,114,9928
3/1/2022,VA,Virginia,Augusta,51015,19439,14377,5062,17258,77,17181,2181,45,2136,18290,13228,5062,15006,10358,4648,1998,440,128,12440
3/1/2022,VA,Virginia,Bath,51017,1312,1043,269,1177,*,*,135,*,*,1245,976,269,1021,772,249,162,31,13,815
3/1/2022,VA,Virginia,Bedford,51019,21267,14736,6531,18788,75,18713,2479,49,2430,19801,13271,6530,16324,10685,5639,2080,524,151,13569
3/1/2022,VA,Virginia,Bland,51021,1840,1154,686,1515,*,*,325,*,*,1733,1047,686,1414,842,572,224,57,15,1118
3/1/2022,VA,Virginia,Botetourt,51023,9148,6085,3063,8188,49,8139,960,18,942,8525,5462,3063,7000,4320,2680,742,176,38,6044
3/1/2022,VA,Virginia,Bristol City,51520,4503,1936,2567,3640,*,*,863,16,847,4232,1665,2567,3721,1257,2464,1070,167,39,2445
3/1/2022,VA,Virginia,Brunswick,51025,4152,2531,1621,3551,28,3523,601,16,585,3896,2275,1621,3237,1739,1498,1037,136,31,2033
3/1/2022,VA,Virginia,Buchanan,51027,6832,2973,3859,4727,20,4707,2105,12,2093,6597,2738,3859,5782,2647,3135,1554,389,88,3751
3/1/2022,VA,Virginia,Buckingham,51029,3829,2477,1352,3229,27,3202,600,17,583,3581,2229,1352,2897,1719,1178,786,139,36,1936
3/1/2022,VA,Virginia,Buena Vista City,51530,1482,975,507,1225,*,*,257,*,*,1383,876,507,1113,659,454,301,49,18,745
3/1/2022,VA,Virginia,Campbell,51031,13527,8735,4792,11594,79,11515,1933,58,1875,12656,7864,4792,10779,6370,4409,2116,401,127,8135
3/1/2022,VA,Virginia,Caroline,51033,6368,4189,2179,5537,28,5509,831,33,798,5736,3557,2179,4203,2225,1978,866,206,46,3085
3/1/2022,VA,Virginia,Carroll,51035,8704,5934,2770,7399,40,7359,1305,18,1287,8311,5541,2770,6802,4294,2508,1550,310,88,4854
3/1/2022,VA,Virginia,Charles City,51036,2014,1250,764,1768,20,1748,246,*,*,1855,1091,764,1503,811,692,266,*,*,1140
3/1/2022,VA,Virginia,Charlotte,51037,3243,2172,1071,2743,24,2719,500,14,486,3043,1972,1071,2527,1548,979,689,131,30,1677
3/1/2022,VA,Virginia,Charlottesville City,51540,6310,4760,1550,5500,32,5468,810,31,779,5657,4109,1548,4767,3305,1462,1109,158,24,3476
3/1/2022,VA,Virginia,Chesapeake City,51550,42171,28552,13619,37408,306,37102,4763,178,4585,38136,24518,13618,24747,12361,12386,4493,1026,190,19038
3/1/2022,VA,Virginia,Chesterfield,51041,67519,44811,22708,60758,285,60473,6761,239,6522,61147,38444,22703,49651,28863,20788,6194,1067,218,42172
3/1/2022,VA,Virginia,Clarke,51043,3724,2892,832,3486,13,3473,238,*,*,3361,2529,832,2480,1781,699,306,75,27,2072
3/1/2022,VA,Virginia,Colonial Heights City,51570,4090,2929,1161,3554,21,3533,536,*,*,3770,2609,1161,2652,1594,1058,522,111,21,1998
3/1/2022,VA,Virginia,Covington City,51580,1552,1054,498,1207,14,1193,345,*,*,1448,950,498,1217,740,477,349,*,*,805
3/1/2022,VA,Virginia,Craig,51045,1382,855,527,1138,*,*,244,*,*,1295,768,527,1085,604,481,202,*,*,821
3/1/2022,VA,Virginia,Culpeper,51047,10321,7578,2743,9198,48,9150,1123,30,1093,9334,6591,2743,6996,4722,2274,1262,244,62,5428
3/1/2022,VA,Virginia,Cumberland,51049,2400,1499,901,2042,13,2029,358,*,*,2219,1318,901,1855,1034,821,451,98,20,1286
3/1/2022,VA,Virginia,Danville City,51590,11036,5896,5140,8967,91,8876,2069,111,1958,10363,5223,5140,9120,4892,4228,3209,441,110,5360
3/1/2022,VA,Virginia,Dickenson,51051,4826,1849,2977,3374,13,3361,1452,*,*,4644,1667,2977,4044,1389,2655,1093,225,44,2682
3/1/2022,VA,Virginia,Dinwiddie,51053,6274,3951,2323,5289,36,5253,985,29,956,5802,3479,2323,4600,2431,2169,940,225,45,3390
3/1/2022,VA,Virginia,Emporia City,51595,1313,704,609,1073,17,1056,240,*,*,1224,615,609,1065,505,560,456,63,11,535
3/1/2022,VA,Virginia,Essex,51057,3073,2044,1029,2688,16,2672,385,15,370,2861,1832,1029,2272,1380,892,476,85,28,1683
3/1/2022,VA,Virginia,Fairfax,51059,164004,120309,43695,156512,666,155846,7492,394,7098,132935,89259,43676,86614,48474,38140,15301,2759,514,68040
3/1/2022,VA,Virginia,Fairfax City,51600,4183,3052,1131,3943,15,3928,240,*,*,3489,2359,1130,2387,1443,944,402,72,13,1900
3/1/2022,VA,Virginia,Falls Church City,51610,2232,1702,530,2157,*,*,75,*,*,1793,1263,530,1198,729,469,132,*,*,1049
3/1/2022,VA,Virginia,Fauquier,51061,13738,10663,3075,12788,77,12711,950,35,915,12164,9090,3074,8566,6093,2473,996,194,48,7328
3/1/2022,VA,Virginia,Floyd,51063,4404,2942,1462,3890,14,3876,514,*,*,4118,2657,1461,3414,2044,1370,625,116,27,2646
3/1/2022,VA,Virginia,Fluvanna,51065,6833,5162,1671,6229,30,6199,604,17,587,6234,4563,1671,4831,3379,1452,638,114,27,4052
3/1/2022,VA,Virginia,Franklin,51067,15801,9753,6048,13710,62,13648,2091,37,2054,14856,8808,6048,12560,7050,5510,2069,500,117,9874
3/1/2022,VA,Virginia,Franklin City,51620,2213,1432,781,1849,19,1830,364,16,348,2087,1306,781,1765,1024,741,549,*,*,1134
3/1/2022,VA,Virginia,Frederick,51069,18439,13736,4703,16760,79,16681,1679,43,1636,16718,12017,4701,12368,8371,3997,1517,403,111,10337
3/1/2022,VA,Virginia,Fredericksburg City,51630,4341,3059,1282,3732,23,3709,609,24,585,3855,2574,1281,2818,1630,1188,809,92,29,1888
3/1/2022,VA,Virginia,Galax City,51640,1696,1193,503,1399,*,*,297,*,*,1616,1113,503,1371,900,471,534,55,19,763
3/1/2022,VA,Virginia,Giles,51071,4548,2882,1666,3752,15,3737,796,16,780,4314,2648,1666,3705,2269,1436,755,116,28,2806
3/1/2022,VA,Virginia,Gloucester,51073,9608,6835,2773,8565,45,8520,1043,24,1019,8897,6124,2773,6123,3629,2494,1056,198,48,4821
3/1/2022,VA,Virginia,Goochland,51075,6851,4984,1867,6412,37,6375,439,11,428,6276,4409,1867,5383,3746,1637,439,107,18,4819
3/1/2022,VA,Virginia,Grayson,51077,4710,3108,1602,3992,16,3976,718,*,*,4512,2910,1602,3677,2177,1500,915,182,70,2510
3/1/2022,VA,Virginia,Greene,51079,4311,3237,1074,3846,16,3830,465,*,*,3914,2840,1074,3028,2044,984,477,100,17,2434
3/1/2022,VA,Virginia,Greensville,51081,2204,1221,983,1822,30,1792,382,12,370,2042,1059,983,1735,847,888,462,113,18,1142
3/1/2022,VA,Virginia,Halifax,51083,10036,6752,3284,8499,63,8436,1537,56,1481,9430,6146,3284,7914,4876,3038,2089,408,123,5294
3/1/2022,VA,Virginia,Hampton City,51650,26721,15989,10732,22698,248,22450,4023,197,3826,24365,13634,10731,16395,6411,9984,4240,843,154,11158
3/1/2022,VA,Virginia,Hanover,51085,23796,16070,7726,22051,111,21940,1745,58,1687,21832,14109,7723,18388,11639,6749,1578,345,68,16397
3/1/2022,VA,Virginia,Harrisonburg City,51660,5658,4206,1452,4895,26,4869,763,21,742,5142,3690,1452,4316,2978,1338,979,161,38,3138
3/1/2022,VA,Virginia,Henrico,51087,61287,38629,22658,54813,421,54392,6474,296,6178,55642,32986,22656,47517,26855,20662,7202,1453,292,38570
3/1/2022,VA,Virginia,Henry,51089,14851,8139,6712,12186,102,12084,2665,63,2602,14122,7411,6711,12470,6143,6327,2995,746,183,8546
3/1/2022,VA,Virginia,Highland,51091,879,694,185,804,*,*,75,0,75,835,650,185,668,501,167,74,*,*,567
3/1/2022,VA,Virginia,Hopewell City,51670,4584,2784,1800,3683,35,3648,901,28,873,4239,2439,1800,3199,1480,1719,1051,172,29,1947
3/1/2022,VA,Virginia,Isle of Wight,51093,9187,6292,2895,8248,58,8190,939,36,903,8470,5576,2894,6222,3540,2682,1003,204,66,4949
3/1/2022,VA,Virginia,James City,51095,22686,17560,5126,21481,69,21412,1205,36,1169,21039,15917,5122,14434,10214,4220,1038,231,50,13115
3/1/2022,VA,Virginia,King and Queen,51097,1844,1243,601,1617,11,1606,227,*,*,1738,1137,601,1394,851,543,279,*,*,1038
3/1/2022,VA,Virginia,King George,51099,4418,3391,1027,3937,23,3914,481,17,464,3826,2799,1027,2172,1241,931,488,86,24,1574
3/1/2022,VA,Virginia,King William,51101,3804,2591,1213,3336,35,3301,468,25,443,3509,2296,1213,2964,1844,1120,436,103,19,2406
3/1/2022,VA,Virginia,Lancaster,51103,4464,3348,1116,4163,20,4143,301,14,287,4177,3062,1115,3234,2306,928,485,99,12,2638
3/1/2022,VA,Virginia,Lee,51105,6461,2401,4060,4765,22,4743,1696,17,1679,6154,2097,4057,5247,1591,3656,1935,243,60,3009
3/1/2022,VA,Virginia,Lexington City,51678,1316,995,321,1218,*,*,98,*,*,1218,898,320,983,690,293,168,*,*,777
3/1/2022,VA,Virginia,Loudoun,51107,44835,32761,12074,42520,179,42341,2315,122,2193,37331,25266,12065,26667,16141,10526,3885,724,151,21907
3/1/2022,VA,Virginia,Louisa,51109,9447,6437,3010,8254,51,8203,1193,31,1162,8626,5616,3010,6752,4059,2693,1166,259,55,5272
3/1/2022,VA,Virginia,Lunenburg,51111,3246,2096,1150,2769,19,2750,477,*,*,3042,1892,1150,2461,1393,1068,762,125,30,1544
3/1/2022,VA,Virginia,Lynchburg City,51680,14799,9402,5397,12482,97,12385,2317,82,2235,13799,8402,5397,11797,6769,5028,2937,468,114,8278
3/1/2022,VA,Virginia,Madison,51113,3497,2592,905,3165,*,*,332,*,*,3243,2339,904,2533,1757,776,414,88,18,2013
3/1/2022,VA,Virginia,Manassas City,51683,5013,3418,1595,4560,23,4537,453,32,421,4218,2623,1595,3136,1710,1426,555,114,20,2447
3/1/2022,VA,Virginia,Manassas Park City,51685,1419,817,602,1248,16,1232,171,13,158,1193,591,602,934,377,557,232,*,*,641
3/1/2022,VA,Virginia,Martinsville City,51690,3811,2047,1764,2972,40,2932,839,29,810,3603,1839,1764,3181,1489,1692,1242,168,46,1725
3/1/2022,VA,Virginia,Mathews,51115,3011,2229,782,2786,22,2764,225,*,*,2832,2050,782,2159,1483,676,289,40,13,1817
3/1/2022,VA,Virginia,Mecklenburg,51117,9572,6265,3307,8208,66,8142,1364,48,1316,8974,5667,3307,7368,4353,3015,1762,419,78,5109
3/1/2022,VA,Virginia,Middlesex,51119,3765,2748,1017,3459,18,3441,306,*,*,3539,2522,1017,2789,1910,879,441,83,14,2251
3/1/2022,VA,Virginia,Montgomery,51121,14764,10389,4375,12723,70,12653,2041,31,2010,13301,8926,4375,11395,7342,4053,1963,335,86,9011
3/1/2022,VA,Virginia,Nelson,51125,4931,3607,1324,4498,15,4483,433,*,*,4587,3263,1324,3526,2364,1162,546,117,22,2841
3/1/2022,VA,Virginia,New Kent,51127,5425,3866,1559,4945,26,4919,480,18,462,4972,3413,1559,3719,2415,1304,342,96,17,3264
3/1/2022,VA,Virginia,Newport News City,51700,30092,17880,12212,25494,241,25253,4598,228,4370,27484,15274,12210,19465,7974,11491,5351,951,174,12989
3/1/2022,VA,Virginia,Norfolk City,51710,34835,20390,14445,29157,313,28844,5678,313,5365,31317,16874,14443,22886,9176,13710,7720,1410,239,13517
3/1/2022,VA,Virginia,Northampton,51131,3928,2568,1360,3518,21,3497,410,23,387,3676,2316,1360,3064,1831,1233,879,90,23,2072
3/1/2022,VA,Virginia,Northumberland,51133,4860,3592,1268,4539,17,4522,321,12,309,4536,3268,1268,3323,2294,1029,452,85,25,2761
3/1/2022,VA,Virginia,Norton City,51720,1091,469,622,793,*,*,298,*,*,1030,408,622,901,340,561,339,*,*,503
3/1/2022,VA,Virginia,Nottoway,51135,3637,2389,1248,3066,24,3042,571,14,557,3381,2133,1248,2746,1611,1135,804,142,35,1765
3/1/2022,VA,Virginia,Orange,51137,9296,6758,2538,8368,53,8315,928,26,902,8479,5941,2538,6155,3977,2178,984,217,49,4905
3/1/2022,VA,Virginia,Page,51139,6409,4672,1737,5436,23,5413,973,23,950,5995,4258,1737,4689,3124,1565,1076,255,55,3303
3/1/2022,VA,Virginia,Patrick,51141,5550,3418,2132,4732,16,4716,818,12,806,5276,3146,2130,4442,2474,1968,1018,195,58,3171
3/1/2022,VA,Virginia,Petersburg City,51730,7146,3730,3416,5528,90,5438,1618,77,1541,6528,3112,3416,5234,1982,3252,2184,339,58,2653
3/1/2022,VA,Virginia,Pittsylvania,51143,16918,9930,6988,14363,124,14239,2555,71,2484,15948,8960,6988,13793,8127,5666,3040,576,142,10035
3/1/2022,VA,Virginia,Poquoson City,51735,2688,2143,545,2525,*,*,163,*,*,2469,1924,545,1414,917,497,126,*,*,1251
3/1/2022,VA,Virginia,Portsmouth City,51740,18763,10862,7901,15184,203,14981,3579,190,3389,16883,8982,7901,12141,4641,7500,4193,753,115,7080
3/1/2022,VA,Virginia,Powhatan,51145,6784,4836,1948,6234,17,6217,550,15,535,6254,4306,1948,5206,3469,1737,423,118,28,4637
3/1/2022,VA,Virginia,Prince Edward,51147,4886,3165,1721,4082,38,4044,804,25,779,4525,2805,1720,3740,2146,1594,1085,169,40,2446
3/1/2022,VA,Virginia,Prince George,51149,6710,4968,1742,5780,34,5746,930,36,894,6194,4452,1742,4096,2522,1574,662,147,33,3254
3/1/2022,VA,Virginia,Prince William,51153,55263,38883,16380,50527,331,50196,4736,273,4463,47064,30687,16377,29799,15008,14791,5859,1266,227,22447
3/1/2022,VA,Virginia,Pulaski,51155,9264,5717,3547,7637,36,7601,1627,30,1597,8644,5097,3547,7331,4070,3261,1574,279,78,5400
3/1/2022,VA,Virginia,Radford City,51750,2132,1410,722,1777,*,*,355,*,*,1931,1209,722,1686,1008,678,335,45,19,1287
3/1/2022,VA,Virginia,Rappahannock,51157,2109,1674,435,1987,*,*,122,*,*,1902,1468,434,1402,1051,351,160,38,11,1193
3/1/2022,VA,Virginia,Richmond,51159,2025,1386,639,1801,*,*,224,*,*,1894,1255,639,1485,949,536,334,*,*,1070
3/1/2022,VA,Virginia,Richmond City,51760,34797,18591,16206,28946,306,28640,5851,255,5596,31452,15248,16204,27671,12232,15439,8842,1360,243,17226
3/1/2022,VA,Virginia,Roanoke,51161,24732,16596,8136,22338,118,22220,2394,50,2344,22873,14742,8131,19181,11956,7225,2162,484,124,16411
3/1/2022,VA,Virginia,Roanoke City,51770,21364,11813,9551,17088,169,16919,4276,128,4148,19572,10021,9551,16722,7802,8920,4810,928,179,10805
3/1/2022,VA,Virginia,Rockbridge,51163,6687,4807,1880,5861,17,5844,826,*,*,6225,4345,1880,4927,3230,1697,862,184,53,3828
3/1/2022,VA,Virginia,Rockingham,51165,19028,14477,4551,17122,65,17057,1906,40,1866,17676,13125,4551,14641,10541,4100,1810,502,133,12196
3/1/2022,VA,Virginia,Russell,51167,7980,3768,4212,5973,21,5952,2007,20,1987,7664,3453,4211,6780,3172,3608,1672,328,103,4677
3/1/2022,VA,Virginia,Salem City,51775,6160,4191,1969,5384,32,5352,776,14,762,5652,3683,1969,4708,2895,1813,762,122,39,3785
3/1/2022,VA,Virginia,Scott,51169,6792,2412,4380,5340,15,5325,1452,*,*,6506,2126,4380,5813,1656,4157,1518,273,86,3936
3/1/2022,VA,Virginia,Shenandoah,51171,11157,8108,3049,10090,33,10057,1067,18,1049,10444,7396,3048,7956,5291,2665,1237,284,72,6363
3/1/2022,VA,Virginia,Smyth,51173,8632,4905,3727,6718,20,6698,1914,24,1890,8191,4464,3727,6996,3457,3539,2011,387,114,4484
3/1/2022,VA,Virginia,Southampton,51175,4177,2849,1328,3613,34,3579,564,22,542,3873,2545,1328,3169,1954,1215,670,145,30,2324
3/1/2022,VA,Virginia,Spotsylvania,51177,24093,16955,7138,21508,142,21366,2585,99,2486,21364,14228,7136,14066,7711,6355,2292,549,116,11109
3/1/2022,VA,Virginia,Stafford,51179,20054,15152,4902,18148,137,18011,1906,85,1821,17604,12705,4899,9997,5667,4330,1668,412,69,7848
3/1/2022,VA,Virginia,Staunton City,51790,6416,4637,1779,5524,28,5496,892,15,877,6043,4264,1779,4944,3306,1638,1078,147,50,3669
3/1/2022,VA,Virginia,Suffolk City,51800,18204,11919,6285,15508,157,15351,2696,109,2587,16662,10377,6285,11789,5960,5829,2846,528,89,8326
3/1/2022,VA,Virginia,Surry,51181,1811,1151,660,1594,15,1579,217,*,*,1675,1015,660,1301,675,626,231,51,13,1006
3/1/2022,VA,Virginia,Sussex,51183,2543,1512,1031,2143,22,2121,400,14,386,2372,1341,1031,1924,953,971,504,141,22,1257
3/1/2022,VA,Virginia,Tazewell,51185,11929,6344,5585,9315,42,9273,2614,36,2578,11392,5808,5584,9475,4981,4494,2297,504,123,6551
3/1/2022,VA,Virginia,Unknown,51999,*,*,*,*,*,*,*,*,*,*,*,*,*,*,*,*,*,*,*
3/1/2022,VA,Virginia,Virginia Beach City,51810,78662,56213,22449,70941,437,70504,7721,307,7414,72028,49586,22442,44785,24330,20455,7358,1656,336,35435
3/1/2022,VA,Virginia,Warren,51187,8574,6252,2322,7632,26,7606,942,28,914,7778,5456,2322,5721,3750,1971,960,238,64,4459
3/1/2022,VA,Virginia,Washington,51191,15702,8210,7492,13160,43,13117,2542,27,2515,14860,7369,7491,12722,5791,6931,2385,629,156,9552
3/1/2022,VA,Virginia,Waynesboro City,51820,5140,3656,1484,4392,25,4367,748,20,728,4817,3333,1484,4000,2593,1407,876,136,43,2945
3/1/2022,VA,Virginia,Westmoreland,51193,5472,3981,1491,4936,32,4904,536,18,518,4950,3459,1491,3470,2131,1339,828,139,40,2463
3/1/2022,VA,Virginia,Williamsburg City,51830,3036,2205,831,2793,11,2782,243,*,*,2796,1965,831,2093,1363,730,296,*,*,1749
3/1/2022,VA,Virginia,Winchester City,51840,5652,4170,1482,4934,28,4906,718,18,700,5159,3677,1482,3976,2676,1300,916,155,28,2877
3/1/2022,VA,Virginia,Wise,51195,10594,4121,6473,7672,31,7641,2922,31,2891,10062,3589,6473,8445,2788,5657,2395,483,129,5438
3/1/2022,VA,Virginia,Wythe,51197,8037,4581,3456,6476,42,6434,1561,13,1548,7614,4158,3456,6492,3277,3215,1626,313,75,4478
3/1/2022,VA,Virginia,York,51199,13233,10234,2999,12316,46,12270,917,41,876,12109,9110,2999,6920,4270,2650,754,177,38,5951
5/1/2022,VA,Virginia,Accomack,51001,9612,6715,2897,8496,55,8441,1116,41,1075,8891,5995,2896,6851,4315,2536,1583,367,65,4836
5/1/2022,VA,Virginia,Albemarle,51003,23754,19169,4585,22269,58,22211,1485,49,1436,21501,16918,4583,17222,13164,4058,1720,297,61,15144
5/1/2022,VA,Virginia,Alexandria City,51510,19094,14277,4817,17875,82,17793,1219,72,1147,15458,10643,4815,10280,5858,4422,2233,320,52,7675
5/1/2022,VA,Virginia,Alleghany,51005,4652,3208,1444,3868,19,3849,784,*,*,4397,2953,1444,3704,2432,1272,827,115,30,2732
5/1/2022,VA,Virginia,Amelia,51007,3316,2052,1264,2900,11,2889,416,12,404,3055,1791,1264,2530,1338,1192,470,89,19,1952
5/1/2022,VA,Virginia,Amherst,51009,8164,5244,2920,7011,53,6958,1153,29,1124,7614,4694,2920,6419,3717,2702,1274,237,60,4848
5/1/2022,VA,Virginia,Appomattox,51011,4272,2815,1457,3567,21,3546,705,26,679,3994,2538,1456,3360,2010,1350,798,105,38,2419
5/1/2022,VA,Virginia,Arlington,51013,26024,19855,6169,24576,111,24465,1448,72,1376,20539,14371,6168,13615,7887,5728,3115,408,101,9991
5/1/2022,VA,Virginia,Augusta,51015,19532,14398,5134,17339,74,17265,2193,44,2149,18356,13222,5134,15041,10329,4712,2026,428,125,12462
5/1/2022,VA,Virginia,Bath,51017,1316,1040,276,1180,*,*,136,*,*,1245,969,276,1020,765,255,160,31,13,816
5/1/2022,VA,Virginia,Bedford,51019,21339,14718,6621,18853,73,18780,2486,50,2436,19874,13253,6621,16386,10653,5733,2100,521,139,13626
5/1/2022,VA,Virginia,Bland,51021,1838,1151,687,1513,*,*,325,*,*,1729,1042,687,1409,837,572,222,57,13,1117
5/1/2022,VA,Virginia,Botetourt,51023,9175,6096,3079,8210,48,8162,965,19,946,8556,5477,3079,7026,4330,2696,753,175,34,6064
5/1/2022,VA,Virginia,Bristol City,51520,4493,1914,2579,3624,*,*,869,16,853,4219,1640,2579,3708,1232,2476,1077,157,30,2444
5/1/2022,VA,Virginia,Brunswick,51025,4163,2513,1650,3556,27,3529,607,16,591,3903,2253,1650,3243,1718,1525,1034,135,23,2051
5/1/2022,VA,Virginia,Buchanan,51027,6831,2954,3877,4720,20,4700,2111,12,2099,6586,2709,3877,5769,2615,3154,1559,390,76,3744
5/1/2022,VA,Virginia,Buckingham,51029,3847,2474,1373,3240,26,3214,607,17,590,3594,2222,1372,2901,1700,1201,798,137,32,1934
5/1/2022,VA,Virginia,Buena Vista City,51530,1484,968,516,1223,*,*,261,*,*,1384,868,516,1112,650,462,303,47,17,745
5/1/2022,VA,Virginia,Campbell,51031,13559,8709,4850,11615,76,11539,1944,58,1886,12692,7842,4850,10789,6323,4466,2137,388,116,8148
5/1/2022,VA,Virginia,Caroline,51033,6410,4194,2216,5576,27,5549,834,33,801,5770,3554,2216,4245,2235,2010,882,200,41,3122
5/1/2022,VA,Virginia,Carroll,51035,8721,5922,2799,7408,37,7371,1313,18,1295,8325,5526,2799,6808,4270,2538,1557,297,80,4874
5/1/2022,VA,Virginia,Charles City,51036,2019,1250,769,1775,20,1755,244,*,*,1858,1089,769,1507,811,696,265,*,*,1145
5/1/2022,VA,Virginia,Charlotte,51037,3249,2167,1082,2743,22,2721,506,13,493,3047,1965,1082,2527,1534,993,687,128,24,1688
5/1/2022,VA,Virginia,Charlottesville City,51540,6323,4755,1568,5509,31,5478,814,29,785,5671,4105,1566,4776,3293,1483,1114,158,17,3487
5/1/2022,VA,Virginia,Chesapeake City,51550,42370,28636,13734,37573,296,37277,4797,179,4618,38286,24553,13733,24834,12338,12496,4563,1009,170,19092
5/1/2022,VA,Virginia,Chesterfield,51041,67825,44876,22949,61039,272,60767,6786,235,6551,61387,38443,22944,49852,28821,21031,6248,1052,195,42357
5/1/2022,VA,Virginia,Clarke,51043,3743,2898,845,3507,12,3495,236,*,*,3373,2528,845,2489,1780,709,306,74,25,2084
5/1/2022,VA,Virginia,Colonial Heights City,51570,4097,2915,1182,3557,20,3537,540,*,*,3772,2590,1182,2661,1578,1083,523,113,18,2007
5/1/2022,VA,Virginia,Covington City,51580,1554,1042,512,1206,13,1193,348,*,*,1454,942,512,1223,736,487,350,*,*,808
5/1/2022,VA,Virginia,Craig,51045,1388,849,539,1144,*,*,244,*,*,1303,764,539,1090,602,488,196,*,*,833
5/1/2022,VA,Virginia,Culpeper,51047,10363,7585,2778,9236,48,9188,1127,29,1098,9367,6589,2778,7029,4721,2308,1274,238,60,5457
5/1/2022,VA,Virginia,Cumberland,51049,2407,1495,912,2048,13,2035,359,*,*,2231,1319,912,1861,1028,833,455,98,18,1290
5/1/2022,VA,Virginia,Danville City,51590,11030,5830,5200,8966,87,8879,2064,107,1957,10366,5166,5200,9120,4842,4278,3215,428,95,5382
5/1/2022,VA,Virginia,Dickenson,51051,4826,1837,2989,3368,12,3356,1458,*,*,4645,1656,2989,4036,1371,2665,1103,215,37,2681
5/1/2022,VA,Virginia,Dinwiddie,51053,6297,3945,2352,5301,35,5266,996,29,967,5822,3470,2352,4603,2411,2192,953,219,38,3393
5/1/2022,VA,Virginia,Emporia City,51595,1318,688,630,1075,17,1058,243,*,*,1230,600,630,1069,489,580,460,*,*,539
5/1/2022,VA,Virginia,Essex,51057,3088,2019,1069,2701,15,2686,387,14,373,2872,1803,1069,2295,1365,930,488,83,28,1696
5/1/2022,VA,Virginia,Fairfax,51059,165104,120866,44238,157569,650,156919,7535,398,7137,133599,89379,44220,87083,48401,38682,15442,2700,478,68463
5/1/2022,VA,Virginia,Fairfax City,51600,4200,3060,1140,3961,15,3946,239,*,*,3482,2343,1139,2393,1438,955,405,*,*,1906
5/1/2022,VA,Virginia,Falls Church City,51610,2235,1702,533,2159,*,*,76,*,*,1786,1253,533,1196,725,471,129,*,*,1051
5/1/2022,VA,Virginia,Fauquier,51061,13809,10689,3120,12850,73,12777,959,35,924,12198,9079,3119,8606,6082,2524,1011,191,46,7358
5/1/2022,VA,Virginia,Floyd,51063,4413,2949,1464,3898,14,3884,515,*,*,4122,2659,1463,3406,2033,1373,627,116,26,2637
5/1/2022,VA,Virginia,Fluvanna,51065,6868,5187,1681,6259,28,6231,609,17,592,6262,4581,1681,4851,3389,1462,649,113,23,4066
5/1/2022,VA,Virginia,Franklin,51067,15826,9747,6079,13734,58,13676,2092,36,2056,14890,8811,6079,12585,7043,5542,2075,493,111,9906
5/1/2022,VA,Virginia,Franklin City,51620,2208,1416,792,1840,16,1824,368,16,352,2081,1289,792,1752,1000,752,550,*,*,1125
5/1/2022,VA,Virginia,Frederick,51069,18494,13759,4735,16797,74,16723,1697,44,1653,16783,12050,4733,12372,8344,4028,1523,397,97,10355
5/1/2022,VA,Virginia,Fredericksburg City,51630,4344,3039,1305,3733,23,3710,611,24,587,3862,2558,1304,2811,1601,1210,809,92,28,1882
5/1/2022,VA,Virginia,Galax City,51640,1690,1188,502,1395,*,*,295,*,*,1609,1107,502,1364,895,469,528,54,18,764
5/1/2022,VA,Virginia,Giles,51071,4535,2858,1677,3733,12,3721,802,16,786,4303,2626,1677,3691,2241,1450,748,114,26,2803
5/1/2022,VA,Virginia,Gloucester,51073,9649,6852,2797,8597,45,8552,1052,24,1028,8928,6131,2797,6132,3614,2518,1051,194,45,4842
5/1/2022,VA,Virginia,Goochland,51075,6891,5015,1876,6448,37,6411,443,11,432,6299,4423,1876,5399,3750,1649,448,104,16,4831
5/1/2022,VA,Virginia,Grayson,51077,4712,3096,1616,3991,15,3976,721,11,710,4503,2887,1616,3672,2158,1514,921,174,63,2514
5/1/2022,VA,Virginia,Greene,51079,4329,3252,1077,3857,15,3842,472,*,*,3927,2850,1077,3031,2046,985,480,102,15,2434
5/1/2022,VA,Virginia,Greensville,51081,2211,1222,989,1828,26,1802,383,12,371,2038,1049,989,1730,835,895,465,113,21,1131
5/1/2022,VA,Virginia,Halifax,51083,10056,6727,3329,8511,62,8449,1545,57,1488,9447,6118,3329,7920,4839,3081,2085,391,112,5332
5/1/2022,VA,Virginia,Hampton City,51650,26810,15975,10835,22759,239,22520,4051,196,3855,24427,13594,10833,16400,6327,10073,4287,835,139,11139
5/1/2022,VA,Virginia,Hanover,51085,23864,16088,7776,22107,105,22002,1757,56,1701,21885,14112,7773,18415,11617,6798,1603,323,61,16428
5/1/2022,VA,Virginia,Harrisonburg City,51660,5688,4206,1482,4923,23,4900,765,22,743,5164,3682,1482,4334,2967,1367,994,158,33,3149
5/1/2022,VA,Virginia,Henrico,51087,61514,38687,22827,55007,413,54594,6507,292,6215,55772,32947,22825,47595,26760,20835,7246,1428,267,38654
5/1/2022,VA,Virginia,Henry,51089,14831,8077,6754,12158,97,12061,2673,62,2611,14090,7337,6753,12456,6089,6367,3013,732,158,8553
5/1/2022,VA,Virginia,Highland,51091,883,696,187,807,*,*,76,0,76,839,652,187,668,501,167,77,*,*,565
5/1/2022,VA,Virginia,Hopewell City,51670,4584,2757,1827,3680,35,3645,904,29,875,4240,2413,1827,3195,1449,1746,1064,166,22,1943
5/1/2022,VA,Virginia,Isle of Wight,51093,9225,6295,2930,8274,58,8216,951,36,915,8497,5568,2929,6243,3525,2718,1012,196,59,4976
5/1/2022,VA,Virginia,James City,51095,22754,17574,5180,21542,65,21477,1212,36,1176,21098,15922,5176,14494,10227,4267,1040,225,46,13183
5/1/2022,VA,Virginia,King and Queen,51097,1845,1236,609,1615,11,1604,230,*,*,1739,1130,609,1392,843,549,283,*,*,1033
5/1/2022,VA,Virginia,King George,51099,4439,3395,1044,3956,22,3934,483,18,465,3823,2779,1044,2166,1217,949,488,84,22,1572
5/1/2022,VA,Virginia,King William,51101,3822,2596,1226,3350,34,3316,472,25,447,3533,2307,1226,2974,1842,1132,441,100,15,2418
5/1/2022,VA,Virginia,Lancaster,51103,4476,3345,1131,4173,19,4154,303,13,290,4186,3056,1130,3243,2297,946,489,*,*,2648
5/1/2022,VA,Virginia,Lee,51105,6444,2366,4078,4746,20,4726,1698,17,1681,6136,2061,4075,5222,1550,3672,1925,232,53,3012
5/1/2022,VA,Virginia,Lexington City,51678,1320,998,322,1221,*,*,99,*,*,1221,900,321,983,689,294,168,*,*,779
5/1/2022,VA,Virginia,Loudoun,51107,45159,32980,12179,42828,172,42656,2331,123,2208,37465,25294,12171,26809,16175,10634,3932,705,144,22028
5/1/2022,VA,Virginia,Louisa,51109,9491,6457,3034,8294,47,8247,1197,30,1167,8664,5631,3033,6768,4049,2719,1180,254,52,5282
5/1/2022,VA,Virginia,Lunenburg,51111,3246,2085,1161,2769,18,2751,477,*,*,3044,1883,1161,2453,1377,1076,763,122,25,1543
5/1/2022,VA,Virginia,Lynchburg City,51680,14828,9356,5472,12496,96,12400,2332,79,2253,13821,8349,5472,11809,6711,5098,2974,457,104,8274
5/1/2022,VA,Virginia,Madison,51113,3498,2576,922,3166,*,*,332,*,*,3246,2325,921,2533,1740,793,419,85,18,2011
5/1/2022,VA,Virginia,Manassas City,51683,5067,3441,1626,4606,23,4583,461,32,429,4261,2635,1626,3166,1708,1458,572,113,19,2462
5/1/2022,VA,Virginia,Manassas Park City,51685,1433,828,605,1262,16,1246,171,13,158,1199,594,605,935,376,559,233,*,*,644
5/1/2022,VA,Virginia,Martinsville City,51690,3799,2016,1783,2957,37,2920,842,29,813,3585,1802,1783,3167,1458,1709,1242,165,36,1724
5/1/2022,VA,Virginia,Mathews,51115,3015,2224,791,2788,20,2768,227,*,*,2842,2051,791,2165,1483,682,290,42,12,1821
5/1/2022,VA,Virginia,Mecklenburg,51117,9571,6220,3351,8202,62,8140,1369,48,1321,8973,5622,3351,7363,4305,3058,1761,412,74,5116
5/1/2022,VA,Virginia,Middlesex,51119,3773,2753,1020,3466,18,3448,307,*,*,3543,2523,1020,2800,1919,881,447,81,12,2260
5/1/2022,VA,Virginia,Montgomery,51121,14780,10348,4432,12726,68,12658,2054,30,2024,13297,8865,4432,11391,7282,4109,1977,329,78,9007
5/1/2022,VA,Virginia,Nelson,51125,4947,3610,1337,4516,16,4500,431,*,*,4598,3261,1337,3532,2355,1177,555,112,19,2846
5/1/2022,VA,Virginia,New Kent,51127,5466,3875,1591,4983,24,4959,483,18,465,5011,3420,1591,3755,2427,1328,347,94,18,3296
5/1/2022,VA,Virginia,Newport News City,51700,30245,17873,12372,25610,239,25371,4635,228,4407,27587,15217,12370,19547,7905,11642,5410,932,155,13050
5/1/2022,VA,Virginia,Norfolk City,51710,34941,20309,14632,29224,301,28923,5717,316,5401,31374,16744,14630,22953,9063,13890,7792,1382,212,13567
5/1/2022,VA,Virginia,Northampton,51131,3937,2561,1376,3522,21,3501,415,23,392,3682,2306,1376,3066,1816,1250,891,88,19,2068
5/1/2022,VA,Virginia,Northumberland,51133,4871,3593,1278,4543,16,4527,328,11,317,4538,3260,1278,3323,2280,1043,452,87,19,2765
5/1/2022,VA,Virginia,Norton City,51720,1090,470,620,790,*,*,300,*,*,1027,407,620,900,339,561,341,*,*,501
5/1/2022,VA,Virginia,Nottoway,51135,3648,2385,1263,3075,22,3053,573,14,559,3388,2125,1263,2753,1598,1155,811,141,33,1768
5/1/2022,VA,Virginia,Orange,51137,9305,6728,2577,8368,51,8317,937,26,911,8486,5909,2577,6153,3934,2219,988,214,39,4912
5/1/2022,VA,Virginia,Page,51139,6411,4660,1751,5433,21,5412,978,21,957,5997,4246,1751,4690,3109,1581,1076,250,49,3315
5/1/2022,VA,Virginia,Patrick,51141,5538,3379,2159,4722,16,4706,816,*,*,5260,3103,2157,4433,2437,1996,1021,190,49,3173
5/1/2022,VA,Virginia,Petersburg City,51730,7144,3685,3459,5524,90,5434,1620,77,1543,6511,3052,3459,5214,1929,3285,2190,329,54,2641
5/1/2022,VA,Virginia,Pittsylvania,51143,16953,9896,7057,14390,120,14270,2563,73,2490,15970,8913,7057,13803,8071,5732,3074,551,132,10046
5/1/2022,VA,Virginia,Poquoson City,51735,2706,2154,552,2543,*,*,163,*,*,2484,1932,552,1422,918,504,128,*,*,1259
5/1/2022,VA,Virginia,Portsmouth City,51740,18801,10815,7986,15197,196,15001,3604,192,3412,16883,8897,7986,12128,4548,7580,4226,747,105,7050
5/1/2022,VA,Virginia,Powhatan,51145,6805,4855,1950,6255,16,6239,550,15,535,6269,4319,1950,5221,3476,1745,422,116,23,4660
5/1/2022,VA,Virginia,Prince Edward,51147,4875,3140,1735,4069,36,4033,806,25,781,4507,2772,1735,3719,2108,1611,1069,163,38,2449
5/1/2022,VA,Virginia,Prince George,51149,6742,4973,1769,5810,33,5777,932,33,899,6219,4450,1769,4121,2521,1600,666,144,28,3283
5/1/2022,VA,Virginia,Prince William,51153,55634,39088,16546,50879,318,50561,4755,274,4481,47282,30740,16542,29939,14977,14962,5920,1239,201,22579
5/1/2022,VA,Virginia,Pulaski,51155,9265,5703,3562,7638,33,7605,1627,30,1597,8632,5070,3562,7305,4030,3275,1573,276,68,5388
5/1/2022,VA,Virginia,Radford City,51750,2142,1410,732,1784,*,*,358,*,*,1936,1204,732,1694,1006,688,338,47,18,1291
5/1/2022,VA,Virginia,Rappahannock,51157,2109,1671,438,1989,*,*,120,*,*,1901,1464,437,1399,1044,355,157,37,12,1193
5/1/2022,VA,Virginia,Richmond,51159,2026,1384,642,1802,*,*,224,*,*,1892,1250,642,1484,944,540,338,*,*,1072
5/1/2022,VA,Virginia,Richmond City,51760,34896,18530,16366,29021,300,28721,5875,255,5620,31520,15156,16364,27696,12097,15599,8887,1362,209,17238
5/1/2022,VA,Virginia,Roanoke,51161,24793,16626,8167,22382,112,22270,2411,53,2358,22908,14745,8163,19207,11941,7266,2173,475,113,16446
5/1/2022,VA,Virginia,Roanoke City,51770,21376,11805,9571,17082,164,16918,4294,129,4165,19569,9998,9571,16691,7750,8941,4832,906,152,10801
5/1/2022,VA,Virginia,Rockbridge,51163,6709,4806,1903,5881,16,5865,828,*,*,6229,4326,1903,4930,3211,1719,865,181,49,3835
5/1/2022,VA,Virginia,Rockingham,51165,19097,14479,4618,17189,63,17126,1908,39,1869,17706,13088,4618,14662,10493,4169,1822,489,114,12237
5/1/2022,VA,Virginia,Russell,51167,7971,3749,4222,5954,20,5934,2017,21,1996,7652,3431,4221,6763,3147,3616,1676,323,83,4681
5/1/2022,VA,Virginia,Salem City,51775,6170,4189,1981,5384,29,5355,786,15,771,5661,3680,1981,4705,2881,1824,767,119,33,3786
5/1/2022,VA,Virginia,Scott,51169,6791,2406,4385,5339,14,5325,1452,*,*,6500,2115,4385,5806,1647,4159,1522,268,75,3941
5/1/2022,VA,Virginia,Shenandoah,51171,11162,8079,3083,10090,31,10059,1072,17,1055,10449,7367,3082,7967,5273,2694,1243,283,61,6380
5/1/2022,VA,Virginia,Smyth,51173,8620,4858,3762,6704,19,6685,1916,23,1893,8176,4414,3762,6989,3418,3571,2013,380,104,4492
5/1/2022,VA,Virginia,Southampton,51175,4202,2863,1339,3628,32,3596,574,23,551,3892,2553,1339,3174,1949,1225,685,148,28,2313
5/1/2022,VA,Virginia,Spotsylvania,51177,24230,17023,7207,21638,141,21497,2592,98,2494,21454,14249,7205,14114,7687,6427,2323,537,101,11153
5/1/2022,VA,Virginia,Stafford,51179,20161,15203,4958,18250,135,18115,1911,84,1827,17662,12707,4955,10023,5649,4374,1700,407,65,7851
5/1/2022,VA,Virginia,Staunton City,51790,6415,4617,1798,5522,27,5495,893,16,877,6041,4243,1798,4945,3285,1660,1080,144,45,3676
5/1/2022,VA,Virginia,Suffolk City,51800,18275,11913,6362,15560,149,15411,2715,110,2605,16720,10358,6362,11820,5920,5900,2873,530,78,8339
5/1/2022,VA,Virginia,Surry,51181,1822,1161,661,1603,14,1589,219,*,*,1684,1023,661,1307,681,626,232,51,14,1010
5/1/2022,VA,Virginia,Sussex,51183,2542,1495,1047,2141,19,2122,401,14,387,2373,1326,1047,1926,943,983,502,140,20,1264
5/1/2022,VA,Virginia,Tazewell,51185,11936,6315,5621,9314,39,9275,2622,35,2587,11400,5780,5620,9475,4940,4535,2307,494,115,6559
5/1/2022,VA,Virginia,Unknown,51999,*,*,*,*,*,*,*,*,*,*,*,*,*,*,*,*,*,*,*
5/1/2022,VA,Virginia,Virginia Beach City,51810,78943,56264,22679,71195,422,70773,7748,307,7441,72205,49533,22672,44861,24181,20680,7408,1627,297,35529
5/1/2022,VA,Virginia,Warren,51187,8583,6239,2344,7634,24,7610,949,27,922,7777,5433,2344,5727,3733,1994,971,226,60,4470
5/1/2022,VA,Virginia,Washington,51191,15713,8181,7532,13157,42,13115,2556,26,2530,14866,7335,7531,12728,5765,6963,2407,617,131,9573
5/1/2022,VA,Virginia,Waynesboro City,51820,5139,3642,1497,4391,25,4366,748,18,730,4803,3306,1497,3981,2559,1422,876,134,37,2934
5/1/2022,VA,Virginia,Westmoreland,51193,5471,3962,1509,4931,31,4900,540,19,521,4946,3437,1509,3480,2122,1358,829,134,32,2485
5/1/2022,VA,Virginia,Williamsburg City,51830,3063,2225,838,2815,11,2804,248,*,*,2813,1975,838,2107,1367,740,300,*,*,1761
5/1/2022,VA,Virginia,Winchester City,51840,5668,4165,1503,4950,27,4923,718,17,701,5163,3660,1503,3980,2658,1322,927,155,26,2872
5/1/2022,VA,Virginia,Wise,51195,10579,4089,6490,7657,29,7628,2922,30,2892,10035,3545,6490,8414,2737,5677,2393,471,116,5434
5/1/2022,VA,Virginia,Wythe,51197,8045,4550,3495,6480,39,6441,1565,13,1552,7619,4124,3495,6491,3239,3252,1622,308,70,4491
5/1/2022,VA,Virginia,York,51199,13301,10269,3032,12371,45,12326,930,41,889,12151,9119,3032,6942,4259,2683,767,174,34,5967
11/1/2022,VA,Virginia,Accomack,51001,9747,6710,3037,8594,49,8545,1153,39,1114,9005,5970,3035,6968,4297,2671,1660,366,70,4872
11/1/2022,VA,Virginia,Albemarle,51003,24037,19350,4687,22512,51,22461,1525,51,1474,21742,17057,4685,17469,13305,4164,1778,291,65,15335
11/1/2022,VA,Virginia,Alexandria City,51510,19404,14405,4999,18146,78,18068,1258,73,1185,15754,10757,4997,10484,5901,4583,2305,324,54,7801
11/1/2022,VA,Virginia,Alleghany,51005,4663,3184,1479,3869,19,3850,794,*,*,4432,2953,1479,3747,2438,1309,842,114,32,2759
11/1/2022,VA,Virginia,Amelia,51007,3355,2061,1294,2935,*,*,420,11,409,3105,1811,1294,2573,1353,1220,485,88,18,1982
11/1/2022,VA,Virginia,Amherst,51009,8231,5232,2999,7058,47,7011,1173,29,1144,7696,4697,2999,6496,3715,2781,1301,240,58,4897
11/1/2022,VA,Virginia,Appomattox,51011,4301,2788,1513,3583,20,3563,718,25,693,4016,2504,1512,3394,1989,1405,800,105,40,2449
11/1/2022,VA,Virginia,Arlington,51013,26422,20024,6398,24940,101,24839,1482,69,1413,20882,14485,6397,13868,7915,5953,3190,405,101,10172
11/1/2022,VA,Virginia,Augusta,51015,19690,14439,5251,17465,64,17401,2225,40,2185,18525,13274,5251,15218,10379,4839,2092,420,132,12574
11/1/2022,VA,Virginia,Bath,51017,1325,1042,283,1186,*,*,139,*,*,1258,975,283,1035,776,259,169,31,13,822
11/1/2022,VA,Virginia,Bedford,51019,21552,14677,6875,19000,59,18941,2552,48,2504,20116,13241,6875,16615,10639,5976,2189,509,137,13780
11/1/2022,VA,Virginia,Bland,51021,1847,1149,698,1520,*,*,327,*,*,1734,1036,698,1412,831,581,231,57,13,1111
11/1/2022,VA,Virginia,Botetourt,51023,9275,6141,3134,8290,44,8246,985,20,965,8652,5518,3134,7114,4353,2761,778,173,36,6127
11/1/2022,VA,Virginia,Bristol City,51520,4472,1880,2592,3590,*,*,882,14,868,4208,1616,2592,3709,1219,2490,1089,155,28,2437
11/1/2022,VA,Virginia,Brunswick,51025,4214,2479,1735,3595,26,3569,619,16,603,3951,2216,1735,3283,1678,1605,1049,138,25,2071
11/1/2022,VA,Virginia,Buchanan,51027,6823,2911,3912,4672,18,4654,2151,*,*,6571,2659,3912,5766,2564,3202,1593,386,77,3710
11/1/2022,VA,Virginia,Buckingham,51029,3886,2463,1423,3269,23,3246,617,16,601,3628,2206,1422,2944,1684,1260,829,144,32,1939
11/1/2022,VA,Virginia,Buena Vista City,51530,1484,944,540,1219,*,*,265,*,*,1386,846,540,1111,622,489,312,48,18,733
11/1/2022,VA,Virginia,Campbell,51031,13666,8599,5067,11688,72,11616,1978,59,1919,12787,7720,5067,10921,6235,4686,2186,386,121,8228
11/1/2022,VA,Virginia,Caroline,51033,6477,4176,2301,5626,24,5602,851,34,817,5849,3549,2300,4307,2220,2087,916,187,41,3163
11/1/2022,VA,Virginia,Carroll,51035,8753,5834,2919,7412,32,7380,1341,17,1324,8375,5456,2919,6868,4205,2663,1588,304,78,4898
11/1/2022,VA,Virginia,Charles City,51036,2037,1256,781,1789,18,1771,248,*,*,1870,1089,781,1512,804,708,272,84,11,1145
11/1/2022,VA,Virginia,Charlotte,51037,3265,2156,1109,2747,18,2729,518,13,505,3060,1951,1109,2537,1522,1015,709,126,21,1681
11/1/2022,VA,Virginia,Charlottesville City,51540,6344,4721,1623,5534,30,5504,810,28,782,5727,4106,1621,4824,3290,1534,1134,154,17,3519
11/1/2022,VA,Virginia,Chesapeake City,51550,43140,28933,14207,38210,271,37939,4930,173,4757,39006,24800,14206,25230,12280,12950,4752,1001,176,19301
11/1/2022,VA,Virginia,Chesterfield,51041,68797,45289,23508,61868,236,61632,6929,226,6703,62328,38824,23504,50632,29069,21563,6511,1031,199,42891
11/1/2022,VA,Virginia,Clarke,51043,3760,2898,862,3525,*,*,235,*,*,3395,2533,862,2490,1765,725,301,71,26,2092
11/1/2022,VA,Virginia,Colonial Heights City,51570,4114,2898,1216,3571,17,3554,543,11,532,3774,2558,1216,2669,1559,1110,542,111,17,1999
11/1/2022,VA,Virginia,Covington City,51580,1556,1014,542,1207,11,1196,349,*,*,1447,905,542,1226,711,515,361,*,*,802
11/1/2022,VA,Virginia,Craig,51045,1404,847,557,1156,*,*,248,*,*,1319,762,557,1110,604,506,203,*,*,845
11/1/2022,VA,Virginia,Culpeper,51047,10490,7639,2851,9347,44,9303,1143,32,1111,9504,6653,2851,7110,4732,2378,1317,239,63,5491
11/1/2022,VA,Virginia,Cumberland,51049,2419,1489,930,2054,12,2042,365,*,*,2248,1318,930,1871,1023,848,464,92,19,1296
11/1/2022,VA,Virginia,Danville City,51590,11069,5728,5341,8967,82,8885,2102,97,2005,10413,5072,5341,9178,4757,4421,3311,417,94,5356
11/1/2022,VA,Virginia,Dickenson,51051,4820,1802,3018,3332,*,*,1488,*,*,4634,1616,3018,4032,1331,2701,1113,214,36,2669
11/1/2022,VA,Virginia,Dinwiddie,51053,6362,3934,2428,5357,30,5327,1005,31,974,5900,3472,2428,4649,2382,2267,977,216,35,3421
11/1/2022,VA,Virginia,Emporia City,51595,1314,678,636,1069,15,1054,245,*,*,1222,586,636,1061,474,587,461,*,*,534
11/1/2022,VA,Virginia,Essex,51057,3102,2008,1094,2708,15,2693,394,15,379,2891,1797,1094,2307,1350,957,507,80,30,1690
11/1/2022,VA,Virginia,Fairfax,51059,168510,122727,45783,160757,587,160170,7753,387,7366,136556,90791,45765,89107,49002,40105,16095,2655,480,69877
11/1/2022,VA,Virginia,Fairfax City,51600,4301,3117,1184,4062,14,4048,239,11,228,3565,2382,1183,2448,1453,995,422,*,*,1948
11/1/2022,VA,Virginia,Falls Church City,51610,2279,1730,549,2202,*,*,77,*,*,1824,1275,549,1224,740,484,131,*,*,1077
11/1/2022,VA,Virginia,Fauquier,51061,14005,10787,3218,13025,61,12964,980,36,944,12342,9124,3218,8726,6104,2622,1045,193,43,7445
11/1/2022,VA,Virginia,Floyd,51063,4445,2934,1511,3927,12,3915,518,*,*,4149,2639,1510,3442,2024,1418,645,114,26,2657
11/1/2022,VA,Virginia,Fluvanna,51065,6981,5220,1761,6353,25,6328,628,18,610,6373,4613,1760,4957,3412,1545,677,111,24,4145
11/1/2022,VA,Virginia,Franklin,51067,15944,9719,6225,13809,52,13757,2135,33,2102,15011,8786,6225,12702,7024,5678,2144,483,111,9964
11/1/2022,VA,Virginia,Franklin City,51620,2216,1383,833,1837,15,1822,379,17,362,2089,1256,833,1774,981,793,562,*,*,1136
11/1/2022,VA,Virginia,Frederick,51069,18749,13875,4874,17013,63,16950,1736,46,1690,16999,12127,4872,12577,8413,4164,1580,389,97,10511
11/1/2022,VA,Virginia,Fredericksburg City,51630,4424,3062,1362,3791,22,3769,633,26,607,3951,2590,1361,2874,1619,1255,840,96,25,1913
11/1/2022,VA,Virginia,Galax City,51640,1687,1179,508,1388,*,*,299,*,*,1608,1100,508,1359,885,474,532,54,16,757
11/1/2022,VA,Virginia,Giles,51071,4517,2841,1676,3714,12,3702,803,15,788,4272,2596,1676,3675,2221,1454,750,118,27,2780
11/1/2022,VA,Virginia,Gloucester,51073,9772,6913,2859,8699,39,8660,1073,22,1051,9077,6218,2859,6252,3669,2583,1087,192,47,4926
11/1/2022,VA,Virginia,Goochland,51075,7009,5093,1916,6564,34,6530,445,*,*,6418,4502,1916,5510,3817,1693,456,107,16,4931
11/1/2022,VA,Virginia,Grayson,51077,4734,3084,1650,4003,13,3990,731,*,*,4532,2882,1650,3702,2156,1546,939,170,61,2532
11/1/2022,VA,Virginia,Greene,51079,4406,3296,1110,3921,14,3907,485,*,*,3991,2881,1110,3069,2050,1019,499,101,16,2453
11/1/2022,VA,Virginia,Greensville,51081,2231,1213,1018,1841,22,1819,390,12,378,2054,1036,1018,1753,829,924,474,110,20,1149
11/1/2022,VA,Virginia,Halifax,51083,10076,6607,3469,8523,59,8464,1553,53,1500,9476,6007,3469,7947,4730,3217,2115,403,115,5314
11/1/2022,VA,Virginia,Hampton City,51650,27165,15965,11200,23013,218,22795,4152,190,3962,24798,13600,11198,16662,6246,10416,4438,823,132,11269
11/1/2022,VA,Virginia,Hanover,51085,24211,16262,7949,22414,92,22322,1797,53,1744,22186,14240,7946,18696,11715,6981,1650,324,61,16661
11/1/2022,VA,Virginia,Harrisonburg City,51660,5709,4172,1537,4938,22,4916,771,22,749,5228,3691,1537,4401,2978,1423,1028,155,35,3183
11/1/2022,VA,Virginia,Henrico,51087,62116,38755,23361,55494,365,55129,6622,289,6333,56371,33012,23359,48151,26789,21362,7474,1416,260,39001
11/1/2022,VA,Virginia,Henry,51089,14835,7942,6893,12125,85,12040,2710,61,2649,14103,7211,6892,12452,5950,6502,3091,721,159,8481
11/1/2022,VA,Virginia,Highland,51091,893,696,197,818,*,*,75,0,75,850,653,197,679,504,175,78,*,*,575
11/1/2022,VA,Virginia,Hopewell City,51670,4613,2727,1886,3686,30,3656,927,30,897,4275,2389,1886,3233,1431,1802,1103,156,23,1951
11/1/2022,VA,Virginia,Isle of Wight,51093,9332,6360,2972,8357,51,8306,975,31,944,8595,5624,2971,6304,3537,2767,1050,194,59,5001
11/1/2022,VA,Virginia,James City,51095,22981,17723,5258,21739,59,21680,1242,33,1209,21294,16040,5254,14649,10299,4350,1103,218,45,13283
11/1/2022,VA,Virginia,King and Queen,51097,1874,1240,634,1636,*,*,238,*,*,1762,1128,634,1401,829,572,290,*,*,1037
11/1/2022,VA,Virginia,King George,51099,4515,3425,1090,4017,20,3997,498,19,479,3902,2812,1090,2199,1202,997,499,84,24,1592
11/1/2022,VA,Virginia,King William,51101,3857,2606,1251,3380,30,3350,477,21,456,3565,2314,1251,2998,1842,1156,449,99,15,2435
11/1/2022,VA,Virginia,Lancaster,51103,4486,3340,1146,4181,17,4164,305,13,292,4199,3054,1145,3246,2285,961,486,96,11,2653
11/1/2022,VA,Virginia,Lee,51105,6447,2290,4157,4732,20,4712,1715,18,1697,6145,1991,4154,5248,1497,3751,1926,235,60,3027
11/1/2022,VA,Virginia,Lexington City,51678,1324,1004,320,1222,*,*,102,*,*,1221,902,319,977,686,291,175,*,*,765
11/1/2022,VA,Virginia,Loudoun,51107,46117,33459,12658,43727,156,43571,2390,118,2272,38288,25639,12649,27387,16291,11096,4087,700,154,22446
11/1/2022,VA,Virginia,Louisa,51109,9658,6526,3132,8435,43,8392,1223,26,1197,8832,5701,3131,6905,4094,2811,1223,242,53,5387
11/1/2022,VA,Virginia,Lunenburg,51111,3255,2050,1205,2773,16,2757,482,*,*,3061,1856,1205,2472,1353,1119,773,122,26,1551
11/1/2022,VA,Virginia,Lynchburg City,51680,14904,9284,5620,12539,89,12450,2365,79,2286,13890,8270,5620,11886,6639,5247,3023,449,106,8308
11/1/2022,VA,Virginia,Madison,51113,3561,2615,946,3220,*,*,341,*,*,3300,2355,945,2575,1761,814,425,87,19,2044
11/1/2022,VA,Virginia,Manassas City,51683,5164,3474,1690,4700,21,4679,464,32,432,4357,2667,1690,3243,1724,1519,609,102,18,2514
11/1/2022,VA,Virginia,Manassas Park City,51685,1467,839,628,1294,16,1278,173,12,161,1229,601,628,958,372,586,250,*,*,653
11/1/2022,VA,Virginia,Martinsville City,51690,3817,1988,1829,2965,32,2933,852,27,825,3601,1772,1829,3178,1422,1756,1278,157,34,1709
11/1/2022,VA,Virginia,Mathews,51115,3062,2262,800,2824,18,2806,238,*,*,2871,2071,800,2183,1490,693,301,41,12,1829
11/1/2022,VA,Virginia,Mecklenburg,51117,9625,6173,3452,8226,51,8175,1399,45,1354,9038,5586,3452,7419,4264,3155,1799,418,77,5125
11/1/2022,VA,Virginia,Middlesex,51119,3777,2750,1027,3464,12,3452,313,*,*,3546,2519,1027,2797,1913,884,457,76,11,2253
11/1/2022,VA,Virginia,Montgomery,51121,14898,10362,4536,12827,61,12766,2071,29,2042,13463,8928,4535,11540,7328,4212,2017,327,77,9119
11/1/2022,VA,Virginia,Nelson,51125,4993,3613,1380,4550,15,4535,443,*,*,4656,3276,1380,3569,2343,1226,566,109,20,2874
11/1/2022,VA,Virginia,New Kent,51127,5578,3953,1625,5076,24,5052,502,17,485,5093,3468,1625,3828,2462,1366,361,97,15,3355
11/1/2022,VA,Virginia,Newport News City,51700,30642,17847,12795,25914,216,25698,4728,219,4509,28026,15232,12794,19878,7833,12045,5644,923,161,13150
11/1/2022,VA,Virginia,Norfolk City,51710,35409,20245,15164,29597,276,29321,5812,305,5507,31871,16709,15162,23344,8956,14388,8122,1374,219,13629
11/1/2022,VA,Virginia,Northampton,51131,3998,2560,1438,3574,18,3556,424,24,400,3734,2296,1438,3116,1809,1307,912,88,21,2095
11/1/2022,VA,Virginia,Northumberland,51133,4926,3605,1321,4582,15,4567,344,13,331,4580,3259,1321,3364,2277,1087,475,86,17,2786
11/1/2022,VA,Virginia,Norton City,51720,1100,456,644,795,*,*,305,*,*,1032,388,644,905,320,585,349,*,*,500
11/1/2022,VA,Virginia,Nottoway,51135,3653,2355,1298,3072,20,3052,581,15,566,3406,2108,1298,2760,1570,1190,832,137,33,1758
11/1/2022,VA,Virginia,Orange,51137,9364,6699,2665,8413,45,8368,951,23,928,8534,5869,2665,6191,3890,2301,1028,211,37,4915
11/1/2022,VA,Virginia,Page,51139,6460,4663,1797,5473,19,5454,987,18,969,6037,4240,1797,4726,3099,1627,1118,249,47,3312
11/1/2022,VA,Virginia,Patrick,51141,5572,3386,2186,4733,15,4718,839,*,*,5289,3105,2184,4451,2421,2030,1058,189,47,3157
11/1/2022,VA,Virginia,Petersburg City,51730,7139,3596,3543,5498,80,5418,1641,75,1566,6528,2985,3543,5231,1863,3368,2234,308,56,2633
11/1/2022,VA,Virginia,Pittsylvania,51143,17042,9823,7219,14412,102,14310,2630,69,2561,16090,8871,7219,13918,8038,5880,3159,543,136,10080
11/1/2022,VA,Virginia,Poquoson City,51735,2719,2143,576,2556,*,*,163,*,*,2491,1915,576,1429,900,529,135,*,*,1261
11/1/2022,VA,Virginia,Portsmouth City,51740,18975,10772,8203,15307,175,15132,3668,182,3486,17098,8895,8203,12301,4503,7798,4375,754,108,7064
11/1/2022,VA,Virginia,Powhatan,51145,6943,4932,2011,6378,14,6364,565,13,552,6408,4397,2011,5339,3533,1806,452,113,23,4751
11/1/2022,VA,Virginia,Prince Edward,51147,4886,3098,1788,4077,32,4045,809,23,786,4534,2746,1788,3736,2070,1666,1097,164,39,2436
11/1/2022,VA,Virginia,Prince George,51149,6799,4997,1802,5857,29,5828,942,31,911,6275,4473,1802,4150,2520,1630,695,133,30,3292
11/1/2022,VA,Virginia,Prince William,51153,56878,39650,17228,51982,290,51692,4896,267,4629,48402,31178,17224,30730,15125,15605,6282,1222,197,23029
11/1/2022,VA,Virginia,Pulaski,51155,9276,5660,3616,7624,29,7595,1652,30,1622,8638,5022,3616,7322,3997,3325,1599,270,67,5386
11/1/2022,VA,Virginia,Radford City,51750,2158,1413,745,1791,*,*,367,*,*,1956,1211,745,1705,1005,700,347,46,18,1294
11/1/2022,VA,Virginia,Rappahannock,51157,2149,1702,447,2027,*,*,122,*,*,1943,1497,446,1423,1058,365,158,37,11,1217
11/1/2022,VA,Virginia,Richmond,51159,2053,1388,665,1826,*,*,227,*,*,1914,1249,665,1514,946,568,357,*,*,1084
11/1/2022,VA,Virginia,Richmond City,51760,35233,18500,16733,29306,281,29025,5927,248,5679,31864,15133,16731,28013,12057,15956,9195,1333,203,17282
11/1/2022,VA,Virginia,Roanoke,51161,24928,16623,8305,22478,94,22384,2450,49,2401,23035,14734,8301,19336,11918,7418,2238,472,116,16510
11/1/2022,VA,Virginia,Roanoke City,51770,21391,11653,9738,17075,135,16940,4316,125,4191,19619,9881,9738,16755,7638,9117,4939,897,156,10763
11/1/2022,VA,Virginia,Rockbridge,51163,6777,4806,1971,5927,15,5912,850,*,*,6320,4349,1971,4999,3212,1787,902,178,49,3870
11/1/2022,VA,Virginia,Rockingham,51165,19232,14497,4735,17286,51,17235,1946,38,1908,17864,13129,4735,14826,10540,4286,1888,464,116,12358
11/1/2022,VA,Virginia,Russell,51167,7986,3688,4298,5944,19,5925,2042,22,2020,7675,3379,4296,6779,3095,3684,1710,312,82,4675
11/1/2022,VA,Virginia,Salem City,51775,6195,4169,2026,5391,25,5366,804,17,787,5678,3652,2026,4735,2866,1869,790,115,32,3798
11/1/2022,VA,Virginia,Scott,51169,6766,2347,4419,5298,11,5287,1468,12,1456,6483,2064,4419,5788,1602,4186,1524,263,77,3924
11/1/2022,VA,Virginia,Shenandoah,51171,11238,8085,3153,10141,27,10114,1097,16,1081,10521,7369,3152,8067,5303,2764,1301,286,64,6416
11/1/2022,VA,Virginia,Smyth,51173,8581,4767,3814,6656,19,6637,1925,20,1905,8140,4326,3814,6966,3349,3617,2034,365,102,4465
11/1/2022,VA,Virginia,Southampton,51175,4245,2857,1388,3660,28,3632,585,22,563,3943,2555,1388,3211,1939,1272,708,144,29,2330
11/1/2022,VA,Virginia,Spotsylvania,51177,24657,17209,7448,22015,128,21887,2642,98,2544,21856,14410,7446,14380,7722,6658,2442,521,107,11310
11/1/2022,VA,Virginia,Stafford,51179,20602,15426,5176,18628,121,18507,1974,88,1886,18055,12884,5171,10190,5606,4584,1759,404,68,7959
11/1/2022,VA,Virginia,Staunton City,51790,6426,4591,1835,5510,23,5487,916,17,899,6052,4217,1835,4966,3267,1699,1114,137,44,3671
11/1/2022,VA,Virginia,Suffolk City,51800,18546,11967,6579,15765,137,15628,2781,114,2667,16971,10393,6578,11973,5863,6110,2948,517,86,8422
11/1/2022,VA,Virginia,Surry,51181,1841,1166,675,1615,14,1601,226,*,*,1693,1018,675,1324,685,639,244,47,14,1019
11/1/2022,VA,Virginia,Sussex,51183,2546,1458,1088,2138,16,2122,408,13,395,2386,1298,1088,1944,922,1022,518,136,20,1270
11/1/2022,VA,Virginia,Tazewell,51185,11910,6250,5660,9247,36,9211,2663,31,2632,11366,5707,5659,9448,4853,4595,2343,498,109,6498
11/1/2022,VA,Virginia,Unknown,51999,*,*,*,*,*,*,*,*,*,*,*,*,*,*,*,*,*,*,*
11/1/2022,VA,Virginia,Virginia Beach City,51810,80092,56728,23364,72197,368,71829,7895,306,7589,73326,49969,23357,45569,24269,21300,7704,1630,313,35922
11/1/2022,VA,Virginia,Warren,51187,8737,6281,2456,7764,21,7743,973,23,950,7952,5496,2456,5830,3727,2103,1014,214,63,4539
11/1/2022,VA,Virginia,Washington,51191,15716,8088,7628,13118,31,13087,2598,26,2572,14877,7250,7627,12770,5702,7068,2482,604,128,9556
11/1/2022,VA,Virginia,Waynesboro City,51820,5166,3621,1545,4404,22,4382,762,16,746,4839,3294,1545,4015,2547,1468,894,130,37,2954
11/1/2022,VA,Virginia,Westmoreland,51193,5527,3985,1542,4973,30,4943,554,19,535,5019,3477,1542,3504,2115,1389,846,141,32,2485
11/1/2022,VA,Virginia,Williamsburg City,51830,3088,2225,863,2833,*,*,255,*,*,2845,1982,863,2129,1364,765,312,*,*,1769
11/1/2022,VA,Virginia,Winchester City,51840,5690,4128,1562,4956,22,4934,734,21,713,5200,3638,1562,4017,2631,1386,946,149,29,2893
11/1/2022,VA,Virginia,Wise,51195,10582,4010,6572,7605,25,7580,2977,30,2947,10035,3464,6571,8430,2659,5771,2448,467,116,5399
11/1/2022,VA,Virginia,Wythe,51197,8040,4476,3564,6448,33,6415,1592,14,1578,7615,4051,3564,6492,3173,3319,1642,306,72,4472
11/1/2022,VA,Virginia,York,51199,13456,10330,3126,12491,37,12454,965,41,924,12296,9170,3126,7029,4263,2766,809,162,36,6022
10/1/2022,VA,Virginia,Accomack,51001,9734,6712,3022,8588,49,8539,1146,39,1107,8982,5962,3020,6957,4300,2657,1645,363,70,4879
10/1/2022,VA,Virginia,Albemarle,51003,24017,19339,4678,22495,52,22443,1522,50,1472,21731,17055,4676,17444,13289,4155,1778,292,64,15310
10/1/2022,VA,Virginia,Alexandria City,51510,19360,14366,4994,18110,80,18030,1250,73,1177,15706,10714,4992,10469,5891,4578,2294,321,53,7801
10/1/2022,VA,Virginia,Alleghany,51005,4667,3182,1485,3873,19,3854,794,*,*,4435,2950,1485,3757,2442,1315,839,112,31,2775
10/1/2022,VA,Virginia,Amelia,51007,3346,2056,1290,2929,*,*,417,11,406,3096,1806,1290,2563,1348,1215,476,89,17,1981
10/1/2022,VA,Virginia,Amherst,51009,8224,5228,2996,7055,47,7008,1169,29,1140,7687,4691,2996,6490,3711,2779,1297,241,58,4894
10/1/2022,VA,Virginia,Appomattox,51011,4294,2782,1512,3580,20,3560,714,25,689,4016,2505,1511,3396,1993,1403,799,103,38,2456
10/1/2022,VA,Virginia,Arlington,51013,26357,19983,6374,24877,104,24773,1480,68,1412,20846,14473,6373,13827,7902,5925,3173,403,101,10150
10/1/2022,VA,Virginia,Augusta,51015,19681,14437,5244,17454,64,17390,2227,40,2187,18515,13271,5244,15200,10371,4829,2085,421,128,12566
10/1/2022,VA,Virginia,Bath,51017,1326,1040,286,1186,*,*,140,*,*,1260,974,286,1035,773,262,169,32,13,821
10/1/2022,VA,Virginia,Bedford,51019,21523,14681,6842,18981,64,18917,2542,49,2493,20087,13245,6842,16585,10642,5943,2161,512,139,13773
10/1/2022,VA,Virginia,Bland,51021,1849,1151,698,1525,*,*,324,*,*,1735,1037,698,1415,834,581,229,57,13,1116
10/1/2022,VA,Virginia,Botetourt,51023,9262,6132,3130,8275,44,8231,987,20,967,8637,5507,3130,7099,4344,2755,771,171,35,6122
10/1/2022,VA,Virginia,Bristol City,51520,4472,1880,2592,3592,*,*,880,15,865,4208,1616,2592,3707,1219,2488,1082,156,28,2441
10/1/2022,VA,Virginia,Brunswick,51025,4215,2484,1731,3594,26,3568,621,16,605,3950,2219,1731,3277,1675,1602,1048,135,25,2069
10/1/2022,VA,Virginia,Buchanan,51027,6820,2905,3915,4675,18,4657,2145,*,*,6572,2657,3915,5770,2564,3206,1588,384,77,3721
10/1/2022,VA,Virginia,Buckingham,51029,3885,2464,1421,3270,23,3247,615,16,599,3627,2207,1420,2941,1685,1256,817,142,32,1950
10/1/2022,VA,Virginia,Buena Vista City,51530,1483,944,539,1219,*,*,264,*,*,1386,847,539,1110,623,487,309,48,18,735
10/1/2022,VA,Virginia,Campbell,51031,13656,8613,5043,11685,72,11613,1971,58,1913,12781,7738,5043,10917,6254,4663,2171,384,121,8241
10/1/2022,VA,Virginia,Caroline,51033,6469,4172,2297,5619,25,5594,850,35,815,5838,3542,2296,4306,2225,2081,908,191,41,3166
10/1/2022,VA,Virginia,Carroll,51035,8750,5845,2905,7412,32,7380,1338,17,1321,8371,5466,2905,6865,4216,2649,1579,305,78,4903
10/1/2022,VA,Virginia,Charles City,51036,2036,1256,780,1787,18,1769,249,*,*,1867,1087,780,1508,800,708,270,86,11,1141
10/1/2022,VA,Virginia,Charlotte,51037,3269,2158,1111,2751,19,2732,518,13,505,3062,1951,1111,2539,1521,1018,711,126,21,1681
10/1/2022,VA,Virginia,Charlottesville City,51540,6346,4726,1620,5536,30,5506,810,28,782,5732,4114,1618,4823,3293,1530,1130,155,19,3519
10/1/2022,VA,Virginia,Chesapeake City,51550,43017,28842,14175,38106,277,37829,4911,173,4738,38902,24728,14174,25175,12259,12916,4715,994,176,19290
10/1/2022,VA,Virginia,Chesterfield,51041,68690,45238,23452,61782,241,61541,6908,228,6680,62257,38809,23448,50561,29050,21511,6457,1031,199,42874
10/1/2022,VA,Virginia,Clarke,51043,3759,2897,862,3524,*,*,235,*,*,3395,2533,862,2493,1770,723,304,72,26,2091
10/1/2022,VA,Virginia,Colonial Heights City,51570,4110,2897,1213,3568,17,3551,542,11,531,3772,2559,1213,2668,1562,1106,536,109,16,2007
10/1/2022,VA,Virginia,Covington City,51580,1559,1019,540,1210,11,1199,349,*,*,1454,914,540,1230,717,513,356,*,*,811
10/1/2022,VA,Virginia,Craig,51045,1403,845,558,1157,*,*,246,*,*,1318,760,558,1110,603,507,200,*,*,847
10/1/2022,VA,Virginia,Culpeper,51047,10482,7621,2861,9342,45,9297,1140,32,1108,9495,6634,2861,7108,4718,2390,1303,241,61,5503
10/1/2022,VA,Virginia,Cumberland,51049,2417,1490,927,2052,13,2039,365,*,*,2243,1316,927,1872,1024,848,465,93,17,1297
10/1/2022,VA,Virginia,Danville City,51590,11058,5725,5333,8967,83,8884,2091,99,1992,10401,5068,5333,9174,4757,4417,3283,422,94,5375
10/1/2022,VA,Virginia,Dickenson,51051,4820,1801,3019,3339,11,3328,1481,*,*,4637,1618,3019,4033,1334,2699,1116,215,36,2666
10/1/2022,VA,Virginia,Dinwiddie,51053,6363,3944,2419,5358,30,5328,1005,30,975,5900,3481,2419,4646,2391,2255,971,214,37,3424
10/1/2022,VA,Virginia,Emporia City,51595,1318,680,638,1072,15,1057,246,11,235,1224,586,638,1063,474,589,463,*,*,535
10/1/2022,VA,Virginia,Essex,51057,3103,2010,1093,2710,15,2695,393,15,378,2890,1797,1093,2308,1353,955,504,81,29,1694
10/1/2022,VA,Virginia,Fairfax,51059,168108,122483,45625,160365,597,159768,7743,388,7355,136264,90657,45607,88872,48925,39947,16001,2673,481,69717
10/1/2022,VA,Virginia,Fairfax City,51600,4289,3113,1176,4048,14,4034,241,11,230,3556,2381,1175,2436,1449,987,416,*,*,1942
10/1/2022,VA,Virginia,Falls Church City,51610,2278,1731,547,2200,*,*,78,*,*,1822,1275,547,1222,738,484,133,*,*,1073
10/1/2022,VA,Virginia,Fauquier,51061,13991,10779,3212,13017,63,12954,974,36,938,12346,9135,3211,8721,6106,2615,1043,195,43,7440
10/1/2022,VA,Virginia,Floyd,51063,4448,2946,1502,3932,12,3920,516,*,*,4153,2652,1501,3445,2037,1408,641,115,25,2664
10/1/2022,VA,Virginia,Fluvanna,51065,6975,5221,1754,6347,26,6321,628,18,610,6375,4622,1753,4950,3414,1536,673,111,24,4142
10/1/2022,VA,Virginia,Franklin,51067,15943,9726,6217,13813,52,13761,2130,34,2096,15010,8793,6217,12705,7036,5669,2127,483,110,9985
10/1/2022,VA,Virginia,Franklin City,51620,2216,1385,831,1840,15,1825,376,16,360,2090,1259,831,1773,982,791,561,*,*,1136
10/1/2022,VA,Virginia,Frederick,51069,18730,13866,4864,17001,65,16936,1729,45,1684,16984,12122,4862,12556,8401,4155,1571,397,97,10491
10/1/2022,VA,Virginia,Fredericksburg City,51630,4423,3061,1362,3790,22,3768,633,26,607,3950,2589,1361,2874,1617,1257,840,94,25,1915
10/1/2022,VA,Virginia,Galax City,51640,1692,1183,509,1394,*,*,298,*,*,1613,1104,509,1365,890,475,532,52,16,765
10/1/2022,VA,Virginia,Giles,51071,4521,2844,1677,3718,12,3706,803,15,788,4277,2600,1677,3675,2222,1453,745,117,27,2786
10/1/2022,VA,Virginia,Gloucester,51073,9751,6891,2860,8679,40,8639,1072,22,1050,9061,6201,2860,6240,3658,2582,1076,192,47,4925
10/1/2022,VA,Virginia,Goochland,51075,6996,5084,1912,6551,34,6517,445,*,*,6400,4488,1912,5498,3810,1688,454,107,16,4921
10/1/2022,VA,Virginia,Grayson,51077,4730,3084,1646,4000,13,3987,730,*,*,4532,2886,1646,3702,2160,1542,936,170,61,2535
10/1/2022,VA,Virginia,Greene,51079,4402,3293,1109,3916,14,3902,486,*,*,3985,2876,1109,3070,2051,1019,494,101,16,2459
10/1/2022,VA,Virginia,Greensville,51081,2223,1212,1011,1833,22,1811,390,12,378,2045,1034,1011,1744,827,917,474,110,20,1140
10/1/2022,VA,Virginia,Halifax,51083,10096,6626,3470,8541,59,8482,1555,54,1501,9494,6024,3470,7963,4744,3219,2111,400,116,5336
10/1/2022,VA,Virginia,Hampton City,51650,27124,15965,11159,22985,222,22763,4139,190,3949,24761,13604,11157,16633,6260,10373,4409,827,133,11264
10/1/2022,VA,Virginia,Hanover,51085,24180,16245,7935,22382,93,22289,1798,53,1745,22170,14238,7932,18686,11722,6964,1649,325,62,16650
10/1/2022,VA,Virginia,Harrisonburg City,51660,5713,4174,1539,4943,22,4921,770,22,748,5234,3695,1539,4402,2977,1425,1020,158,36,3188
10/1/2022,VA,Virginia,Henrico,51087,62057,38758,23299,55444,373,55071,6613,290,6323,56334,33037,23297,48083,26782,21301,7423,1422,266,38972
10/1/2022,VA,Virginia,Henry,51089,14833,7955,6878,12124,87,12037,2709,61,2648,14100,7223,6877,12447,5960,6487,3083,720,158,8486
10/1/2022,VA,Virginia,Highland,51091,892,696,196,816,*,*,76,0,76,847,651,196,676,502,174,78,*,*,572
10/1/2022,VA,Virginia,Hopewell City,51670,4612,2738,1874,3687,30,3657,925,30,895,4270,2396,1874,3226,1437,1789,1096,157,22,1951
10/1/2022,VA,Virginia,Isle of Wight,51093,9315,6347,2968,8343,52,8291,972,31,941,8587,5620,2967,6294,3534,2760,1037,194,59,5004
10/1/2022,VA,Virginia,James City,51095,22951,17699,5252,21707,60,21647,1244,33,1211,21269,16021,5248,14640,10298,4342,1100,219,45,13276
10/1/2022,VA,Virginia,King and Queen,51097,1874,1241,633,1637,*,*,237,*,*,1761,1128,633,1404,832,572,291,*,*,1038
10/1/2022,VA,Virginia,King George,51099,4503,3412,1091,4005,20,3985,498,18,480,3892,2801,1091,2200,1204,996,501,82,23,1594
10/1/2022,VA,Virginia,King William,51101,3854,2609,1245,3381,30,3351,473,21,452,3562,2317,1245,2998,1848,1150,449,100,15,2434
10/1/2022,VA,Virginia,Lancaster,51103,4483,3347,1136,4181,17,4164,302,13,289,4202,3067,1135,3249,2298,951,483,96,11,2659
10/1/2022,VA,Virginia,Lee,51105,6446,2303,4143,4734,20,4714,1712,17,1695,6142,2002,4140,5243,1506,3737,1921,236,58,3028
10/1/2022,VA,Virginia,Lexington City,51678,1321,1000,321,1219,*,*,102,*,*,1220,900,320,979,687,292,173,*,*,769
10/1/2022,VA,Virginia,Loudoun,51107,46028,33430,12598,43639,160,43479,2389,119,2270,38224,25636,12588,27323,16285,11038,4052,698,152,22421
10/1/2022,VA,Virginia,Louisa,51109,9638,6514,3124,8420,43,8377,1218,26,1192,8815,5692,3123,6888,4084,2804,1216,243,52,5377
10/1/2022,VA,Virginia,Lunenburg,51111,3258,2061,1197,2778,16,2762,480,*,*,3064,1867,1197,2468,1356,1112,771,122,27,1548
10/1/2022,VA,Virginia,Lynchburg City,51680,14914,9294,5620,12552,92,12460,2362,79,2283,13893,8273,5620,11895,6649,5246,3017,450,108,8320
10/1/2022,VA,Virginia,Madison,51113,3557,2608,949,3217,*,*,340,*,*,3300,2352,948,2579,1763,816,427,85,19,2048
10/1/2022,VA,Virginia,Manassas City,51683,5156,3478,1678,4694,21,4673,462,32,430,4349,2671,1678,3231,1723,1508,600,103,18,2510
10/1/2022,VA,Virginia,Manassas Park City,51685,1465,843,622,1292,16,1276,173,12,161,1227,605,622,953,374,579,250,*,*,648
10/1/2022,VA,Virginia,Martinsville City,51690,3813,1983,1830,2962,33,2929,851,27,824,3594,1764,1830,3176,1421,1755,1272,154,35,1715
10/1/2022,VA,Virginia,Mathews,51115,3060,2258,802,2822,18,2804,238,*,*,2874,2072,802,2188,1493,695,302,42,12,1832
10/1/2022,VA,Virginia,Mecklenburg,51117,9631,6184,3447,8232,53,8179,1399,46,1353,9038,5591,3447,7417,4267,3150,1798,415,75,5129
10/1/2022,VA,Virginia,Middlesex,51119,3776,2751,1025,3467,15,3452,309,*,*,3545,2520,1025,2797,1914,883,457,75,11,2254
10/1/2022,VA,Virginia,Montgomery,51121,14896,10363,4533,12825,62,12763,2071,29,2042,13469,8937,4532,11546,7335,4211,2016,328,76,9126
10/1/2022,VA,Virginia,Nelson,51125,4984,3599,1385,4545,15,4530,439,*,*,4652,3267,1385,3570,2343,1227,565,111,20,2874
10/1/2022,VA,Virginia,New Kent,51127,5565,3947,1618,5064,25,5039,501,17,484,5088,3470,1618,3815,2457,1358,359,96,15,3345
10/1/2022,VA,Virginia,Newport News City,51700,30584,17836,12748,25865,218,25647,4719,221,4498,27956,15209,12747,19813,7814,11999,5589,922,160,13142
10/1/2022,VA,Virginia,Norfolk City,51710,35373,20262,15111,29577,281,29296,5796,307,5489,31823,16714,15109,23290,8954,14336,8065,1378,219,13628
10/1/2022,VA,Virginia,Northampton,51131,3978,2547,1431,3560,19,3541,418,23,395,3715,2284,1431,3104,1804,1300,900,89,21,2094
10/1/2022,VA,Virginia,Northumberland,51133,4928,3609,1319,4587,15,4572,341,13,328,4583,3264,1319,3369,2285,1084,468,88,17,2796
10/1/2022,VA,Virginia,Norton City,51720,1094,451,643,792,*,*,302,*,*,1028,385,643,902,319,583,345,*,*,500
10/1/2022,VA,Virginia,Nottoway,51135,3659,2363,1296,3080,20,3060,579,15,564,3413,2117,1296,2770,1584,1186,830,138,33,1769
10/1/2022,VA,Virginia,Orange,51137,9370,6705,2665,8421,46,8375,949,23,926,8542,5877,2665,6196,3895,2301,1023,210,37,4926
10/1/2022,VA,Virginia,Page,51139,6467,4666,1801,5481,19,5462,986,18,968,6051,4250,1801,4730,3099,1631,1115,250,48,3317
10/1/2022,VA,Virginia,Patrick,51141,5564,3375,2189,4726,15,4711,838,*,*,5288,3101,2187,4451,2420,2031,1046,193,47,3165
10/1/2022,VA,Virginia,Petersburg City,51730,7151,3604,3547,5512,83,5429,1639,74,1565,6531,2984,3547,5246,1873,3373,2230,311,57,2648
10/1/2022,VA,Virginia,Pittsylvania,51143,17058,9833,7225,14439,103,14336,2619,67,2552,16103,8878,7225,13920,8038,5882,3144,541,139,10096
10/1/2022,VA,Virginia,Poquoson City,51735,2718,2146,572,2555,*,*,163,*,*,2490,1918,572,1429,904,525,136,*,*,1261
10/1/2022,VA,Virginia,Portsmouth City,51740,18948,10767,8181,15282,179,15103,3666,185,3481,17070,8889,8181,12266,4489,7777,4345,752,112,7057
10/1/2022,VA,Virginia,Powhatan,51145,6911,4912,1999,6349,14,6335,562,13,549,6383,4384,1999,5318,3524,1794,447,114,22,4735
10/1/2022,VA,Virginia,Prince Edward,51147,4896,3106,1790,4086,33,4053,810,25,785,4547,2757,1790,3747,2079,1668,1085,163,39,2460
10/1/2022,VA,Virginia,Prince George,51149,6789,4990,1799,5852,29,5823,937,31,906,6264,4465,1799,4143,2515,1628,686,136,30,3291
10/1/2022,VA,Virginia,Prince William,51153,56729,39564,17165,51839,293,51546,4890,268,4622,48286,31125,17161,30651,15106,15545,6220,1223,200,23008
10/1/2022,VA,Virginia,Pulaski,51155,9290,5667,3623,7643,30,7613,1647,29,1618,8656,5033,3623,7341,4009,3332,1594,274,64,5409
10/1/2022,VA,Virginia,Radford City,51750,2154,1407,747,1788,*,*,366,*,*,1951,1204,747,1702,1001,701,347,46,18,1291
10/1/2022,VA,Virginia,Rappahannock,51157,2139,1691,448,2018,*,*,121,*,*,1940,1493,447,1421,1055,366,157,*,*,1217
10/1/2022,VA,Virginia,Richmond,51159,2045,1382,663,1820,*,*,225,*,*,1909,1246,663,1512,946,566,352,*,*,1087
10/1/2022,VA,Virginia,Richmond City,51760,35178,18472,16706,29251,285,28966,5927,249,5678,31806,15102,16704,27968,12040,15928,9123,1346,205,17294
10/1/2022,VA,Virginia,Roanoke,51161,24936,16645,8291,22493,101,22392,2443,50,2393,23042,14755,8287,19353,11955,7398,2232,471,115,16535
10/1/2022,VA,Virginia,Roanoke City,51770,21397,11668,9729,17069,141,16928,4328,126,4202,19627,9898,9729,16760,7650,9110,4919,896,155,10790
10/1/2022,VA,Virginia,Rockbridge,51163,6782,4810,1972,5932,15,5917,850,*,*,6319,4347,1972,4997,3210,1787,900,176,48,3873
10/1/2022,VA,Virginia,Rockingham,51165,19221,14491,4730,17280,52,17228,1941,38,1903,17860,13130,4730,14815,10535,4280,1877,468,114,12356
10/1/2022,VA,Virginia,Russell,51167,7995,3697,4298,5953,19,5934,2042,22,2020,7684,3388,4296,6789,3105,3684,1705,313,80,4691
10/1/2022,VA,Virginia,Salem City,51775,6209,4187,2022,5409,28,5381,800,16,784,5697,3675,2022,4735,2871,1864,782,118,32,3803
10/1/2022,VA,Virginia,Scott,51169,6772,2351,4421,5307,11,5296,1465,11,1454,6491,2070,4421,5795,1606,4189,1523,265,75,3932
10/1/2022,VA,Virginia,Shenandoah,51171,11220,8069,3151,10127,27,10100,1093,16,1077,10502,7352,3150,8042,5279,2763,1290,283,66,6403
10/1/2022,VA,Virginia,Smyth,51173,8588,4779,3809,6662,19,6643,1926,20,1906,8146,4337,3809,6963,3351,3612,2020,365,103,4475
10/1/2022,VA,Virginia,Southampton,51175,4236,2855,1381,3651,28,3623,585,23,562,3935,2554,1381,3208,1943,1265,700,146,30,2332
10/1/2022,VA,Virginia,Spotsylvania,51177,24583,17167,7416,21944,129,21815,2639,97,2542,21788,14374,7414,14328,7695,6633,2407,525,106,11290
10/1/2022,VA,Virginia,Stafford,51179,20561,15413,5148,18592,128,18464,1969,87,1882,18018,12874,5144,10173,5618,4555,1754,405,68,7946
10/1/2022,VA,Virginia,Staunton City,51790,6448,4605,1843,5535,25,5510,913,17,896,6074,4231,1843,4983,3278,1705,1108,140,42,3693
10/1/2022,VA,Virginia,Suffolk City,51800,18502,11936,6566,15725,138,15587,2777,113,2664,16944,10379,6565,11960,5860,6100,2926,519,84,8431
10/1/2022,VA,Virginia,Surry,51181,1839,1166,673,1613,14,1599,226,*,*,1692,1019,673,1323,686,637,243,47,13,1020
10/1/2022,VA,Virginia,Sussex,51183,2545,1467,1078,2141,17,2124,404,13,391,2381,1303,1078,1938,926,1012,509,139,20,1270
10/1/2022,VA,Virginia,Tazewell,51185,11929,6254,5675,9269,37,9232,2660,32,2628,11385,5711,5674,9472,4873,4599,2336,496,109,6531
10/1/2022,VA,Virginia,Unknown,51999,*,*,*,*,*,*,*,*,*,*,*,*,*,*,*,*,*,*,*
10/1/2022,VA,Virginia,Virginia Beach City,51810,79954,56644,23310,72071,375,71696,7883,310,7573,73203,49900,23303,45504,24259,21245,7664,1631,312,35897
10/1/2022,VA,Virginia,Warren,51187,8708,6258,2450,7741,21,7720,967,23,944,7916,5466,2450,5814,3716,2098,994,218,64,4538
10/1/2022,VA,Virginia,Washington,51191,15734,8101,7633,13139,34,13105,2595,26,2569,14901,7269,7632,12785,5716,7069,2478,605,124,9578
10/1/2022,VA,Virginia,Waynesboro City,51820,5163,3621,1542,4402,22,4380,761,16,745,4838,3296,1542,4010,2548,1462,889,131,37,2953
10/1/2022,VA,Virginia,Westmoreland,51193,5519,3974,1545,4968,31,4937,551,19,532,5009,3464,1545,3499,2107,1392,844,141,32,2482
10/1/2022,VA,Virginia,Williamsburg City,51830,3090,2229,861,2834,*,*,256,*,*,2842,1981,861,2135,1370,765,314,*,*,1773
10/1/2022,VA,Virginia,Winchester City,51840,5701,4144,1557,4968,24,4944,733,22,711,5210,3653,1557,4026,2646,1380,948,147,29,2902
10/1/2022,VA,Virginia,Wise,51195,10597,4022,6575,7622,26,7596,2975,32,2943,10053,3479,6574,8443,2670,5773,2443,463,113,5424
10/1/2022,VA,Virginia,Wythe,51197,8058,4503,3555,6473,34,6439,1585,14,1571,7635,4080,3555,6503,3193,3310,1631,305,73,4494
10/1/2022,VA,Virginia,York,51199,13432,10319,3113,12472,39,12433,960,41,919,12283,9170,3113,7022,4269,2753,805,167,36,6014
9/1/2022,VA,Virginia,Accomack,51001,9695,6700,2995,8557,49,8508,1138,40,1098,8954,5961,2993,6931,4298,2633,1633,360,68,4870
9/1/2022,VA,Virginia,Albemarle,51003,23978,19316,4662,22459,52,22407,1519,50,1469,21694,17034,4660,17424,13281,4143,1773,292,63,15296
9/1/2022,VA,Virginia,Alexandria City,51510,19315,14357,4958,18065,81,17984,1250,73,1177,15681,10725,4956,10426,5876,4550,2275,320,52,7779
9/1/2022,VA,Virginia,Alleghany,51005,4656,3182,1474,3867,19,3848,789,*,*,4424,2950,1474,3740,2435,1305,829,111,31,2769
9/1/2022,VA,Virginia,Amelia,51007,3333,2054,1279,2916,*,*,417,12,405,3081,1802,1279,2548,1341,1207,469,90,18,1971
9/1/2022,VA,Virginia,Amherst,51009,8215,5232,2983,7048,47,7001,1167,30,1137,7684,4701,2983,6478,3712,2766,1299,238,58,4883
9/1/2022,VA,Virginia,Appomattox,51011,4296,2800,1496,3582,20,3562,714,25,689,4017,2521,1496,3396,2009,1387,800,104,37,2455
9/1/2022,VA,Virginia,Arlington,51013,26284,19942,6342,24804,105,24699,1480,68,1412,20820,14479,6341,13787,7891,5896,3157,400,101,10129
9/1/2022,VA,Virginia,Augusta,51015,19662,14427,5235,17436,69,17367,2226,41,2185,18499,13264,5235,15188,10370,4818,2080,424,128,12556
9/1/2022,VA,Virginia,Bath,51017,1324,1038,286,1185,*,*,139,*,*,1255,969,286,1030,768,262,166,32,13,819
9/1/2022,VA,Virginia,Bedford,51019,21499,14715,6784,18967,65,18902,2532,49,2483,20075,13291,6784,16570,10679,5891,2144,510,136,13780
9/1/2022,VA,Virginia,Bland,51021,1844,1150,694,1521,*,*,323,*,*,1735,1041,694,1411,835,576,225,58,13,1115
9/1/2022,VA,Virginia,Botetourt,51023,9260,6131,3129,8276,44,8232,984,20,964,8640,5511,3129,7085,4335,2750,766,171,34,6114
9/1/2022,VA,Virginia,Bristol City,51520,4477,1887,2590,3604,*,*,873,16,857,4211,1621,2590,3709,1222,2487,1076,155,30,2448
9/1/2022,VA,Virginia,Brunswick,51025,4209,2485,1724,3592,26,3566,617,16,601,3946,2222,1724,3272,1678,1594,1044,134,25,2069
9/1/2022,VA,Virginia,Buchanan,51027,6829,2922,3907,4686,18,4668,2143,12,2131,6577,2670,3907,5775,2579,3196,1582,384,76,3733
9/1/2022,VA,Virginia,Buckingham,51029,3871,2455,1416,3258,23,3235,613,16,597,3626,2211,1415,2932,1684,1248,808,141,34,1949
9/1/2022,VA,Virginia,Buena Vista City,51530,1480,948,532,1218,*,*,262,*,*,1381,849,532,1106,626,480,308,49,18,731
9/1/2022,VA,Virginia,Campbell,51031,13642,8634,5008,11670,72,11598,1972,58,1914,12773,7765,5008,10902,6277,4625,2168,382,119,8233
9/1/2022,VA,Virginia,Caroline,51033,6452,4172,2280,5606,25,5581,846,35,811,5825,3545,2280,4288,2223,2065,900,192,41,3155
9/1/2022,VA,Virginia,Carroll,51035,8741,5881,2860,7405,33,7372,1336,18,1318,8360,5500,2860,6849,4247,2602,1573,302,79,4895
9/1/2022,VA,Virginia,Charles City,51036,2030,1254,776,1782,18,1764,248,*,*,1863,1087,776,1505,801,704,266,89,11,1139
9/1/2022,VA,Virginia,Charlotte,51037,3258,2153,1105,2744,19,2725,514,13,501,3057,1952,1105,2533,1519,1014,698,127,23,1685
9/1/2022,VA,Virginia,Charlottesville City,51540,6343,4731,1612,5528,30,5498,815,28,787,5736,4126,1610,4826,3304,1522,1128,153,18,3527
9/1/2022,VA,Virginia,Chesapeake City,51550,42904,28803,14101,38011,283,37728,4893,173,4720,38812,24712,14100,25118,12264,12854,4670,1008,174,19266
9/1/2022,VA,Virginia,Chesterfield,51041,68498,45119,23379,61610,245,61365,6888,227,6661,62130,38755,23375,50433,28992,21441,6400,1029,197,42807
9/1/2022,VA,Virginia,Clarke,51043,3748,2888,860,3513,*,*,235,*,*,3389,2529,860,2487,1766,721,302,73,26,2086
9/1/2022,VA,Virginia,Colonial Heights City,51570,4113,2902,1211,3571,18,3553,542,11,531,3779,2568,1211,2675,1571,1104,537,110,16,2012
9/1/2022,VA,Virginia,Covington City,51580,1550,1021,529,1200,12,1188,350,*,*,1450,921,529,1226,722,504,354,*,*,806
9/1/2022,VA,Virginia,Craig,51045,1400,847,553,1154,*,*,246,*,*,1316,763,553,1107,606,501,200,*,*,845
9/1/2022,VA,Virginia,Culpeper,51047,10465,7621,2844,9323,46,9277,1142,32,1110,9479,6635,2844,7107,4732,2375,1299,237,62,5509
9/1/2022,VA,Virginia,Cumberland,51049,2416,1492,924,2055,13,2042,361,*,*,2243,1319,924,1872,1027,845,463,93,17,1299
9/1/2022,VA,Virginia,Danville City,51590,11048,5725,5323,8957,84,8873,2091,102,1989,10399,5076,5323,9169,4760,4409,3274,423,94,5378
9/1/2022,VA,Virginia,Dickenson,51051,4826,1815,3011,3349,11,3338,1477,*,*,4644,1633,3011,4031,1341,2690,1113,213,36,2669
9/1/2022,VA,Virginia,Dinwiddie,51053,6352,3944,2408,5347,30,5317,1005,31,974,5890,3482,2408,4640,2395,2245,969,216,38,3417
9/1/2022,VA,Virginia,Emporia City,51595,1314,675,639,1069,15,1054,245,11,234,1223,584,639,1062,474,588,463,*,*,533
9/1/2022,VA,Virginia,Essex,51057,3096,2011,1085,2703,15,2688,393,15,378,2888,1803,1085,2304,1356,948,500,82,29,1693
9/1/2022,VA,Virginia,Fairfax,51059,167483,122103,45380,159760,606,159154,7723,389,7334,135910,90548,45362,88568,48848,39720,15874,2682,479,69533
9/1/2022,VA,Virginia,Fairfax City,51600,4277,3101,1176,4036,14,4022,241,11,230,3546,2371,1175,2429,1442,987,413,*,*,1937
9/1/2022,VA,Virginia,Falls Church City,51610,2268,1719,549,2190,*,*,78,*,*,1818,1269,549,1219,733,486,132,*,*,1071
9/1/2022,VA,Virginia,Fauquier,51061,13951,10756,3195,12978,65,12913,973,36,937,12317,9123,3194,8696,6094,2602,1038,192,44,7422
9/1/2022,VA,Virginia,Floyd,51063,4440,2952,1488,3926,12,3914,514,*,*,4145,2658,1487,3436,2040,1396,637,113,27,2659
9/1/2022,VA,Virginia,Fluvanna,51065,6952,5215,1737,6326,27,6299,626,17,609,6353,4617,1736,4930,3411,1519,666,114,23,4127
9/1/2022,VA,Virginia,Franklin,51067,15927,9732,6195,13805,56,13749,2122,34,2088,15000,8805,6195,12684,7035,5649,2105,482,109,9988
9/1/2022,VA,Virginia,Franklin City,51620,2218,1387,831,1843,15,1828,375,16,359,2094,1263,831,1776,986,790,556,*,*,1143
9/1/2022,VA,Virginia,Frederick,51069,18698,13844,4854,16972,67,16905,1726,46,1680,16967,12115,4852,12539,8397,4142,1555,396,100,10488
9/1/2022,VA,Virginia,Fredericksburg City,51630,4409,3056,1353,3780,23,3757,629,25,604,3940,2588,1352,2861,1610,1251,831,94,26,1910
9/1/2022,VA,Virginia,Galax City,51640,1689,1176,513,1392,*,*,297,*,*,1609,1096,513,1364,885,479,530,51,17,766
9/1/2022,VA,Virginia,Giles,51071,4525,2841,1684,3721,12,3709,804,15,789,4285,2601,1684,3685,2226,1459,737,115,27,2806
9/1/2022,VA,Virginia,Gloucester,51073,9729,6889,2840,8661,40,8621,1068,22,1046,9029,6189,2840,6212,3651,2561,1063,195,47,4907
9/1/2022,VA,Virginia,Goochland,51075,6962,5059,1903,6517,34,6483,445,*,*,6375,4472,1903,5473,3795,1678,453,103,17,4900
9/1/2022,VA,Virginia,Grayson,51077,4735,3090,1645,4008,14,3994,727,*,*,4536,2891,1645,3709,2167,1542,938,172,61,2538
9/1/2022,VA,Virginia,Greene,51079,4388,3285,1103,3902,14,3888,486,*,*,3975,2872,1103,3059,2048,1011,490,98,16,2455
9/1/2022,VA,Virginia,Greensville,51081,2223,1218,1005,1833,23,1810,390,12,378,2046,1041,1005,1741,832,909,469,112,20,1140
9/1/2022,VA,Virginia,Halifax,51083,10092,6642,3450,8535,59,8476,1557,55,1502,9491,6041,3450,7954,4755,3199,2100,400,114,5340
9/1/2022,VA,Virginia,Hampton City,51650,27074,15983,11091,22949,227,22722,4125,192,3933,24694,13605,11089,16575,6260,10315,4381,826,135,11233
9/1/2022,VA,Virginia,Hanover,51085,24098,16208,7890,22303,94,22209,1795,53,1742,22120,14233,7887,18625,11705,6920,1634,325,62,16604
9/1/2022,VA,Virginia,Harrisonburg City,51660,5714,4189,1525,4945,22,4923,769,22,747,5231,3706,1525,4393,2983,1410,1010,156,35,3192
9/1/2022,VA,Virginia,Henrico,51087,61972,38757,23215,55359,376,54983,6613,287,6326,56306,33093,23213,48020,26807,21213,7375,1422,264,38959
9/1/2022,VA,Virginia,Henry,51089,14820,7974,6846,12115,88,12027,2705,61,2644,14083,7238,6845,12440,5985,6455,3058,724,158,8500
9/1/2022,VA,Virginia,Highland,51091,893,700,193,816,*,*,77,0,77,849,656,193,677,504,173,77,*,*,574
9/1/2022,VA,Virginia,Hopewell City,51670,4609,2738,1871,3688,31,3657,921,29,892,4275,2404,1871,3222,1438,1784,1084,157,22,1959
9/1/2022,VA,Virginia,Isle of Wight,51093,9304,6335,2969,8333,52,8281,971,32,939,8581,5613,2968,6289,3529,2760,1030,196,59,5004
9/1/2022,VA,Virginia,James City,51095,22908,17671,5237,21668,61,21607,1240,33,1207,21241,16008,5233,14621,10291,4330,1083,221,44,13273
9/1/2022,VA,Virginia,King and Queen,51097,1872,1247,625,1636,*,*,236,*,*,1759,1134,625,1401,837,564,288,*,*,1038
9/1/2022,VA,Virginia,King George,51099,4485,3401,1084,3992,20,3972,493,18,475,3881,2797,1084,2198,1209,989,496,83,22,1597
9/1/2022,VA,Virginia,King William,51101,3840,2604,1236,3369,30,3339,471,22,449,3547,2311,1236,2984,1844,1140,445,100,16,2423
9/1/2022,VA,Virginia,Lancaster,51103,4482,3351,1131,4180,17,4163,302,13,289,4202,3072,1130,3248,2301,947,485,95,11,2657
9/1/2022,VA,Virginia,Lee,51105,6460,2317,4143,4745,20,4725,1715,17,1698,6157,2017,4140,5255,1519,3736,1931,234,58,3032
9/1/2022,VA,Virginia,Lexington City,51678,1322,1001,321,1221,*,*,101,*,*,1222,902,320,978,686,292,172,*,*,769
9/1/2022,VA,Virginia,Loudoun,51107,45824,33308,12516,43444,163,43281,2380,121,2259,38109,25603,12506,27220,16262,10958,4024,695,151,22350
9/1/2022,VA,Virginia,Louisa,51109,9588,6477,3111,8378,43,8335,1210,27,1183,8770,5660,3110,6853,4062,2791,1204,245,52,5352
9/1/2022,VA,Virginia,Lunenburg,51111,3251,2062,1189,2770,17,2753,481,*,*,3055,1866,1189,2465,1360,1105,762,121,26,1556
9/1/2022,VA,Virginia,Lynchburg City,51680,14926,9326,5600,12563,93,12470,2363,80,2283,13908,8308,5600,11900,6673,5227,3008,450,106,8336
9/1/2022,VA,Virginia,Madison,51113,3555,2607,948,3216,*,*,339,*,*,3300,2353,947,2574,1759,815,428,83,19,2044
9/1/2022,VA,Virginia,Manassas City,51683,5131,3465,1666,4673,22,4651,458,32,426,4332,2666,1666,3213,1717,1496,594,104,18,2497
9/1/2022,VA,Virginia,Manassas Park City,51685,1464,845,619,1291,16,1275,173,12,161,1226,607,619,953,377,576,246,*,*,652
9/1/2022,VA,Virginia,Martinsville City,51690,3818,1992,1826,2967,33,2934,851,27,824,3598,1772,1826,3184,1434,1750,1271,159,35,1719
9/1/2022,VA,Virginia,Mathews,51115,3039,2240,799,2806,19,2787,233,*,*,2863,2064,799,2181,1491,690,299,41,12,1829
9/1/2022,VA,Virginia,Mecklenburg,51117,9612,6186,3426,8223,53,8170,1389,47,1342,9031,5605,3426,7402,4272,3130,1787,409,73,5133
9/1/2022,VA,Virginia,Middlesex,51119,3779,2755,1024,3471,15,3456,308,*,*,3549,2525,1024,2797,1916,881,451,75,11,2260
9/1/2022,VA,Virginia,Montgomery,51121,14902,10381,4521,12829,62,12767,2073,30,2043,13482,8962,4520,11557,7358,4199,2017,327,75,9138
9/1/2022,VA,Virginia,Nelson,51125,4970,3599,1371,4532,15,4517,438,*,*,4640,3269,1371,3561,2348,1213,561,110,20,2870
9/1/2022,VA,Virginia,New Kent,51127,5550,3938,1612,5053,25,5028,497,17,480,5078,3466,1612,3806,2453,1353,358,97,16,3335
9/1/2022,VA,Virginia,Newport News City,51700,30544,17851,12693,25831,222,25609,4713,224,4489,27922,15230,12692,19786,7838,11948,5567,922,160,13137
9/1/2022,VA,Virginia,Norfolk City,51710,35339,20298,15041,29547,283,29264,5792,311,5481,31811,16772,15039,23235,8964,14271,7999,1387,214,13635
9/1/2022,VA,Virginia,Northampton,51131,3968,2544,1424,3548,19,3529,420,23,397,3711,2287,1424,3097,1805,1292,897,88,21,2091
9/1/2022,VA,Virginia,Northumberland,51133,4917,3613,1304,4576,15,4561,341,13,328,4574,3270,1304,3360,2289,1071,466,87,17,2790
9/1/2022,VA,Virginia,Norton City,51720,1095,459,636,792,*,*,303,*,*,1029,393,636,904,328,576,344,*,*,502
9/1/2022,VA,Virginia,Nottoway,51135,3664,2369,1295,3084,21,3063,580,15,565,3417,2122,1295,2774,1587,1187,829,137,33,1775
9/1/2022,VA,Virginia,Orange,51137,9359,6703,2656,8411,46,8365,948,24,924,8547,5891,2656,6197,3905,2292,1020,211,37,4929
9/1/2022,VA,Virginia,Page,51139,6449,4662,1787,5465,20,5445,984,18,966,6037,4250,1787,4720,3101,1619,1102,250,49,3319
9/1/2022,VA,Virginia,Patrick,51141,5554,3370,2184,4726,15,4711,828,*,*,5277,3095,2182,4439,2415,2024,1039,191,47,3162
9/1/2022,VA,Virginia,Petersburg City,51730,7161,3629,3532,5522,86,5436,1639,75,1564,6539,3007,3532,5246,1888,3358,2222,314,55,2655
9/1/2022,VA,Virginia,Pittsylvania,51143,17055,9858,7197,14447,104,14343,2608,68,2540,16100,8903,7197,13912,8055,5857,3122,548,137,10105
9/1/2022,VA,Virginia,Poquoson City,51735,2714,2145,569,2551,*,*,163,*,*,2493,1924,569,1427,905,522,133,*,*,1260
9/1/2022,VA,Virginia,Portsmouth City,51740,18924,10780,8144,15258,183,15075,3666,187,3479,17047,8903,8144,12234,4494,7740,4320,750,111,7053
9/1/2022,VA,Virginia,Powhatan,51145,6896,4899,1997,6336,15,6321,560,13,547,6378,4381,1997,5306,3515,1791,446,111,22,4727
9/1/2022,VA,Virginia,Prince Edward,51147,4904,3118,1786,4096,35,4061,808,25,783,4554,2768,1786,3749,2086,1663,1081,163,39,2466
9/1/2022,VA,Virginia,Prince George,51149,6779,4985,1794,5842,29,5813,937,31,906,6255,4461,1794,4137,2513,1624,683,135,29,3290
9/1/2022,VA,Virginia,Prince William,51153,56507,39460,17047,51635,294,51341,4872,269,4603,48124,31081,17043,30521,15088,15433,6152,1218,200,22951
9/1/2022,VA,Virginia,Pulaski,51155,9297,5682,3615,7649,33,7616,1648,29,1619,8658,5043,3615,7334,4011,3323,1596,272,63,5403
9/1/2022,VA,Virginia,Radford City,51750,2156,1410,746,1790,*,*,366,*,*,1951,1205,746,1706,1006,700,346,46,18,1296
9/1/2022,VA,Virginia,Rappahannock,51157,2133,1686,447,2011,*,*,122,*,*,1933,1487,446,1416,1051,365,155,36,12,1213
9/1/2022,VA,Virginia,Richmond,51159,2042,1383,659,1817,*,*,225,*,*,1907,1248,659,1506,945,561,346,*,*,1087
9/1/2022,VA,Virginia,Richmond City,51760,35125,18486,16639,29206,286,28920,5919,254,5665,31767,15131,16636,27906,12042,15864,9047,1357,205,17297
9/1/2022,VA,Virginia,Roanoke,51161,24905,16638,8267,22467,103,22364,2438,50,2388,23031,14768,8263,19336,11962,7374,2218,469,115,16534
9/1/2022,VA,Virginia,Roanoke City,51770,21415,11707,9708,17087,148,16939,4328,126,4202,19643,9935,9708,16760,7674,9086,4896,893,152,10819
9/1/2022,VA,Virginia,Rockbridge,51163,6767,4815,1952,5917,15,5902,850,*,*,6303,4351,1952,4984,3216,1768,897,177,47,3863
9/1/2022,VA,Virginia,Rockingham,51165,19197,14505,4692,17257,55,17202,1940,41,1899,17824,13132,4692,14763,10522,4241,1859,472,112,12320
9/1/2022,VA,Virginia,Russell,51167,8001,3717,4284,5960,19,5941,2041,23,2018,7685,3402,4283,6791,3118,3673,1706,315,80,4690
9/1/2022,VA,Virginia,Salem City,51775,6208,4192,2016,5405,28,5377,803,16,787,5696,3680,2016,4729,2871,1858,779,118,33,3799
9/1/2022,VA,Virginia,Scott,51169,6780,2351,4429,5317,12,5305,1463,*,*,6501,2072,4429,5809,1611,4198,1523,264,75,3947
9/1/2022,VA,Virginia,Shenandoah,51171,11204,8070,3134,10115,27,10088,1089,16,1073,10494,7361,3133,8039,5292,2747,1275,287,64,6413
9/1/2022,VA,Virginia,Smyth,51173,8592,4794,3798,6671,19,6652,1921,20,1901,8150,4352,3798,6963,3363,3600,2006,370,103,4484
9/1/2022,VA,Virginia,Southampton,51175,4226,2842,1384,3642,30,3612,584,23,561,3925,2541,1384,3206,1938,1268,694,146,31,2335
9/1/2022,VA,Virginia,Spotsylvania,51177,24526,17141,7385,21890,130,21760,2636,98,2538,21751,14368,7383,14302,7701,6601,2400,525,105,11272
9/1/2022,VA,Virginia,Stafford,51179,20487,15376,5111,18526,129,18397,1961,87,1874,17968,12861,5107,10156,5641,4515,1742,408,68,7938
9/1/2022,VA,Virginia,Staunton City,51790,6443,4607,1836,5530,25,5505,913,17,896,6070,4234,1836,4977,3278,1699,1103,141,42,3691
9/1/2022,VA,Virginia,Suffolk City,51800,18462,11924,6538,15696,138,15558,2766,113,2653,16902,10364,6538,11933,5859,6074,2909,518,84,8422
9/1/2022,VA,Virginia,Surry,51181,1837,1167,670,1612,14,1598,225,*,*,1690,1020,670,1319,685,634,239,47,13,1020
9/1/2022,VA,Virginia,Sussex,51183,2548,1472,1076,2145,18,2127,403,14,389,2382,1306,1076,1933,923,1010,499,141,20,1273
9/1/2022,VA,Virginia,Tazewell,51185,11918,6250,5668,9268,37,9231,2650,32,2618,11382,5715,5667,9468,4878,4590,2325,495,110,6538
9/1/2022,VA,Virginia,Unknown,51999,*,*,*,*,*,*,*,*,*,*,*,*,*,*,*,*,*,*,*
9/1/2022,VA,Virginia,Virginia Beach City,51810,79775,56554,23221,71903,381,71522,7872,312,7560,73059,49845,23214,45391,24224,21167,7600,1635,314,35842
9/1/2022,VA,Virginia,Warren,51187,8686,6258,2428,7723,21,7702,963,23,940,7895,5467,2428,5797,3718,2079,992,219,64,4522
9/1/2022,VA,Virginia,Washington,51191,15744,8131,7613,13151,37,13114,2593,26,2567,14911,7299,7612,12792,5745,7047,2465,609,123,9595
9/1/2022,VA,Virginia,Waynesboro City,51820,5161,3623,1538,4401,22,4379,760,17,743,4833,3295,1538,4004,2547,1457,879,135,38,2952
9/1/2022,VA,Virginia,Westmoreland,51193,5513,3975,1538,4961,31,4930,552,19,533,5002,3464,1538,3502,2115,1387,838,140,33,2491
9/1/2022,VA,Virginia,Williamsburg City,51830,3087,2228,859,2832,*,*,255,*,*,2842,1983,859,2134,1371,763,309,*,*,1777
9/1/2022,VA,Virginia,Winchester City,51840,5702,4159,1543,4972,25,4947,730,20,710,5212,3669,1543,4015,2647,1368,940,152,29,2894
9/1/2022,VA,Virginia,Wise,51195,10601,4032,6569,7632,27,7605,2969,32,2937,10062,3494,6568,8440,2678,5762,2432,465,115,5428
9/1/2022,VA,Virginia,Wythe,51197,8059,4512,3547,6477,34,6443,1582,13,1569,7631,4084,3547,6504,3205,3299,1631,304,72,4497
9/1/2022,VA,Virginia,York,51199,13411,10314,3097,12454,40,12414,957,41,916,12268,9171,3097,7005,4267,2738,800,169,37,5999
4/1/2023,VA,Virginia,Accomack,51001,9803,6422,3381,8646,48,8598,1157,38,1119,9089,5710,3379,7141,4132,3009,1758,338,52,4993
4/1/2023,VA,Virginia,Albemarle,51003,24145,19038,5107,22652,52,22600,1493,52,1441,21992,16889,5103,17845,13276,4569,1872,275,57,15641
4/1/2023,VA,Virginia,Alexandria City,51510,19438,14081,5357,18191,79,18112,1247,70,1177,15929,10575,5354,10747,5810,4937,2451,303,44,7949
4/1/2023,VA,Virginia,Alleghany,51005,4678,3032,1646,3886,17,3869,792,11,781,4448,2802,1646,3810,2348,1462,903,106,33,2768
4/1/2023,VA,Virginia,Amelia,51007,3376,1970,1406,2956,*,*,420,*,*,3138,1732,1406,2629,1305,1324,504,89,19,2017
4/1/2023,VA,Virginia,Amherst,51009,8236,5008,3228,7078,48,7030,1158,31,1127,7734,4507,3227,6587,3589,2998,1362,217,47,4961
4/1/2023,VA,Virginia,Appomattox,51011,4331,2699,1632,3630,19,3611,701,25,676,4065,2434,1631,3451,1938,1513,833,97,33,2488
4/1/2023,VA,Virginia,Arlington,51013,26399,19248,7151,24962,101,24861,1437,68,1369,21095,13945,7150,14232,7533,6699,3350,378,90,10414
4/1/2023,VA,Virginia,Augusta,51015,19792,13987,5805,17584,62,17522,2208,38,2170,18690,12885,5805,15515,10122,5393,2230,393,113,12779
4/1/2023,VA,Virginia,Bath,51017,1326,1013,313,1185,*,*,141,*,*,1269,956,313,1051,764,287,162,27,15,847
4/1/2023,VA,Virginia,Bedford,51019,21753,14154,7599,19238,62,19176,2515,47,2468,20393,12794,7599,16987,10292,6695,2316,474,106,14091
4/1/2023,VA,Virginia,Bland,51021,1857,1098,759,1539,*,*,318,*,*,1753,994,759,1436,788,648,234,*,*,1141
4/1/2023,VA,Virginia,Botetourt,51023,9296,5959,3337,8319,39,8280,977,19,958,8707,5370,3337,7244,4279,2965,829,156,33,6226
4/1/2023,VA,Virginia,Bristol City,51520,4440,1750,2690,3565,*,*,875,13,862,4185,1495,2690,3712,1139,2573,1138,135,23,2416
4/1/2023,VA,Virginia,Brunswick,51025,4238,2353,1885,3628,27,3601,610,17,593,3985,2101,1884,3356,1601,1755,1098,122,20,2116
4/1/2023,VA,Virginia,Buchanan,51027,6793,2654,4139,4680,19,4661,2113,14,2099,6544,2406,4138,5773,2434,3339,1665,349,70,3689
4/1/2023,VA,Virginia,Buckingham,51029,3882,2317,1565,3276,24,3252,606,19,587,3626,2062,1564,2992,1584,1408,868,126,32,1966
4/1/2023,VA,Virginia,Buena Vista City,51530,1476,902,574,1215,*,*,261,*,*,1380,806,574,1133,607,526,334,38,16,745
4/1/2023,VA,Virginia,Campbell,51031,13650,8155,5495,11712,70,11642,1938,56,1882,12833,7339,5494,11042,5998,5044,2302,364,100,8276
4/1/2023,VA,Virginia,Caroline,51033,6528,4010,2518,5696,28,5668,832,37,795,5939,3422,2517,4459,2155,2304,996,173,29,3261
4/1/2023,VA,Virginia,Carroll,51035,8759,5612,3147,7425,33,7392,1334,15,1319,8392,5245,3147,6964,4048,2916,1652,287,63,4962
4/1/2023,VA,Virginia,Charles City,51036,2051,1194,857,1808,17,1791,243,*,*,1896,1039,857,1545,770,775,299,*,*,1164
4/1/2023,VA,Virginia,Charlotte,51037,3256,2061,1195,2739,19,2720,517,12,505,3054,1859,1195,2549,1446,1103,727,121,19,1682
4/1/2023,VA,Virginia,Charlottesville City,51540,6329,4575,1754,5536,32,5504,793,24,769,5734,3982,1752,4864,3207,1657,1165,139,13,3547
4/1/2023,VA,Virginia,Chesapeake City,51550,43573,28199,15374,38652,268,38384,4921,175,4746,39639,24267,15372,25923,11767,14156,5086,922,155,19760
4/1/2023,VA,Virginia,Chesterfield,51041,69299,44121,25178,62458,233,62225,6841,220,6621,63196,38029,25167,51746,28591,23155,6945,951,166,43684
4/1/2023,VA,Virginia,Clarke,51043,3779,2833,946,3545,*,*,234,*,*,3429,2483,946,2531,1731,800,318,62,25,2126
4/1/2023,VA,Virginia,Colonial Heights City,51570,4085,2774,1311,3544,18,3526,541,11,530,3765,2454,1311,2706,1505,1201,568,*,*,2026
4/1/2023,VA,Virginia,Covington City,51580,1526,959,567,1183,*,*,343,*,*,1420,853,567,1219,674,545,365,43,11,800
4/1/2023,VA,Virginia,Craig,51045,1401,820,581,1156,*,*,245,*,*,1319,738,581,1115,588,527,225,42,13,835
4/1/2023,VA,Virginia,Culpeper,51047,10523,7375,3148,9405,39,9366,1118,29,1089,9588,6441,3147,7317,4630,2687,1361,234,55,5667
4/1/2023,VA,Virginia,Cumberland,51049,2421,1437,984,2077,11,2066,344,*,*,2252,1268,984,1903,991,912,475,85,17,1326
4/1/2023,VA,Virginia,Danville City,51590,11052,5371,5681,8986,86,8900,2066,95,1971,10433,4753,5680,9277,4527,4750,3457,383,78,5359
4/1/2023,VA,Virginia,Dickenson,51051,4801,1466,3335,3344,11,3333,1457,*,*,4617,1283,3334,4024,1239,2785,1140,196,36,2652
4/1/2023,VA,Virginia,Dinwiddie,51053,6366,3724,2642,5372,33,5339,994,29,965,5948,3306,2642,4742,2268,2474,1042,174,29,3497
4/1/2023,VA,Virginia,Emporia City,51595,1306,632,674,1064,14,1050,242,12,230,1224,550,674,1064,437,627,473,*,*,528
4/1/2023,VA,Virginia,Essex,51057,3134,1959,1175,2750,17,2733,384,13,371,2925,1750,1175,2371,1331,1040,530,73,21,1747
4/1/2023,VA,Virginia,Fairfax,51059,169413,119807,49606,161787,580,161207,7626,366,7260,138794,89217,49577,92088,48250,43838,17124,2464,436,72064
4/1/2023,VA,Virginia,Fairfax City,51600,4309,3024,1285,4080,14,4066,229,11,218,3597,2313,1284,2519,1427,1092,475,*,*,1983
4/1/2023,VA,Virginia,Falls Church City,51610,2276,1692,584,2202,*,*,74,*,*,1841,1258,583,1255,735,520,130,*,*,1108
4/1/2023,VA,Virginia,Fauquier,51061,14092,10519,3573,13137,55,13082,955,36,919,12491,8919,3572,8898,5931,2967,1111,178,35,7574
4/1/2023,VA,Virginia,Floyd,51063,4466,2840,1626,3956,14,3942,510,*,*,4194,2569,1625,3496,1968,1528,681,106,22,2687
4/1/2023,VA,Virginia,Fluvanna,51065,7034,5113,1921,6417,27,6390,617,17,600,6453,4533,1920,5075,3368,1707,699,107,21,4248
4/1/2023,VA,Virginia,Franklin,51067,15941,9301,6640,13860,58,13802,2081,33,2048,15062,8422,6640,12827,6739,6088,2236,433,92,10066
4/1/2023,VA,Virginia,Franklin City,51620,2184,1288,896,1815,16,1799,369,17,352,2068,1172,896,1782,927,855,582,*,*,1136
4/1/2023,VA,Virginia,Frederick,51069,18932,13491,5441,17198,66,17132,1734,47,1687,17272,11834,5438,12977,8266,4711,1717,360,79,10821
4/1/2023,VA,Virginia,Fredericksburg City,51630,4452,2942,1510,3822,24,3798,630,24,606,4006,2497,1509,2938,1526,1412,879,87,22,1950
4/1/2023,VA,Virginia,Galax City,51640,1697,1139,558,1394,*,*,303,*,*,1615,1057,558,1385,861,524,561,47,14,763
4/1/2023,VA,Virginia,Giles,51071,4498,2730,1768,3706,12,3694,792,12,780,4267,2499,1768,3723,2152,1571,792,100,22,2809
4/1/2023,VA,Virginia,Gloucester,51073,9891,6774,3117,8830,41,8789,1061,21,1040,9219,6102,3117,6451,3622,2829,1172,165,43,5071
4/1/2023,VA,Virginia,Goochland,51075,7138,5039,2099,6698,30,6668,440,*,*,6590,4492,2098,5703,3836,1867,471,96,13,5123
4/1/2023,VA,Virginia,Grayson,51077,4690,2952,1738,3981,12,3969,709,*,*,4505,2767,1738,3719,2084,1635,951,162,59,2547
4/1/2023,VA,Virginia,Greene,51079,4454,3205,1249,3979,12,3967,475,*,*,4062,2813,1249,3160,2011,1149,541,88,14,2517
4/1/2023,VA,Virginia,Greensville,51081,2245,1140,1105,1858,19,1839,387,12,375,2080,975,1105,1796,784,1012,488,100,19,1189
4/1/2023,VA,Virginia,Halifax,51083,10094,6332,3762,8557,53,8504,1537,53,1484,9504,5742,3762,8027,4525,3502,2155,385,98,5389
4/1/2023,VA,Virginia,Hampton City,51650,26984,15053,11931,23035,208,22827,3949,176,3773,24772,12845,11927,16843,5854,10989,4546,741,111,11445
4/1/2023,VA,Virginia,Hanover,51085,24365,15885,8480,22605,90,22515,1760,46,1714,22463,13986,8477,19076,11576,7500,1733,287,47,17009
4/1/2023,VA,Virginia,Harrisonburg City,51660,5717,4031,1686,4955,23,4932,762,19,743,5271,3585,1686,4478,2911,1567,1088,136,31,3223
4/1/2023,VA,Virginia,Henrico,51087,62351,37498,24853,55892,364,55528,6459,280,6179,56943,32097,24846,49009,26175,22834,7864,1283,217,39645
4/1/2023,VA,Virginia,Henry,51089,14838,7513,7325,12177,84,12093,2661,66,2595,14114,6791,7323,12563,5638,6925,3256,657,126,8524
4/1/2023,VA,Virginia,Highland,51091,913,687,226,837,*,*,76,0,76,869,643,226,702,505,197,88,*,*,591
4/1/2023,VA,Virginia,Hopewell City,51670,4620,2601,2019,3726,26,3700,894,30,864,4284,2265,2019,3299,1378,1921,1176,136,23,1964
4/1/2023,VA,Virginia,Isle of Wight,51093,9379,6138,3241,8421,54,8367,958,34,924,8699,5460,3239,6459,3435,3024,1111,177,51,5120
4/1/2023,VA,Virginia,James City,51095,23083,17305,5778,21852,53,21799,1231,35,1196,21501,15728,5773,14901,10032,4869,1170,205,30,13496
4/1/2023,VA,Virginia,King and Queen,51097,1893,1204,689,1656,*,*,237,*,*,1790,1101,689,1443,822,621,317,*,*,1059
4/1/2023,VA,Virginia,King George,51099,4565,3353,1212,4061,24,4037,504,18,486,3983,2771,1212,2284,1165,1119,536,85,19,1644
4/1/2023,VA,Virginia,King William,51101,3873,2501,1372,3410,28,3382,463,17,446,3600,2230,1370,3053,1780,1273,475,91,16,2471
4/1/2023,VA,Virginia,Lancaster,51103,4447,3176,1271,4149,19,4130,298,*,*,4179,2909,1270,3271,2182,1089,504,*,*,2669
4/1/2023,VA,Virginia,Lee,51105,6405,2131,4274,4712,23,4689,1693,15,1678,6107,1835,4272,5257,1360,3897,1950,208,56,3043
4/1/2023,VA,Virginia,Lexington City,51678,1339,985,354,1235,12,1223,104,*,*,1239,886,353,1001,673,328,184,*,*,784
4/1/2023,VA,Virginia,Loudoun,51107,46676,32842,13834,44323,152,44171,2353,109,2244,39154,25333,13821,28447,16222,12225,4370,668,132,23277
4/1/2023,VA,Virginia,Louisa,51109,9764,6318,3446,8548,45,8503,1216,27,1189,8974,5528,3446,7137,4006,3131,1324,217,38,5558
4/1/2023,VA,Virginia,Lunenburg,51111,3259,1936,1323,2786,17,2769,473,*,*,3067,1744,1323,2511,1274,1237,808,111,21,1571
4/1/2023,VA,Virginia,Lynchburg City,51680,14966,8864,6102,12618,91,12527,2348,79,2269,13983,7881,6102,12042,6337,5705,3171,391,84,8396
4/1/2023,VA,Virginia,Madison,51113,3553,2527,1026,3220,*,*,333,*,*,3308,2283,1025,2594,1705,889,442,79,17,2056
4/1/2023,VA,Virginia,Manassas City,51683,5181,3344,1837,4723,21,4702,458,31,427,4398,2563,1835,3329,1668,1661,667,94,13,2555
4/1/2023,VA,Virginia,Manassas Park City,51685,1466,799,667,1289,17,1272,177,11,166,1264,597,667,998,373,625,255,*,*,695
4/1/2023,VA,Virginia,Martinsville City,51690,3797,1833,1964,2976,31,2945,821,27,794,3602,1639,1963,3206,1328,1878,1318,143,30,1715
4/1/2023,VA,Virginia,Mathews,51115,3065,2214,851,2829,16,2813,236,*,*,2885,2034,851,2206,1464,742,319,*,*,1836
4/1/2023,VA,Virginia,Mecklenburg,51117,9667,5845,3822,8273,53,8220,1394,40,1354,9104,5282,3822,7573,4059,3514,1867,383,61,5262
4/1/2023,VA,Virginia,Middlesex,51119,3803,2640,1163,3486,13,3473,317,*,*,3589,2426,1163,2861,1837,1024,490,*,*,2293
4/1/2023,VA,Virginia,Montgomery,51121,14892,10050,4842,12867,63,12804,2025,28,1997,13543,8702,4841,11685,7176,4509,2094,296,61,9234
4/1/2023,VA,Virginia,Nelson,51125,5006,3515,1491,4560,15,4545,446,*,*,4704,3213,1491,3646,2301,1345,614,94,21,2917
4/1/2023,VA,Virginia,New Kent,51127,5673,3914,1759,5187,25,5162,486,17,469,5231,3473,1758,3954,2459,1495,393,86,13,3462
4/1/2023,VA,Virginia,Newport News City,51700,30925,17143,13782,26081,205,25876,4844,209,4635,28504,14726,13778,20484,7574,12910,6180,853,124,13327
4/1/2023,VA,Virginia,Norfolk City,51710,35495,19322,16173,29775,268,29507,5720,296,5424,32205,16039,16166,23883,8539,15344,8565,1245,168,13905
4/1/2023,VA,Virginia,Northampton,51131,4034,2438,1596,3622,19,3603,412,22,390,3801,2205,1596,3202,1736,1466,934,78,18,2172
4/1/2023,VA,Virginia,Northumberland,51133,4944,3485,1459,4611,16,4595,333,13,320,4617,3158,1459,3429,2228,1201,511,71,12,2835
4/1/2023,VA,Virginia,Norton City,51720,1090,419,671,798,*,*,292,*,*,1026,355,671,912,295,617,351,*,*,506
4/1/2023,VA,Virginia,Nottoway,51135,3666,2231,1435,3081,19,3062,585,15,570,3436,2001,1435,2818,1494,1324,884,115,26,1793
4/1/2023,VA,Virginia,Orange,51137,9474,6498,2976,8535,46,8489,939,23,916,8668,5692,2976,6394,3767,2627,1098,199,41,5056
4/1/2023,VA,Virginia,Page,51139,6441,4430,2011,5466,22,5444,975,16,959,6036,4026,2010,4804,2967,1837,1184,227,42,3351
4/1/2023,VA,Virginia,Patrick,51141,5578,3200,2378,4755,19,4736,823,*,*,5304,2929,2375,4535,2315,2220,1105,175,45,3210
4/1/2023,VA,Virginia,Petersburg City,51730,7154,3329,3825,5549,80,5469,1605,77,1528,6607,2785,3822,5332,1690,3642,2380,280,47,2625
4/1/2023,VA,Virginia,Pittsylvania,51143,17068,9311,7757,14485,103,14382,2583,65,2518,16184,8429,7755,14096,7776,6320,3325,492,108,10171
4/1/2023,VA,Virginia,Poquoson City,51735,2729,2123,606,2570,*,*,159,*,*,2508,1902,606,1453,902,551,135,*,*,1286
4/1/2023,VA,Virginia,Portsmouth City,51740,18922,10129,8793,15346,160,15186,3576,172,3404,17178,8387,8791,12521,4143,8378,4553,676,89,7203
4/1/2023,VA,Virginia,Powhatan,51145,7009,4848,2161,6461,13,6448,548,13,535,6506,4345,2161,5451,3508,1943,481,94,20,4856
4/1/2023,VA,Virginia,Prince Edward,51147,4889,2962,1927,4100,32,4068,789,26,763,4552,2625,1927,3782,1985,1797,1114,153,37,2478
4/1/2023,VA,Virginia,Prince George,51149,6824,4826,1998,5891,25,5866,933,31,902,6342,4345,1997,4255,2448,1807,735,120,24,3376
4/1/2023,VA,Virginia,Prince William,51153,57448,38539,18909,52642,278,52364,4806,257,4549,49452,30551,18901,31954,14747,17207,6873,1114,170,23797
4/1/2023,VA,Virginia,Pulaski,51155,9232,5355,3877,7605,31,7574,1627,28,1599,8633,4757,3876,7401,3811,3590,1659,248,49,5445
4/1/2023,VA,Virginia,Radford City,51750,2176,1375,801,1817,*,*,359,12,347,1982,1181,801,1738,982,756,372,48,14,1304
4/1/2023,VA,Virginia,Rappahannock,51157,2154,1644,510,2034,*,*,120,*,*,1960,1451,509,1464,1042,422,169,*,*,1252
4/1/2023,VA,Virginia,Richmond,51159,2041,1332,709,1818,11,1807,223,*,*,1909,1200,709,1531,918,613,373,54,11,1093
4/1/2023,VA,Virginia,Richmond City,51760,35124,17626,17498,29299,273,29026,5825,236,5589,32089,14596,17493,28413,11747,16666,9608,1178,155,17472
4/1/2023,VA,Virginia,Roanoke,51161,24934,16069,8865,22517,94,22423,2417,49,2368,23139,14280,8859,19600,11623,7977,2365,437,98,16700
4/1/2023,VA,Virginia,Roanoke City,51770,21308,11058,10250,17073,128,16945,4235,126,4109,19626,9377,10249,16909,7290,9619,5153,833,143,10780
4/1/2023,VA,Virginia,Rockbridge,51163,6802,4679,2123,5950,16,5934,852,*,*,6356,4234,2122,5077,3144,1933,970,167,45,3895
4/1/2023,VA,Virginia,Rockingham,51165,19334,13974,5360,17448,51,17397,1886,30,1856,18017,12658,5359,15058,10167,4891,1991,432,91,12544
4/1/2023,VA,Virginia,Russell,51167,7961,3103,4858,5966,17,5949,1995,19,1976,7660,2804,4856,6818,2944,3874,1767,291,65,4695
4/1/2023,VA,Virginia,Salem City,51775,6176,3992,2184,5405,30,5375,771,18,753,5683,3500,2183,4786,2758,2028,823,108,28,3827
4/1/2023,VA,Virginia,Scott,51169,6708,2172,4536,5276,11,5265,1432,11,1421,6442,1907,4535,5778,1498,4280,1568,239,75,3896
4/1/2023,VA,Virginia,Shenandoah,51171,11255,7762,3493,10199,25,10174,1056,16,1040,10549,7058,3491,8177,5088,3089,1369,267,49,6492
4/1/2023,VA,Virginia,Smyth,51173,8522,4522,4000,6635,20,6615,1887,20,1867,8109,4109,4000,6959,3178,3781,2139,305,81,4434
4/1/2023,VA,Virginia,Southampton,51175,4254,2754,1500,3674,32,3642,580,23,557,3970,2470,1500,3257,1870,1387,745,131,22,2359
4/1/2023,VA,Virginia,Spotsylvania,51177,24804,16698,8106,22212,119,22093,2592,94,2498,22118,14016,8102,14738,7396,7342,2606,480,83,11569
4/1/2023,VA,Virginia,Stafford,51179,20818,15094,5724,18880,114,18766,1938,88,1850,18366,12646,5720,10599,5497,5102,1900,386,60,8253
4/1/2023,VA,Virginia,Staunton City,51790,6434,4409,2025,5533,26,5507,901,16,885,6080,4055,2025,5039,3162,1877,1173,126,37,3703
4/1/2023,VA,Virginia,Suffolk City,51800,18705,11589,7116,15949,137,15812,2756,117,2639,17228,10115,7113,12223,5584,6639,3087,485,65,8586
4/1/2023,VA,Virginia,Surry,51181,1867,1115,752,1646,15,1631,221,*,*,1725,973,752,1372,655,717,262,*,*,1053
4/1/2023,VA,Virginia,Sussex,51183,2543,1364,1179,2144,14,2130,399,16,383,2390,1213,1177,1980,875,1105,548,127,16,1289
4/1/2023,VA,Virginia,Tazewell,51185,11860,5789,6071,9234,34,9200,2626,32,2594,11342,5272,6070,9514,4623,4891,2437,451,92,6534
4/1/2023,VA,Virginia,Unknown,51999,*,*,*,*,*,*,*,*,*,*,*,*,*,*,*,*,*,*,*
4/1/2023,VA,Virginia,Virginia Beach City,51810,80605,55144,25461,72841,358,72483,7764,311,7453,74232,48786,25446,46822,23549,23273,8335,1457,252,36778
4/1/2023,VA,Virginia,Warren,51187,8803,5976,2827,7827,20,7807,976,20,956,8072,5245,2827,6023,3585,2438,1111,191,56,4665
4/1/2023,VA,Virginia,Washington,51191,15648,7610,8038,13101,27,13074,2547,26,2521,14874,6837,8037,12827,5444,7383,2602,538,99,9588
4/1/2023,VA,Virginia,Waynesboro City,51820,5176,3486,1690,4435,22,4413,741,17,724,4870,3180,1690,4092,2477,1615,937,108,30,3017
4/1/2023,VA,Virginia,Westmoreland,51193,5553,3836,1717,5006,24,4982,547,19,528,5057,3340,1717,3609,2054,1555,869,139,29,2572
4/1/2023,VA,Virginia,Williamsburg City,51830,3124,2169,955,2871,*,*,253,*,*,2887,1932,955,2178,1325,853,318,*,*,1816
4/1/2023,VA,Virginia,Winchester City,51840,5682,3978,1704,4950,19,4931,732,21,711,5198,3494,1704,4064,2537,1527,986,128,29,2921
4/1/2023,VA,Virginia,Wise,51195,10512,3609,6903,7583,26,7557,2929,30,2899,9999,3097,6902,8461,2478,5983,2554,435,93,5379
4/1/2023,VA,Virginia,Wythe,51197,8106,4300,3806,6525,32,6493,1581,14,1567,7690,3884,3806,6604,3061,3543,1745,290,50,4519
4/1/2023,VA,Virginia,York,51199,13611,10166,3445,12660,38,12622,951,40,911,12496,9051,3445,7244,4175,3069,865,154,26,6199
2/1/2023,VA,Virginia,Accomack,51001,9802,6467,3335,8654,49,8605,1148,40,1108,9083,5751,3332,7144,4181,2963,1751,348,64,4981
2/1/2023,VA,Virginia,Albemarle,51003,24141,19069,5072,22649,54,22595,1492,53,1439,21949,16881,5068,17800,13270,4530,1848,281,61,15610
2/1/2023,VA,Virginia,Alexandria City,51510,19399,14099,5300,18162,80,18082,1237,69,1168,15854,10560,5294,10698,5821,4877,2422,301,47,7928
2/1/2023,VA,Virginia,Alleghany,51005,4677,3058,1619,3884,18,3866,793,11,782,4450,2831,1619,3806,2369,1437,901,106,37,2762
2/1/2023,VA,Virginia,Amelia,51007,3364,1975,1389,2943,*,*,421,*,*,3119,1730,1389,2613,1303,1310,492,90,18,2013
2/1/2023,VA,Virginia,Amherst,51009,8234,5023,3211,7086,50,7036,1148,30,1118,7732,4521,3211,6597,3612,2985,1357,224,57,4959
2/1/2023,VA,Virginia,Appomattox,51011,4316,2702,1614,3621,20,3601,695,26,669,4046,2434,1612,3441,1944,1497,831,100,35,2475
2/1/2023,VA,Virginia,Arlington,51013,26357,19306,7051,24917,104,24813,1440,68,1372,20994,13945,7049,14146,7547,6599,3331,380,97,10338
2/1/2023,VA,Virginia,Augusta,51015,19770,14025,5745,17584,64,17520,2186,38,2148,18644,12899,5745,15476,10143,5333,2199,396,129,12752
2/1/2023,VA,Virginia,Bath,51017,1335,1020,315,1193,*,*,142,*,*,1278,964,314,1062,773,289,166,31,14,851
2/1/2023,VA,Virginia,Bedford,51019,21692,14180,7512,19197,65,19132,2495,47,2448,20321,12809,7512,16920,10306,6614,2302,477,128,14013
2/1/2023,VA,Virginia,Bland,51021,1863,1105,758,1543,*,*,320,*,*,1758,1000,758,1435,791,644,233,53,11,1138
2/1/2023,VA,Virginia,Botetourt,51023,9280,5965,3315,8312,41,8271,968,19,949,8682,5367,3315,7212,4268,2944,818,162,36,6196
2/1/2023,VA,Virginia,Bristol City,51520,4443,1763,2680,3571,*,*,872,13,859,4189,1509,2680,3720,1157,2563,1132,140,28,2420
2/1/2023,VA,Virginia,Brunswick,51025,4252,2386,1866,3641,28,3613,611,17,594,3998,2132,1866,3351,1618,1733,1096,128,20,2107
2/1/2023,VA,Virginia,Buchanan,51027,6803,2667,4136,4691,19,4672,2112,14,2098,6554,2419,4135,5771,2447,3324,1655,356,73,3687
2/1/2023,VA,Virginia,Buckingham,51029,3892,2339,1553,3287,25,3262,605,18,587,3636,2084,1552,2995,1600,1395,871,132,30,1962
2/1/2023,VA,Virginia,Buena Vista City,51530,1478,907,571,1218,*,*,260,*,*,1380,809,571,1130,608,522,331,41,19,739
2/1/2023,VA,Virginia,Campbell,51031,13645,8193,5452,11702,74,11628,1943,56,1887,12813,7364,5449,11034,6029,5005,2294,367,113,8260
2/1/2023,VA,Virginia,Caroline,51033,6511,4020,2491,5676,28,5648,835,37,798,5919,3429,2490,4442,2162,2280,986,179,34,3243
2/1/2023,VA,Virginia,Carroll,51035,8768,5638,3130,7435,34,7401,1333,15,1318,8399,5269,3130,6969,4069,2900,1650,287,64,4968
2/1/2023,VA,Virginia,Charles City,51036,2046,1198,848,1803,18,1785,243,*,*,1887,1039,848,1539,772,767,292,75,11,1161
2/1/2023,VA,Virginia,Charlotte,51037,3243,2062,1181,2734,20,2714,509,13,496,3036,1855,1181,2535,1448,1087,716,125,21,1673
2/1/2023,VA,Virginia,Charlottesville City,51540,6331,4586,1745,5539,33,5506,792,26,766,5741,4000,1741,4870,3222,1648,1163,140,15,3552
2/1/2023,VA,Virginia,Chesapeake City,51550,43421,28192,15229,38527,274,38253,4894,177,4717,39444,24220,15224,25789,11767,14022,5011,944,171,19663
2/1/2023,VA,Virginia,Chesterfield,51041,69136,44160,24976,62338,246,62092,6798,219,6579,62938,37978,24960,51518,28567,22951,6867,966,191,43494
2/1/2023,VA,Virginia,Clarke,51043,3779,2838,941,3549,*,*,230,*,*,3423,2482,941,2531,1733,798,315,66,25,2125
2/1/2023,VA,Virginia,Colonial Heights City,51570,4104,2808,1296,3561,19,3542,543,11,532,3777,2481,1296,2709,1524,1185,574,102,14,2019
2/1/2023,VA,Virginia,Covington City,51580,1530,961,569,1187,*,*,343,*,*,1423,854,569,1223,676,547,359,*,*,808
2/1/2023,VA,Virginia,Craig,51045,1402,824,578,1156,*,*,246,*,*,1322,744,578,1113,589,524,221,*,*,837
2/1/2023,VA,Virginia,Culpeper,51047,10495,7393,3102,9381,43,9338,1114,30,1084,9550,6448,3102,7276,4637,2639,1357,233,58,5628
2/1/2023,VA,Virginia,Cumberland,51049,2416,1440,976,2075,12,2063,341,*,*,2248,1272,976,1892,989,903,472,85,19,1316
2/1/2023,VA,Virginia,Danville City,51590,11046,5427,5619,8984,89,8895,2062,96,1966,10427,4809,5618,9276,4586,4690,3444,391,89,5352
2/1/2023,VA,Virginia,Dickenson,51051,4804,1468,3336,3351,11,3340,1453,*,*,4619,1285,3334,4032,1251,2781,1136,204,37,2655
2/1/2023,VA,Virginia,Dinwiddie,51053,6360,3745,2615,5377,33,5344,983,30,953,5925,3310,2615,4733,2284,2449,1027,190,33,3483
2/1/2023,VA,Virginia,Emporia City,51595,1309,637,672,1068,14,1054,241,12,229,1226,554,672,1072,448,624,476,*,*,532
2/1/2023,VA,Virginia,Essex,51057,3121,1957,1164,2734,18,2716,387,13,374,2912,1749,1163,2357,1330,1027,522,81,30,1724
2/1/2023,VA,Virginia,Fairfax,51059,168778,119780,48998,161203,599,160604,7575,368,7207,137961,89007,48954,91421,48177,43244,16904,2518,479,71520
2/1/2023,VA,Virginia,Fairfax City,51600,4307,3045,1262,4076,15,4061,231,11,220,3589,2329,1260,2513,1445,1068,472,*,*,1975
2/1/2023,VA,Virginia,Falls Church City,51610,2269,1692,577,2195,*,*,74,*,*,1824,1247,577,1238,725,513,127,*,*,1095
2/1/2023,VA,Virginia,Fauquier,51061,14055,10515,3540,13108,56,13052,947,35,912,12438,8902,3536,8861,5933,2928,1087,177,40,7557
2/1/2023,VA,Virginia,Floyd,51063,4453,2840,1613,3944,14,3930,509,*,*,4167,2555,1612,3481,1964,1517,678,109,24,2670
2/1/2023,VA,Virginia,Fluvanna,51065,7011,5107,1904,6398,27,6371,613,17,596,6422,4520,1902,5047,3364,1683,694,112,24,4217
2/1/2023,VA,Virginia,Franklin,51067,15941,9335,6606,13867,59,13808,2074,33,2041,15046,8440,6606,12813,6763,6050,2237,446,107,10023
2/1/2023,VA,Virginia,Franklin City,51620,2190,1304,886,1823,17,1806,367,17,350,2073,1187,886,1783,937,846,578,*,*,1136
2/1/2023,VA,Virginia,Frederick,51069,18870,13465,5405,17151,66,17085,1719,47,1672,17192,11792,5400,12906,8240,4666,1688,365,93,10760
2/1/2023,VA,Virginia,Fredericksburg City,51630,4458,2963,1495,3828,24,3804,630,24,606,3998,2504,1494,2929,1531,1398,875,90,24,1940
2/1/2023,VA,Virginia,Galax City,51640,1695,1143,552,1395,*,*,300,*,*,1615,1063,552,1382,865,517,554,49,16,763
2/1/2023,VA,Virginia,Giles,51071,4511,2752,1759,3717,12,3705,794,15,779,4268,2509,1759,3713,2156,1557,787,101,25,2800
2/1/2023,VA,Virginia,Gloucester,51073,9831,6761,3070,8780,41,8739,1051,21,1030,9151,6081,3070,6396,3610,2786,1149,169,50,5028
2/1/2023,VA,Virginia,Goochland,51075,7115,5036,2079,6678,33,6645,437,*,*,6560,4481,2079,5675,3830,1845,475,97,14,5089
2/1/2023,VA,Virginia,Grayson,51077,4701,2961,1740,3993,14,3979,708,*,*,4512,2773,1739,3721,2087,1634,949,166,63,2543
2/1/2023,VA,Virginia,Greene,51079,4459,3218,1241,3985,14,3971,474,*,*,4059,2819,1240,3151,2007,1144,533,90,15,2513
2/1/2023,VA,Virginia,Greensville,51081,2241,1140,1101,1858,19,1839,383,11,372,2074,974,1100,1788,780,1008,482,102,21,1183
2/1/2023,VA,Virginia,Halifax,51083,10094,6342,3752,8565,55,8510,1529,53,1476,9507,5756,3751,8059,4562,3497,2158,395,111,5395
2/1/2023,VA,Virginia,Hampton City,51650,26947,15148,11799,23035,224,22811,3912,182,3730,24692,12899,11793,16788,5899,10889,4483,764,123,11418
2/1/2023,VA,Virginia,Hanover,51085,24309,15884,8425,22552,94,22458,1757,48,1709,22356,13940,8416,19001,11554,7447,1725,294,60,16922
2/1/2023,VA,Virginia,Harrisonburg City,51660,5713,4045,1668,4953,24,4929,760,19,741,5261,3594,1667,4475,2927,1548,1082,137,38,3218
2/1/2023,VA,Virginia,Henrico,51087,62248,37525,24723,55822,376,55446,6426,282,6144,56743,32032,24711,48847,26145,22702,7803,1315,245,39484
2/1/2023,VA,Virginia,Henry,51089,14833,7561,7272,12186,86,12100,2647,66,2581,14106,6836,7270,12567,5689,6878,3231,675,145,8516
2/1/2023,VA,Virginia,Highland,51091,907,683,224,832,*,*,75,0,75,864,640,224,699,501,198,85,*,*,590
2/1/2023,VA,Virginia,Hopewell City,51670,4615,2616,1999,3724,28,3696,891,31,860,4280,2281,1999,3284,1381,1903,1156,138,25,1965
2/1/2023,VA,Virginia,Isle of Wight,51093,9370,6169,3201,8415,57,8358,955,34,921,8686,5487,3199,6440,3454,2986,1105,179,56,5100
2/1/2023,VA,Virginia,James City,51095,23072,17313,5759,21852,56,21796,1220,35,1185,21454,15701,5753,14886,10041,4845,1146,208,38,13494
2/1/2023,VA,Virginia,King and Queen,51097,1896,1212,684,1660,*,*,236,*,*,1787,1103,684,1441,823,618,313,*,*,1063
2/1/2023,VA,Virginia,King George,51099,4552,3351,1201,4048,24,4024,504,18,486,3961,2761,1200,2270,1162,1108,524,83,20,1643
2/1/2023,VA,Virginia,King William,51101,3881,2516,1365,3421,30,3391,460,18,442,3613,2248,1365,3059,1795,1264,471,92,17,2479
2/1/2023,VA,Virginia,Lancaster,51103,4469,3203,1266,4168,20,4148,301,*,*,4193,2929,1264,3282,2200,1082,507,91,13,2671
2/1/2023,VA,Virginia,Lee,51105,6442,2174,4268,4760,24,4736,1682,15,1667,6140,1876,4264,5282,1398,3884,1967,214,57,3044
2/1/2023,VA,Virginia,Lexington City,51678,1343,992,351,1237,12,1225,106,*,*,1240,890,350,1004,679,325,183,*,*,784
2/1/2023,VA,Virginia,Loudoun,51107,46500,32790,13710,44162,157,44005,2338,112,2226,38927,25234,13693,28269,16167,12102,4300,675,139,23155
2/1/2023,VA,Virginia,Louisa,51109,9724,6313,3411,8518,48,8470,1206,27,1179,8929,5519,3410,7103,4013,3090,1309,220,50,5524
2/1/2023,VA,Virginia,Lunenburg,51111,3261,1948,1313,2790,17,2773,471,*,*,3074,1762,1312,2514,1286,1228,802,118,25,1569
2/1/2023,VA,Virginia,Lynchburg City,51680,14963,8938,6025,12633,93,12540,2330,79,2251,13974,7950,6024,12058,6425,5633,3147,403,106,8402
2/1/2023,VA,Virginia,Madison,51113,3559,2537,1022,3227,*,*,332,*,*,3307,2286,1021,2591,1707,884,439,82,18,2052
2/1/2023,VA,Virginia,Manassas City,51683,5157,3349,1808,4706,21,4685,451,32,419,4377,2571,1806,3304,1668,1636,657,94,16,2537
2/1/2023,VA,Virginia,Manassas Park City,51685,1459,811,648,1282,17,1265,177,11,166,1250,602,648,985,378,607,255,*,*,678
2/1/2023,VA,Virginia,Martinsville City,51690,3801,1868,1933,2980,32,2948,821,27,794,3599,1666,1933,3200,1352,1848,1309,147,32,1712
2/1/2023,VA,Virginia,Mathews,51115,3056,2200,856,2818,17,2801,238,*,*,2876,2020,856,2210,1464,746,320,44,12,1834
2/1/2023,VA,Virginia,Mecklenburg,51117,9647,5865,3782,8254,54,8200,1393,40,1353,9081,5300,3781,7554,4079,3475,1863,384,66,5241
2/1/2023,VA,Virginia,Middlesex,51119,3800,2650,1150,3485,13,3472,315,*,*,3581,2431,1150,2850,1844,1006,486,70,12,2282
2/1/2023,VA,Virginia,Montgomery,51121,14899,10086,4813,12878,66,12812,2021,28,1993,13549,8738,4811,11693,7208,4485,2092,302,67,9232
2/1/2023,VA,Virginia,Nelson,51125,5004,3523,1481,4558,17,4541,446,*,*,4690,3210,1480,3644,2309,1335,607,100,20,2917
2/1/2023,VA,Virginia,New Kent,51127,5632,3888,1744,5152,25,5127,480,16,464,5185,3441,1744,3928,2448,1480,386,85,16,3441
2/1/2023,VA,Virginia,Newport News City,51700,30846,17222,13624,26035,210,25825,4811,214,4597,28370,14755,13615,20378,7610,12768,6101,872,150,13255
2/1/2023,VA,Virginia,Norfolk City,51710,35454,19447,16007,29760,278,29482,5694,302,5392,32114,16114,16000,23800,8605,15195,8483,1277,200,13840
2/1/2023,VA,Virginia,Northampton,51131,4027,2459,1568,3617,20,3597,410,22,388,3779,2211,1568,3191,1752,1439,932,81,19,2159
2/1/2023,VA,Virginia,Northumberland,51133,4938,3490,1448,4607,17,4590,331,13,318,4606,3158,1448,3421,2231,1190,503,75,16,2827
2/1/2023,VA,Virginia,Norton City,51720,1089,425,664,797,*,*,292,*,*,1022,358,664,909,298,611,349,*,*,503
2/1/2023,VA,Virginia,Nottoway,51135,3656,2251,1405,3071,21,3050,585,15,570,3421,2016,1405,2809,1509,1300,871,120,32,1786
2/1/2023,VA,Virginia,Orange,51137,9444,6495,2949,8512,46,8466,932,23,909,8641,5692,2949,6365,3766,2599,1087,200,44,5034
2/1/2023,VA,Virginia,Page,51139,6444,4457,1987,5474,22,5452,970,17,953,6033,4046,1987,4805,2989,1816,1179,233,46,3347
2/1/2023,VA,Virginia,Patrick,51141,5573,3230,2343,4749,19,4730,824,*,*,5301,2961,2340,4525,2332,2193,1100,181,46,3198
2/1/2023,VA,Virginia,Petersburg City,51730,7145,3364,3781,5550,84,5466,1595,77,1518,6591,2811,3780,5323,1722,3601,2354,287,55,2627
2/1/2023,VA,Virginia,Pittsylvania,51143,17061,9350,7711,14494,105,14389,2567,65,2502,16161,8450,7711,14083,7813,6270,3296,510,127,10150
2/1/2023,VA,Virginia,Poquoson City,51735,2717,2117,600,2559,*,*,158,*,*,2488,1888,600,1446,900,546,129,*,*,1284
2/1/2023,VA,Virginia,Portsmouth City,51740,18931,10241,8690,15362,172,15190,3569,178,3391,17151,8466,8685,12513,4236,8277,4522,705,102,7184
2/1/2023,VA,Virginia,Powhatan,51145,6999,4852,2147,6457,14,6443,542,13,529,6478,4332,2146,5429,3500,1929,474,99,23,4833
2/1/2023,VA,Virginia,Prince Edward,51147,4880,2960,1920,4094,33,4061,786,26,760,4546,2626,1920,3772,1982,1790,1113,155,41,2463
2/1/2023,VA,Virginia,Prince George,51149,6794,4822,1972,5866,25,5841,928,31,897,6302,4330,1972,4220,2438,1782,731,122,27,3340
2/1/2023,VA,Virginia,Prince William,51153,57215,38607,18608,52446,285,52161,4769,259,4510,49106,30512,18594,31654,14756,16898,6714,1145,195,23600
2/1/2023,VA,Virginia,Pulaski,51155,9245,5399,3846,7616,33,7583,1629,28,1601,8646,4800,3846,7392,3835,3557,1647,251,61,5433
2/1/2023,VA,Virginia,Radford City,51750,2178,1383,795,1817,*,*,361,13,348,1980,1185,795,1741,992,749,373,50,17,1301
2/1/2023,VA,Virginia,Rappahannock,51157,2150,1640,510,2029,*,*,121,*,*,1955,1446,509,1462,1039,423,169,36,11,1246
2/1/2023,VA,Virginia,Richmond,51159,2052,1351,701,1828,11,1817,224,*,*,1912,1212,700,1535,931,604,378,59,12,1086
2/1/2023,VA,Virginia,Richmond City,51760,35119,17733,17386,29314,288,29026,5805,237,5568,32013,14638,17375,28348,11784,16564,9555,1211,182,17400
2/1/2023,VA,Virginia,Roanoke,51161,24943,16106,8837,22536,97,22439,2407,50,2357,23128,14297,8831,19589,11646,7943,2347,448,111,16683
2/1/2023,VA,Virginia,Roanoke City,51770,21335,11143,10192,17119,135,16984,4216,124,4092,19639,9450,10189,16927,7365,9562,5121,851,154,10801
2/1/2023,VA,Virginia,Rockbridge,51163,6781,4687,2094,5938,16,5922,843,*,*,6332,4238,2094,5060,3157,1903,954,171,47,3888
2/1/2023,VA,Virginia,Rockingham,51165,19301,14000,5301,17425,52,17373,1876,33,1843,17967,12666,5301,15026,10194,4832,1966,440,108,12512
2/1/2023,VA,Virginia,Russell,51167,7969,3121,4848,5984,20,5964,1985,19,1966,7662,2817,4845,6815,2970,3845,1764,300,78,4673
2/1/2023,VA,Virginia,Salem City,51775,6176,4009,2167,5405,31,5374,771,18,753,5674,3508,2166,4771,2763,2008,812,115,30,3814
2/1/2023,VA,Virginia,Scott,51169,6719,2197,4522,5296,11,5285,1423,11,1412,6447,1926,4521,5784,1518,4266,1571,243,75,3895
2/1/2023,VA,Virginia,Shenandoah,51171,11252,7777,3475,10193,25,10168,1059,17,1042,10541,7067,3474,8180,5109,3071,1378,272,62,6468
2/1/2023,VA,Virginia,Smyth,51173,8539,4574,3965,6655,21,6634,1884,20,1864,8120,4155,3965,6970,3224,3746,2132,309,96,4433
2/1/2023,VA,Virginia,Southampton,51175,4244,2762,1482,3668,32,3636,576,23,553,3952,2470,1482,3245,1880,1365,740,130,26,2349
2/1/2023,VA,Virginia,Spotsylvania,51177,24771,16738,8033,22195,124,22071,2576,94,2482,22064,14035,8029,14710,7430,7280,2579,489,103,11539
2/1/2023,VA,Virginia,Stafford,51179,20707,15066,5641,18789,122,18667,1918,88,1830,18245,12616,5629,10533,5506,5027,1873,386,70,8204
2/1/2023,VA,Virginia,Staunton City,51790,6442,4435,2007,5541,26,5515,901,16,885,6084,4077,2007,5040,3177,1863,1168,126,45,3701
2/1/2023,VA,Virginia,Suffolk City,51800,18654,11620,7034,15910,142,15768,2744,118,2626,17162,10131,7031,12191,5632,6559,3061,491,79,8560
2/1/2023,VA,Virginia,Surry,51181,1857,1115,742,1637,15,1622,220,*,*,1713,971,742,1361,654,707,259,50,12,1040
2/1/2023,VA,Virginia,Sussex,51183,2547,1382,1165,2150,16,2134,397,16,381,2394,1229,1165,1977,887,1090,543,131,17,1286
2/1/2023,VA,Virginia,Tazewell,51185,11881,5837,6044,9264,36,9228,2617,32,2585,11356,5319,6037,9534,4673,4861,2430,466,102,6536
2/1/2023,VA,Virginia,Unknown,51999,*,*,*,*,*,*,*,*,*,*,*,*,*,*,*,*,*,*,*
2/1/2023,VA,Virginia,Virginia Beach City,51810,80358,55129,25229,72631,370,72261,7727,309,7418,73900,48693,25207,46623,23561,23062,8204,1519,288,36612
2/1/2023,VA,Virginia,Warren,51187,8793,5992,2801,7822,23,7799,971,20,951,8026,5227,2799,5999,3587,2412,1090,193,61,4655
2/1/2023,VA,Virginia,Washington,51191,15654,7634,8020,13120,29,13091,2534,27,2507,14863,6847,8016,12819,5460,7359,2589,556,117,9557
2/1/2023,VA,Virginia,Waynesboro City,51820,5191,3498,1693,4454,23,4431,737,16,721,4870,3179,1691,4109,2488,1621,937,114,37,3021
2/1/2023,VA,Virginia,Westmoreland,51193,5551,3846,1705,5007,27,4980,544,19,525,5048,3343,1705,3593,2053,1540,866,141,31,2555
2/1/2023,VA,Virginia,Williamsburg City,51830,3124,2171,953,2873,*,*,251,*,*,2889,1936,953,2182,1328,854,320,*,*,1816
2/1/2023,VA,Virginia,Winchester City,51840,5680,3982,1698,4953,20,4933,727,21,706,5194,3497,1697,4062,2541,1521,981,133,32,2916
2/1/2023,VA,Virginia,Wise,51195,10525,3646,6879,7614,28,7586,2911,31,2880,10000,3123,6877,8455,2502,5953,2541,442,107,5365
2/1/2023,VA,Virginia,Wythe,51197,8084,4312,3772,6512,33,6479,1572,14,1558,7665,3894,3771,6587,3078,3509,1727,294,63,4503
2/1/2023,VA,Virginia,York,51199,13543,10139,3404,12591,41,12550,952,42,910,12437,9033,3404,7212,4177,3035,858,156,36,6162
1/1/2023,VA,Virginia,Accomack,51001,9795,6469,3326,8652,50,8602,1143,40,1103,9057,5733,3324,7139,4184,2955,1745,349,65,4980
1/1/2023,VA,Virginia,Albemarle,51003,24116,19057,5059,22632,55,22577,1484,53,1431,21869,16813,5056,17746,13232,4514,1834,283,63,15566
1/1/2023,VA,Virginia,Alexandria City,51510,19409,14116,5293,18172,81,18091,1237,70,1167,15786,10495,5291,10693,5819,4874,2406,305,49,7933
1/1/2023,VA,Virginia,Alleghany,51005,4669,3058,1611,3884,19,3865,785,11,774,4435,2824,1611,3798,2370,1428,895,113,33,2757
1/1/2023,VA,Virginia,Amelia,51007,3372,1992,1380,2948,*,*,424,11,413,3123,1743,1380,2610,1310,1300,494,90,18,2008
1/1/2023,VA,Virginia,Amherst,51009,8234,5032,3202,7089,52,7037,1145,30,1115,7715,4513,3202,6575,3599,2976,1349,222,59,4945
1/1/2023,VA,Virginia,Appomattox,51011,4312,2702,1610,3617,20,3597,695,27,668,4033,2424,1609,3436,1943,1493,826,101,34,2475
1/1/2023,VA,Virginia,Arlington,51013,26327,19306,7021,24884,106,24778,1443,70,1373,20893,13874,7019,14090,7527,6563,3308,374,98,10310
1/1/2023,VA,Virginia,Augusta,51015,19770,14040,5730,17590,65,17525,2180,39,2141,18629,12899,5730,15453,10142,5311,2187,398,128,12740
1/1/2023,VA,Virginia,Bath,51017,1335,1025,310,1194,*,*,141,*,*,1276,966,310,1060,775,285,167,31,14,848
1/1/2023,VA,Virginia,Bedford,51019,21693,14189,7504,19193,66,19127,2500,49,2451,20287,12783,7504,16908,10307,6601,2287,481,131,14009
1/1/2023,VA,Virginia,Bland,51021,1859,1109,750,1540,*,*,319,*,*,1749,999,750,1430,794,636,233,53,11,1133
1/1/2023,VA,Virginia,Botetourt,51023,9292,5974,3318,8323,43,8280,969,20,949,8678,5360,3318,7212,4268,2944,815,163,37,6197
1/1/2023,VA,Virginia,Bristol City,51520,4457,1774,2683,3584,*,*,873,13,860,4199,1516,2683,3726,1162,2564,1127,144,30,2425
1/1/2023,VA,Virginia,Brunswick,51025,4246,2388,1858,3637,29,3608,609,16,593,3985,2127,1858,3340,1614,1726,1089,129,20,2102
1/1/2023,VA,Virginia,Buchanan,51027,6799,2675,4124,4694,20,4674,2105,14,2091,6543,2420,4123,5760,2445,3315,1643,360,73,3684
1/1/2023,VA,Virginia,Buckingham,51029,3893,2355,1538,3290,25,3265,603,17,586,3632,2096,1536,2990,1609,1381,870,135,30,1955
1/1/2023,VA,Virginia,Buena Vista City,51530,1480,917,563,1222,*,*,258,*,*,1379,816,563,1126,612,514,327,42,19,738
1/1/2023,VA,Virginia,Campbell,51031,13643,8225,5418,11707,76,11631,1936,56,1880,12794,7376,5418,11029,6053,4976,2277,371,112,8269
1/1/2023,VA,Virginia,Caroline,51033,6505,4034,2471,5673,28,5645,832,36,796,5887,3417,2470,4420,2158,2262,978,176,35,3231
1/1/2023,VA,Virginia,Carroll,51035,8781,5666,3115,7451,34,7417,1330,15,1315,8407,5292,3115,6973,4088,2885,1647,291,65,4970
1/1/2023,VA,Virginia,Charles City,51036,2050,1206,844,1807,18,1789,243,*,*,1881,1037,844,1540,775,765,289,77,11,1163
1/1/2023,VA,Virginia,Charlotte,51037,3247,2069,1178,2737,20,2717,510,13,497,3040,1862,1178,2538,1452,1086,711,127,19,1681
1/1/2023,VA,Virginia,Charlottesville City,51540,6332,4598,1734,5542,33,5509,790,27,763,5720,3990,1730,4861,3225,1636,1159,140,16,3546
1/1/2023,VA,Virginia,Chesapeake City,51550,43392,28238,15154,38522,279,38243,4870,178,4692,39296,24144,15152,25720,11772,13948,4974,951,170,19625
1/1/2023,VA,Virginia,Chesterfield,51041,69108,44187,24921,62321,250,62071,6787,221,6566,62760,37850,24910,51422,28522,22900,6819,974,198,43431
1/1/2023,VA,Virginia,Clarke,51043,3779,2840,939,3549,*,*,230,*,*,3410,2471,939,2524,1729,795,312,67,25,2120
1/1/2023,VA,Virginia,Colonial Heights City,51570,4104,2812,1292,3565,19,3546,539,11,528,3766,2474,1292,2706,1526,1180,567,102,15,2022
1/1/2023,VA,Virginia,Covington City,51580,1538,966,572,1195,*,*,343,*,*,1432,860,572,1226,677,549,361,*,*,811
1/1/2023,VA,Virginia,Craig,51045,1403,827,576,1158,*,*,245,*,*,1320,744,576,1110,587,523,217,*,*,835
1/1/2023,VA,Virginia,Culpeper,51047,10504,7444,3060,9390,44,9346,1114,31,1083,9540,6481,3059,7266,4672,2594,1351,234,57,5624
1/1/2023,VA,Virginia,Cumberland,51049,2413,1436,977,2070,12,2058,343,*,*,2243,1266,977,1891,988,903,476,85,19,1311
1/1/2023,VA,Virginia,Danville City,51590,11078,5481,5597,9017,89,8928,2061,97,1964,10439,4843,5596,9278,4615,4663,3441,393,89,5355
1/1/2023,VA,Virginia,Dickenson,51051,4811,1477,3334,3363,11,3352,1448,*,*,4625,1292,3333,4041,1266,2775,1142,205,38,2656
1/1/2023,VA,Virginia,Dinwiddie,51053,6366,3765,2601,5385,34,5351,981,31,950,5909,3308,2601,4727,2293,2434,1022,193,34,3478
1/1/2023,VA,Virginia,Emporia City,51595,1315,639,676,1074,14,1060,241,12,229,1224,548,676,1075,447,628,479,*,*,531
1/1/2023,VA,Virginia,Essex,51057,3121,1967,1154,2734,19,2715,387,13,374,2907,1753,1154,2349,1330,1019,522,81,30,1716
1/1/2023,VA,Virginia,Fairfax,51059,168491,119890,48601,160933,611,160322,7558,368,7190,137047,88477,48570,90932,48079,42853,16742,2521,477,71192
1/1/2023,VA,Virginia,Fairfax City,51600,4302,3051,1251,4073,16,4057,229,11,218,3569,2320,1249,2497,1443,1054,463,*,*,1967
1/1/2023,VA,Virginia,Falls Church City,51610,2264,1685,579,2189,*,*,75,*,*,1811,1232,579,1240,725,515,127,*,*,1097
1/1/2023,VA,Virginia,Fauquier,51061,14041,10532,3509,13093,57,13036,948,35,913,12405,8897,3508,8851,5952,2899,1078,177,44,7552
1/1/2023,VA,Virginia,Floyd,51063,4452,2847,1605,3947,14,3933,505,*,*,4157,2553,1604,3464,1956,1508,670,109,24,2661
1/1/2023,VA,Virginia,Fluvanna,51065,6998,5094,1904,6389,27,6362,609,17,592,6389,4486,1903,5030,3349,1681,687,111,25,4207
1/1/2023,VA,Virginia,Franklin,51067,15942,9347,6595,13868,61,13807,2074,34,2040,15030,8435,6595,12803,6764,6039,2224,444,112,10023
1/1/2023,VA,Virginia,Franklin City,51620,2186,1301,885,1823,17,1806,363,16,347,2064,1179,885,1775,932,843,568,*,*,1135
1/1/2023,VA,Virginia,Frederick,51069,18858,13462,5396,17141,67,17074,1717,47,1670,17132,11739,5393,12878,8222,4656,1681,365,95,10737
1/1/2023,VA,Virginia,Fredericksburg City,51630,4452,2961,1491,3822,24,3798,630,24,606,3981,2491,1490,2928,1539,1389,872,91,23,1942
1/1/2023,VA,Virginia,Galax City,51640,1695,1148,547,1396,*,*,299,*,*,1614,1067,547,1380,869,511,552,48,16,764
1/1/2023,VA,Virginia,Giles,51071,4513,2757,1756,3720,12,3708,793,15,778,4265,2509,1756,3708,2155,1553,782,103,24,2799
1/1/2023,VA,Virginia,Gloucester,51073,9827,6765,3062,8778,42,8736,1049,21,1028,9137,6075,3062,6398,3620,2778,1140,172,50,5036
1/1/2023,VA,Virginia,Goochland,51075,7119,5047,2072,6680,33,6647,439,*,*,6545,4473,2072,5665,3826,1839,475,100,15,5075
1/1/2023,VA,Virginia,Grayson,51077,4710,2975,1735,4004,14,3990,706,*,*,4512,2778,1734,3724,2095,1629,947,170,63,2544
1/1/2023,VA,Virginia,Greene,51079,4458,3229,1229,3984,14,3970,474,*,*,4052,2823,1229,3147,2017,1130,529,89,16,2513
1/1/2023,VA,Virginia,Greensville,51081,2247,1151,1096,1866,20,1846,381,11,370,2070,975,1095,1786,786,1000,479,102,21,1184
1/1/2023,VA,Virginia,Halifax,51083,10082,6344,3738,8563,57,8506,1519,53,1466,9490,5752,3738,8041,4560,3481,2146,400,110,5385
1/1/2023,VA,Virginia,Hampton City,51650,26938,15195,11743,23034,233,22801,3904,184,3720,24627,12887,11740,16748,5894,10854,4452,764,126,11406
1/1/2023,VA,Virginia,Hanover,51085,24303,15902,8401,22542,96,22446,1761,48,1713,22310,13914,8396,18970,11547,7423,1720,297,59,16894
1/1/2023,VA,Virginia,Harrisonburg City,51660,5735,4096,1639,4973,25,4948,762,19,743,5270,3631,1639,4474,2955,1519,1080,137,36,3221
1/1/2023,VA,Virginia,Henrico,51087,62284,37657,24627,55880,382,55498,6404,284,6120,56636,32014,24622,48812,26212,22600,7753,1329,249,39481
1/1/2023,VA,Virginia,Henry,51089,14825,7565,7260,12193,87,12106,2632,66,2566,14083,6825,7258,12557,5687,6870,3205,684,152,8516
1/1/2023,VA,Virginia,Highland,51091,904,680,224,829,*,*,75,0,75,863,639,224,694,497,197,83,*,*,587
1/1/2023,VA,Virginia,Hopewell City,51670,4612,2620,1992,3721,30,3691,891,32,859,4277,2285,1992,3271,1376,1895,1148,139,24,1960
1/1/2023,VA,Virginia,Isle of Wight,51093,9375,6188,3187,8421,57,8364,954,34,920,8669,5483,3186,6435,3463,2972,1104,180,57,5094
1/1/2023,VA,Virginia,James City,51095,23062,17318,5744,21852,57,21795,1210,35,1175,21408,15668,5740,14855,10032,4823,1139,207,39,13470
1/1/2023,VA,Virginia,King and Queen,51097,1888,1213,675,1653,*,*,235,*,*,1776,1101,675,1433,823,610,313,*,*,1055
1/1/2023,VA,Virginia,King George,51099,4549,3357,1192,4046,24,4022,503,18,485,3950,2758,1192,2268,1167,1101,519,84,21,1644
1/1/2023,VA,Virginia,King William,51101,3883,2522,1361,3419,30,3389,464,18,446,3602,2241,1361,3061,1799,1262,474,92,17,2478
1/1/2023,VA,Virginia,Lancaster,51103,4475,3218,1257,4173,20,4153,302,*,*,4187,2931,1256,3277,2206,1071,504,91,13,2669
1/1/2023,VA,Virginia,Lee,51105,6444,2176,4268,4765,25,4740,1679,16,1663,6143,1879,4264,5279,1401,3878,1955,217,56,3051
1/1/2023,VA,Virginia,Lexington City,51678,1341,992,349,1236,12,1224,105,*,*,1238,890,348,1003,680,323,181,*,*,784
1/1/2023,VA,Virginia,Loudoun,51107,46436,32826,13610,44106,159,43947,2330,112,2218,38676,25077,13599,28147,16145,12002,4263,672,139,23073
1/1/2023,VA,Virginia,Louisa,51109,9718,6318,3400,8510,49,8461,1208,27,1181,8910,5511,3399,7088,4009,3079,1301,221,50,5516
1/1/2023,VA,Virginia,Lunenburg,51111,3259,1956,1303,2789,17,2772,470,*,*,3065,1762,1303,2506,1291,1215,798,119,24,1565
1/1/2023,VA,Virginia,Lynchburg City,51680,14975,8993,5982,12647,93,12554,2328,79,2249,13964,7983,5981,12037,6451,5586,3121,405,106,8405
1/1/2023,VA,Virginia,Madison,51113,3550,2537,1013,3218,*,*,332,*,*,3290,2278,1012,2587,1712,875,438,82,18,2049
1/1/2023,VA,Virginia,Manassas City,51683,5162,3367,1795,4710,23,4687,452,32,420,4354,2560,1794,3299,1675,1624,658,94,16,2531
1/1/2023,VA,Virginia,Manassas Park City,51685,1459,809,650,1284,16,1268,175,11,164,1237,587,650,981,372,609,251,*,*,679
1/1/2023,VA,Virginia,Martinsville City,51690,3802,1892,1910,2982,36,2946,820,27,793,3598,1688,1910,3197,1370,1827,1300,147,31,1719
1/1/2023,VA,Virginia,Mathews,51115,3056,2203,853,2819,18,2801,237,*,*,2873,2020,853,2205,1462,743,318,44,12,1831
1/1/2023,VA,Virginia,Mecklenburg,51117,9650,5892,3758,8259,54,8205,1391,42,1349,9071,5313,3758,7547,4098,3449,1858,387,70,5232
1/1/2023,VA,Virginia,Middlesex,51119,3799,2657,1142,3486,13,3473,313,*,*,3574,2432,1142,2844,1845,999,481,70,12,2281
1/1/2023,VA,Virginia,Montgomery,51121,14896,10085,4811,12879,69,12810,2017,28,1989,13516,8706,4810,11677,7194,4483,2089,311,66,9211
1/1/2023,VA,Virginia,Nelson,51125,5000,3524,1476,4557,17,4540,443,*,*,4679,3204,1475,3635,2308,1327,606,100,21,2908
1/1/2023,VA,Virginia,New Kent,51127,5637,3899,1738,5157,25,5132,480,16,464,5176,3438,1738,3928,2454,1474,385,87,16,3440
1/1/2023,VA,Virginia,Newport News City,51700,30829,17292,13537,26035,215,25820,4794,216,4578,28248,14713,13535,20315,7627,12688,6044,878,151,13242
1/1/2023,VA,Virginia,Norfolk City,51710,35423,19486,15937,29754,282,29472,5669,306,5363,31966,16033,15933,23723,8598,15125,8416,1290,209,13808
1/1/2023,VA,Virginia,Northampton,51131,4025,2461,1564,3618,20,3598,407,22,385,3767,2203,1564,3185,1750,1435,930,83,21,2151
1/1/2023,VA,Virginia,Northumberland,51133,4932,3494,1438,4601,17,4584,331,13,318,4586,3148,1438,3408,2226,1182,495,74,16,2823
1/1/2023,VA,Virginia,Norton City,51720,1087,425,662,796,*,*,291,*,*,1018,356,662,904,297,607,346,*,*,503
1/1/2023,VA,Virginia,Nottoway,51135,3665,2270,1395,3080,21,3059,585,15,570,3425,2030,1395,2808,1521,1287,869,124,33,1782
1/1/2023,VA,Virginia,Orange,51137,9446,6502,2944,8514,46,8468,932,24,908,8620,5676,2944,6360,3766,2594,1081,203,44,5032
1/1/2023,VA,Virginia,Page,51139,6448,4484,1964,5482,23,5459,966,17,949,6029,4065,1964,4786,2996,1790,1167,233,47,3339
1/1/2023,VA,Virginia,Patrick,51141,5557,3222,2335,4738,19,4719,819,*,*,5287,2954,2333,4517,2331,2186,1088,184,47,3198
1/1/2023,VA,Virginia,Petersburg City,51730,7146,3408,3738,5551,87,5464,1595,79,1516,6561,2824,3737,5313,1756,3557,2337,292,53,2631
1/1/2023,VA,Virginia,Pittsylvania,51143,17069,9376,7693,14517,109,14408,2552,63,2489,16151,8458,7693,14082,7825,6257,3272,508,129,10173
1/1/2023,VA,Virginia,Poquoson City,51735,2718,2106,612,2559,*,*,159,*,*,2493,1881,612,1452,895,557,130,*,*,1290
1/1/2023,VA,Virginia,Portsmouth City,51740,18947,10319,8628,15381,177,15204,3566,178,3388,17104,8478,8626,12480,4259,8221,4501,709,98,7172
1/1/2023,VA,Virginia,Powhatan,51145,6995,4847,2148,6453,13,6440,542,13,529,6467,4319,2148,5428,3498,1930,469,99,24,4836
1/1/2023,VA,Virginia,Prince Edward,51147,4889,2961,1928,4106,33,4073,783,26,757,4547,2619,1928,3776,1977,1799,1112,157,42,2465
1/1/2023,VA,Virginia,Prince George,51149,6792,4838,1954,5866,27,5839,926,31,895,6274,4320,1954,4202,2441,1761,724,124,27,3327
1/1/2023,VA,Virginia,Prince William,51153,57164,38713,18451,52407,293,52114,4757,262,4495,48793,30351,18442,31494,14753,16741,6639,1149,192,23514
1/1/2023,VA,Virginia,Pulaski,51155,9265,5436,3829,7634,35,7599,1631,28,1603,8646,4817,3829,7393,3859,3534,1648,251,63,5431
1/1/2023,VA,Virginia,Radford City,51750,2178,1392,786,1817,*,*,361,13,348,1974,1188,786,1736,995,741,368,50,17,1301
1/1/2023,VA,Virginia,Rappahannock,51157,2151,1644,507,2030,*,*,121,*,*,1953,1447,506,1457,1036,421,168,37,11,1241
1/1/2023,VA,Virginia,Richmond,51159,2054,1354,700,1830,11,1819,224,*,*,1914,1214,700,1530,928,602,374,59,11,1086
1/1/2023,VA,Virginia,Richmond City,51760,35135,17829,17306,29332,292,29040,5803,241,5562,31894,14593,17301,28297,11812,16485,9513,1219,185,17380
1/1/2023,VA,Virginia,Roanoke,51161,24925,16108,8817,22530,99,22431,2395,50,2345,23076,14263,8813,19556,11628,7928,2317,450,112,16677
1/1/2023,VA,Virginia,Roanoke City,51770,21356,11197,10159,17139,137,17002,4217,125,4092,19623,9465,10158,16924,7400,9524,5101,858,156,10809
1/1/2023,VA,Virginia,Rockbridge,51163,6777,4693,2084,5935,16,5919,842,*,*,6329,4245,2084,5049,3157,1892,942,168,50,3889
1/1/2023,VA,Virginia,Rockingham,51165,19295,14011,5284,17419,53,17366,1876,35,1841,17932,12648,5284,15008,10191,4817,1957,445,108,12498
1/1/2023,VA,Virginia,Russell,51167,7967,3130,4837,5991,21,5970,1976,20,1956,7656,2821,4835,6806,2973,3833,1755,300,80,4671
1/1/2023,VA,Virginia,Salem City,51775,6193,4027,2166,5420,31,5389,773,18,755,5681,3516,2165,4776,2768,2008,818,112,30,3816
1/1/2023,VA,Virginia,Scott,51169,6751,2223,4528,5328,13,5315,1423,12,1411,6474,1946,4528,5807,1539,4268,1571,247,76,3913
1/1/2023,VA,Virginia,Shenandoah,51171,11274,7802,3472,10215,27,10188,1059,17,1042,10544,7073,3471,8185,5120,3065,1371,274,62,6478
1/1/2023,VA,Virginia,Smyth,51173,8556,4591,3965,6673,21,6652,1883,19,1864,8125,4160,3965,6976,3231,3745,2140,311,95,4430
1/1/2023,VA,Virginia,Southampton,51175,4251,2768,1483,3673,33,3640,578,23,555,3954,2471,1483,3236,1872,1364,736,134,26,2340
1/1/2023,VA,Virginia,Spotsylvania,51177,24741,16749,7992,22174,127,22047,2567,94,2473,21988,13998,7990,14692,7450,7242,2566,491,106,11529
1/1/2023,VA,Virginia,Stafford,51179,20708,15088,5620,18791,127,18664,1917,88,1829,18194,12580,5614,10518,5512,5006,1873,382,71,8192
1/1/2023,VA,Virginia,Staunton City,51790,6449,4453,1996,5549,26,5523,900,16,884,6085,4089,1996,5044,3192,1852,1166,129,45,3704
1/1/2023,VA,Virginia,Suffolk City,51800,18643,11630,7013,15905,143,15762,2738,118,2620,17091,10080,7011,12184,5644,6540,3032,496,79,8577
1/1/2023,VA,Virginia,Surry,51181,1856,1123,733,1636,16,1620,220,*,*,1708,975,733,1355,656,699,257,50,13,1035
1/1/2023,VA,Virginia,Sussex,51183,2545,1381,1164,2149,16,2133,396,16,380,2393,1229,1164,1972,884,1088,540,134,17,1281
1/1/2023,VA,Virginia,Tazewell,51185,11890,5866,6024,9276,36,9240,2614,33,2581,11357,5336,6021,9524,4688,4836,2419,468,103,6534
1/1/2023,VA,Virginia,Unknown,51999,*,*,*,*,*,*,*,*,*,*,*,*,*,*,*,*,*,*,*
1/1/2023,VA,Virginia,Virginia Beach City,51810,80332,55207,25125,72610,374,72236,7722,312,7410,73647,48541,25106,46521,23564,22957,8153,1519,297,36552
1/1/2023,VA,Virginia,Warren,51187,8786,6015,2771,7823,23,7800,963,20,943,7997,5226,2771,5963,3579,2384,1082,192,61,4628
1/1/2023,VA,Virginia,Washington,51191,15675,7674,8001,13151,32,13119,2524,27,2497,14859,6862,7997,12814,5468,7346,2563,561,117,9573
1/1/2023,VA,Virginia,Waynesboro City,51820,5191,3508,1683,4455,26,4429,736,16,720,4865,3182,1683,4103,2492,1611,934,119,38,3012
1/1/2023,VA,Virginia,Westmoreland,51193,5546,3850,1696,5007,27,4980,539,19,520,5038,3342,1696,3581,2053,1528,862,141,29,2549
1/1/2023,VA,Virginia,Williamsburg City,51830,3123,2169,954,2872,*,*,251,*,*,2881,1927,954,2181,1326,855,320,*,*,1815
1/1/2023,VA,Virginia,Winchester City,51840,5674,3984,1690,4947,20,4927,727,21,706,5183,3493,1690,4063,2547,1516,984,135,32,2912
1/1/2023,VA,Virginia,Wise,51195,10548,3686,6862,7643,29,7614,2905,32,2873,10015,3154,6861,8461,2529,5932,2535,444,103,5379
1/1/2023,VA,Virginia,Wythe,51197,8082,4327,3755,6510,34,6476,1572,14,1558,7654,3900,3754,6584,3086,3498,1723,292,64,4505
1/1/2023,VA,Virginia,York,51199,13537,10158,3379,12588,41,12547,949,41,908,12393,9015,3378,7183,4177,3006,849,157,37,6140
3/1/2023,VA,Virginia,Accomack,51001,9809,6450,3359,8655,48,8607,1154,39,1115,9092,5736,3356,7150,4163,2987,1756,346,63,4985
3/1/2023,VA,Virginia,Albemarle,51003,24148,19066,5082,22652,53,22599,1496,53,1443,21978,16902,5076,17829,13286,4543,1862,281,63,15623
3/1/2023,VA,Virginia,Alexandria City,51510,19424,14088,5336,18180,80,18100,1244,69,1175,15894,10565,5329,10726,5815,4911,2441,300,45,7940
3/1/2023,VA,Virginia,Alleghany,51005,4678,3047,1631,3884,18,3866,794,11,783,4448,2817,1631,3807,2359,1448,899,107,36,2765
3/1/2023,VA,Virginia,Amelia,51007,3371,1973,1398,2950,*,*,421,*,*,3127,1729,1398,2622,1303,1319,500,91,18,2013
3/1/2023,VA,Virginia,Amherst,51009,8233,5023,3210,7082,49,7033,1151,31,1120,7732,4524,3208,6592,3611,2981,1357,223,59,4953
3/1/2023,VA,Virginia,Appomattox,51011,4319,2703,1616,3621,19,3602,698,26,672,4054,2440,1614,3443,1945,1498,832,100,35,2476
3/1/2023,VA,Virginia,Arlington,51013,26376,19288,7088,24937,104,24833,1439,68,1371,21039,13953,7086,14189,7552,6637,3345,387,98,10359
3/1/2023,VA,Virginia,Augusta,51015,19781,14006,5775,17583,64,17519,2198,38,2160,18661,12886,5775,15497,10135,5362,2213,400,129,12755
3/1/2023,VA,Virginia,Bath,51017,1328,1014,314,1186,*,*,142,*,*,1271,958,313,1054,766,288,163,30,15,846
3/1/2023,VA,Virginia,Bedford,51019,21734,14178,7556,19228,65,19163,2506,48,2458,20359,12803,7556,16949,10299,6650,2305,479,129,14036
3/1/2023,VA,Virginia,Bland,51021,1865,1104,761,1546,*,*,319,*,*,1760,999,761,1440,792,648,233,54,11,1142
3/1/2023,VA,Virginia,Botetourt,51023,9284,5968,3316,8314,40,8274,970,18,952,8691,5375,3316,7221,4279,2942,820,160,36,6205
3/1/2023,VA,Virginia,Bristol City,51520,4444,1758,2686,3570,*,*,874,13,861,4192,1506,2686,3722,1152,2570,1138,139,28,2417
3/1/2023,VA,Virginia,Brunswick,51025,4250,2369,1881,3639,27,3612,611,17,594,3997,2117,1880,3360,1612,1748,1102,129,19,2110
3/1/2023,VA,Virginia,Buchanan,51027,6802,2667,4135,4688,19,4669,2114,14,2100,6556,2423,4133,5776,2446,3330,1661,354,77,3684
3/1/2023,VA,Virginia,Buckingham,51029,3884,2326,1558,3280,24,3256,604,18,586,3624,2068,1556,2991,1592,1399,869,133,31,1958
3/1/2023,VA,Virginia,Buena Vista City,51530,1475,901,574,1215,*,*,260,*,*,1379,805,574,1133,608,525,333,41,19,740
3/1/2023,VA,Virginia,Campbell,51031,13648,8176,5472,11709,72,11637,1939,56,1883,12822,7354,5468,11036,6012,5024,2296,367,112,8261
3/1/2023,VA,Virginia,Caroline,51033,6518,4023,2495,5683,28,5655,835,37,798,5931,3437,2494,4445,2162,2283,991,178,34,3242
3/1/2023,VA,Virginia,Carroll,51035,8764,5621,3143,7428,33,7395,1336,15,1321,8396,5253,3143,6963,4050,2913,1652,288,64,4959
3/1/2023,VA,Virginia,Charles City,51036,2049,1193,856,1805,18,1787,244,*,*,1892,1036,856,1545,771,774,297,75,11,1162
3/1/2023,VA,Virginia,Charlotte,51037,3259,2070,1189,2742,20,2722,517,13,504,3053,1864,1189,2551,1454,1097,723,124,23,1681
3/1/2023,VA,Virginia,Charlottesville City,51540,6329,4578,1751,5537,33,5504,792,25,767,5739,3992,1747,4872,3217,1655,1166,141,15,3550
3/1/2023,VA,Virginia,Chesapeake City,51550,43506,28215,15291,38596,273,38323,4910,175,4735,39547,24262,15285,25853,11774,14079,5064,938,170,19681
3/1/2023,VA,Virginia,Chesterfield,51041,69230,44152,25078,62399,242,62157,6831,220,6611,63070,38013,25057,51650,28594,23056,6907,970,190,43583
3/1/2023,VA,Virginia,Clarke,51043,3780,2839,941,3546,*,*,234,*,*,3426,2485,941,2533,1735,798,317,65,26,2125
3/1/2023,VA,Virginia,Colonial Heights City,51570,4096,2795,1301,3552,18,3534,544,11,533,3772,2471,1301,2706,1517,1189,567,103,13,2023
3/1/2023,VA,Virginia,Covington City,51580,1531,963,568,1188,*,*,343,*,*,1424,856,568,1225,679,546,363,*,*,807
3/1/2023,VA,Virginia,Craig,51045,1401,821,580,1157,*,*,244,*,*,1318,738,580,1112,587,525,220,*,*,837
3/1/2023,VA,Virginia,Culpeper,51047,10519,7392,3127,9401,41,9360,1118,29,1089,9572,6446,3126,7298,4635,2663,1362,233,58,5645
3/1/2023,VA,Virginia,Cumberland,51049,2417,1439,978,2075,12,2063,342,*,*,2248,1270,978,1894,989,905,475,84,19,1316
3/1/2023,VA,Virginia,Danville City,51590,11046,5405,5641,8984,88,8896,2062,95,1967,10426,4787,5639,9281,4568,4713,3455,393,90,5343
3/1/2023,VA,Virginia,Dickenson,51051,4807,1464,3343,3347,11,3336,1460,*,*,4620,1280,3340,4032,1244,2788,1139,203,38,2652
3/1/2023,VA,Virginia,Dinwiddie,51053,6370,3737,2633,5378,33,5345,992,30,962,5937,3304,2633,4752,2285,2467,1040,189,33,3490
3/1/2023,VA,Virginia,Emporia City,51595,1312,637,675,1070,14,1056,242,12,230,1229,554,675,1069,442,627,476,*,*,529
3/1/2023,VA,Virginia,Essex,51057,3126,1955,1171,2742,18,2724,384,13,371,2916,1746,1170,2364,1330,1034,527,79,29,1729
3/1/2023,VA,Virginia,Fairfax,51059,169170,119850,49320,161568,592,160976,7602,367,7235,138331,89065,49266,91779,48230,43549,17039,2530,486,71724
3/1/2023,VA,Virginia,Fairfax City,51600,4311,3037,1274,4080,15,4065,231,11,220,3597,2325,1272,2517,1437,1080,475,*,*,1977
3/1/2023,VA,Virginia,Falls Church City,51610,2273,1693,580,2199,*,*,74,*,*,1835,1256,579,1246,730,516,131,*,*,1098
3/1/2023,VA,Virginia,Fauquier,51061,14072,10507,3565,13121,55,13066,951,35,916,12457,8897,3560,8886,5933,2953,1105,179,41,7561
3/1/2023,VA,Virginia,Floyd,51063,4462,2838,1624,3952,14,3938,510,*,*,4180,2557,1623,3489,1962,1527,681,108,25,2675
3/1/2023,VA,Virginia,Fluvanna,51065,7031,5112,1919,6413,27,6386,618,17,601,6445,4528,1917,5068,3367,1701,698,114,24,4232
3/1/2023,VA,Virginia,Franklin,51067,15949,9321,6628,13868,58,13810,2081,33,2048,15060,8432,6628,12827,6754,6073,2244,442,105,10036
3/1/2023,VA,Virginia,Franklin City,51620,2186,1297,889,1819,17,1802,367,17,350,2067,1178,889,1779,933,846,576,*,*,1134
3/1/2023,VA,Virginia,Frederick,51069,18907,13484,5423,17182,65,17117,1725,47,1678,17233,11816,5417,12943,8253,4690,1701,364,93,10785
3/1/2023,VA,Virginia,Fredericksburg City,51630,4453,2955,1498,3822,24,3798,631,24,607,4004,2508,1496,2933,1530,1403,876,90,26,1941
3/1/2023,VA,Virginia,Galax City,51640,1694,1136,558,1392,*,*,302,*,*,1613,1055,558,1384,860,524,561,49,16,758
3/1/2023,VA,Virginia,Giles,51071,4508,2750,1758,3714,12,3702,794,14,780,4266,2508,1758,3715,2157,1558,789,102,24,2800
3/1/2023,VA,Virginia,Gloucester,51073,9862,6769,3093,8807,41,8766,1055,21,1034,9181,6088,3093,6427,3619,2808,1165,169,49,5044
3/1/2023,VA,Virginia,Goochland,51075,7133,5044,2089,6696,31,6665,437,*,*,6579,4491,2088,5685,3829,1856,474,94,15,5102
3/1/2023,VA,Virginia,Grayson,51077,4695,2955,1740,3987,13,3974,708,*,*,4508,2769,1739,3718,2081,1637,951,163,62,2542
3/1/2023,VA,Virginia,Greene,51079,4458,3210,1248,3984,13,3971,474,*,*,4057,2810,1247,3159,2010,1149,536,92,14,2517
3/1/2023,VA,Virginia,Greensville,51081,2241,1137,1104,1855,19,1836,386,12,374,2078,975,1103,1790,779,1011,483,101,22,1184
3/1/2023,VA,Virginia,Halifax,51083,10104,6336,3768,8566,53,8513,1538,53,1485,9516,5749,3767,8053,4547,3506,2166,393,110,5384
3/1/2023,VA,Virginia,Hampton City,51650,26971,15114,11857,23034,215,22819,3937,180,3757,24726,12876,11850,16819,5883,10936,4512,765,125,11417
3/1/2023,VA,Virginia,Hanover,51085,24340,15894,8446,22579,91,22488,1761,49,1712,22408,13971,8437,19030,11566,7464,1732,295,58,16945
3/1/2023,VA,Virginia,Harrisonburg City,51660,5720,4041,1679,4960,24,4936,760,19,741,5268,3590,1678,4478,2918,1560,1084,137,37,3220
3/1/2023,VA,Virginia,Henrico,51087,62320,37540,24780,55876,372,55504,6444,280,6164,56844,32079,24765,48933,26169,22764,7843,1314,250,39526
3/1/2023,VA,Virginia,Henry,51089,14854,7560,7294,12199,85,12114,2655,67,2588,14126,6835,7291,12578,5686,6892,3252,676,145,8505
3/1/2023,VA,Virginia,Highland,51091,911,687,224,836,*,*,75,0,75,867,643,224,700,504,196,86,*,*,590
3/1/2023,VA,Virginia,Hopewell City,51670,4618,2608,2010,3726,27,3699,892,31,861,4280,2270,2010,3290,1377,1913,1165,139,25,1961
3/1/2023,VA,Virginia,Isle of Wight,51093,9373,6147,3226,8415,55,8360,958,34,924,8688,5464,3224,6456,3444,3012,1111,180,57,5108
3/1/2023,VA,Virginia,James City,51095,23077,17313,5764,21854,55,21799,1223,35,1188,21474,15717,5757,14889,10040,4849,1160,207,37,13485
3/1/2023,VA,Virginia,King and Queen,51097,1903,1217,686,1665,*,*,238,*,*,1794,1108,686,1449,831,618,319,*,*,1064
3/1/2023,VA,Virginia,King George,51099,4552,3348,1204,4049,24,4025,503,18,485,3965,2762,1203,2271,1161,1110,526,84,20,1641
3/1/2023,VA,Virginia,King William,51101,3883,2510,1373,3418,29,3389,465,17,448,3606,2235,1371,3053,1782,1271,474,93,17,2469
3/1/2023,VA,Virginia,Lancaster,51103,4459,3188,1271,4159,19,4140,300,*,*,4184,2915,1269,3274,2188,1086,504,92,13,2665
3/1/2023,VA,Virginia,Lee,51105,6415,2140,4275,4731,23,4708,1684,15,1669,6113,1842,4271,5267,1370,3897,1955,214,58,3040
3/1/2023,VA,Virginia,Lexington City,51678,1341,987,354,1237,12,1225,104,*,*,1238,885,353,1003,675,328,183,*,*,783
3/1/2023,VA,Virginia,Loudoun,51107,46602,32835,13767,44254,156,44098,2348,111,2237,39029,25285,13744,28361,16201,12160,4338,678,139,23206
3/1/2023,VA,Virginia,Louisa,51109,9747,6332,3415,8536,47,8489,1211,27,1184,8953,5539,3414,7119,4019,3100,1319,223,51,5526
3/1/2023,VA,Virginia,Lunenburg,51111,3255,1939,1316,2781,17,2764,474,*,*,3064,1749,1315,2509,1278,1231,805,120,24,1560
3/1/2023,VA,Virginia,Lynchburg City,51680,14963,8902,6061,12619,92,12527,2344,80,2264,13969,7909,6060,12052,6381,5671,3165,400,107,8380
3/1/2023,VA,Virginia,Madison,51113,3557,2528,1029,3225,*,*,332,*,*,3306,2278,1028,2595,1703,892,442,82,18,2053
3/1/2023,VA,Virginia,Manassas City,51683,5167,3343,1824,4712,21,4691,455,32,423,4387,2567,1820,3318,1669,1649,663,96,16,2543
3/1/2023,VA,Virginia,Manassas Park City,51685,1463,804,659,1285,17,1268,178,11,167,1256,597,659,998,381,617,256,*,*,690
3/1/2023,VA,Virginia,Martinsville City,51690,3799,1847,1952,2978,32,2946,821,27,794,3596,1645,1951,3205,1337,1868,1317,147,34,1707
3/1/2023,VA,Virginia,Mathews,51115,3063,2212,851,2827,17,2810,236,*,*,2878,2027,851,2206,1464,742,320,43,11,1832
3/1/2023,VA,Virginia,Mecklenburg,51117,9648,5858,3790,8259,53,8206,1389,39,1350,9084,5295,3789,7547,4059,3488,1859,386,67,5235
3/1/2023,VA,Virginia,Middlesex,51119,3803,2648,1155,3486,13,3473,317,*,*,3586,2431,1155,2857,1843,1014,492,68,12,2285
3/1/2023,VA,Virginia,Montgomery,51121,14900,10077,4823,12874,66,12808,2026,28,1998,13542,8721,4821,11693,7201,4492,2095,300,68,9230
3/1/2023,VA,Virginia,Nelson,51125,5005,3514,1491,4558,16,4542,447,*,*,4695,3205,1490,3642,2298,1344,613,99,20,2910
3/1/2023,VA,Virginia,New Kent,51127,5657,3913,1744,5173,25,5148,484,17,467,5212,3469,1743,3943,2460,1483,392,86,16,3449
3/1/2023,VA,Virginia,Newport News City,51700,30917,17204,13713,26084,207,25877,4833,212,4621,28459,14758,13701,20469,7617,12852,6168,865,152,13284
3/1/2023,VA,Virginia,Norfolk City,51710,35483,19408,16075,29773,274,29499,5710,297,5413,32154,16090,16064,23834,8576,15258,8529,1275,198,13832
3/1/2023,VA,Virginia,Northampton,51131,4030,2452,1578,3620,20,3600,410,22,388,3792,2214,1578,3201,1750,1451,934,82,19,2166
3/1/2023,VA,Virginia,Northumberland,51133,4941,3484,1457,4608,17,4591,333,13,320,4613,3156,1457,3425,2226,1199,510,75,15,2825
3/1/2023,VA,Virginia,Norton City,51720,1095,426,669,802,*,*,293,*,*,1029,360,669,915,299,616,351,*,*,508
3/1/2023,VA,Virginia,Nottoway,51135,3667,2244,1423,3080,20,3060,587,15,572,3432,2009,1423,2818,1503,1315,877,120,32,1789
3/1/2023,VA,Virginia,Orange,51137,9464,6497,2967,8526,46,8480,938,23,915,8652,5685,2967,6376,3762,2614,1090,200,45,5041
3/1/2023,VA,Virginia,Page,51139,6441,4445,1996,5468,22,5446,973,16,957,6032,4037,1995,4798,2975,1823,1180,232,48,3338
3/1/2023,VA,Virginia,Patrick,51141,5585,3239,2346,4760,19,4741,825,*,*,5309,2967,2342,4532,2336,2196,1107,182,46,3197
3/1/2023,VA,Virginia,Petersburg City,51730,7153,3347,3806,5553,82,5471,1600,77,1523,6597,2795,3802,5336,1712,3624,2370,291,54,2621
3/1/2023,VA,Virginia,Pittsylvania,51143,17071,9331,7740,14497,104,14393,2574,65,2509,16179,8441,7738,14106,7808,6298,3318,509,128,10151
3/1/2023,VA,Virginia,Poquoson City,51735,2724,2121,603,2565,*,*,159,*,*,2500,1897,603,1450,901,549,132,*,*,1286
3/1/2023,VA,Virginia,Portsmouth City,51740,18914,10157,8757,15343,167,15176,3571,174,3397,17147,8396,8751,12503,4164,8339,4535,703,103,7162
3/1/2023,VA,Virginia,Powhatan,51145,7017,4866,2151,6472,14,6458,545,13,532,6495,4344,2151,5443,3509,1934,479,99,23,4842
3/1/2023,VA,Virginia,Prince Edward,51147,4886,2963,1923,4100,33,4067,786,26,760,4550,2627,1923,3780,1986,1794,1114,153,41,2472
3/1/2023,VA,Virginia,Prince George,51149,6808,4834,1974,5880,25,5855,928,31,897,6319,4346,1973,4236,2452,1784,731,122,28,3355
3/1/2023,VA,Virginia,Prince William,51153,57336,38578,18758,52540,280,52260,4796,258,4538,49274,30533,18741,31799,14753,17046,6793,1137,196,23673
3/1/2023,VA,Virginia,Pulaski,51155,9237,5373,3864,7609,33,7576,1628,28,1600,8639,4776,3863,7391,3814,3577,1647,250,63,5431
3/1/2023,VA,Virginia,Radford City,51750,2175,1377,798,1817,*,*,358,13,345,1979,1181,798,1739,986,753,372,49,17,1301
3/1/2023,VA,Virginia,Rappahannock,51157,2149,1640,509,2029,*,*,120,*,*,1956,1448,508,1462,1040,422,171,36,11,1244
3/1/2023,VA,Virginia,Richmond,51159,2049,1345,704,1825,11,1814,224,*,*,1913,1210,703,1532,925,607,375,58,12,1087
3/1/2023,VA,Virginia,Richmond City,51760,35145,17708,17437,29325,281,29044,5820,236,5584,32061,14640,17421,28399,11791,16608,9595,1212,181,17411
3/1/2023,VA,Virginia,Roanoke,51161,24950,16100,8850,22536,95,22441,2414,48,2366,23138,14296,8842,19595,11637,7958,2358,449,108,16680
3/1/2023,VA,Virginia,Roanoke City,51770,21330,11124,10206,17097,131,16966,4233,126,4107,19636,9436,10200,16920,7343,9577,5138,854,158,10770
3/1/2023,VA,Virginia,Rockbridge,51163,6791,4684,2107,5944,16,5928,847,*,*,6344,4238,2106,5070,3153,1917,966,172,47,3885
3/1/2023,VA,Virginia,Rockingham,51165,19330,14002,5328,17447,52,17395,1883,31,1852,17996,12669,5327,15044,10188,4856,1978,442,108,12516
3/1/2023,VA,Virginia,Russell,51167,7967,3110,4857,5977,17,5960,1990,19,1971,7660,2806,4854,6817,2957,3860,1769,298,78,4672
3/1/2023,VA,Virginia,Salem City,51775,6179,3997,2182,5407,30,5377,772,18,754,5682,3502,2180,4785,2758,2027,822,112,30,3821
3/1/2023,VA,Virginia,Scott,51169,6710,2174,4536,5283,11,5272,1427,11,1416,6440,1906,4534,5785,1507,4278,1568,241,75,3901
3/1/2023,VA,Virginia,Shenandoah,51171,11251,7765,3486,10195,25,10170,1056,16,1040,10539,7054,3485,8178,5096,3082,1377,270,60,6471
3/1/2023,VA,Virginia,Smyth,51173,8537,4559,3978,6652,21,6631,1885,20,1865,8119,4141,3978,6968,3206,3762,2131,312,96,4429
3/1/2023,VA,Virginia,Southampton,51175,4251,2760,1491,3671,32,3639,580,23,557,3960,2469,1491,3253,1878,1375,745,133,26,2349
3/1/2023,VA,Virginia,Spotsylvania,51177,24793,16721,8072,22210,121,22089,2583,94,2489,22104,14038,8066,14731,7417,7314,2601,491,102,11537
3/1/2023,VA,Virginia,Stafford,51179,20766,15084,5682,18838,117,18721,1928,88,1840,18307,12636,5671,10561,5500,5061,1889,387,71,8214
3/1/2023,VA,Virginia,Staunton City,51790,6447,4434,2013,5547,26,5521,900,16,884,6089,4076,2013,5038,3171,1867,1171,126,44,3697
3/1/2023,VA,Virginia,Suffolk City,51800,18695,11608,7087,15941,140,15801,2754,117,2637,17207,10126,7081,12225,5611,6614,3079,490,77,8579
3/1/2023,VA,Virginia,Surry,51181,1865,1119,746,1645,15,1630,220,*,*,1720,974,746,1366,656,710,259,52,11,1044
3/1/2023,VA,Virginia,Sussex,51183,2541,1369,1172,2143,14,2129,398,16,382,2387,1217,1170,1977,877,1100,543,130,17,1287
3/1/2023,VA,Virginia,Tazewell,51185,11867,5814,6053,9244,36,9208,2623,32,2591,11343,5297,6046,9524,4653,4871,2434,461,105,6524
3/1/2023,VA,Virginia,Unknown,51999,*,*,*,*,*,*,*,*,*,*,*,*,*,*,*,*,*,*,*
3/1/2023,VA,Virginia,Virginia Beach City,51810,80506,55160,25346,72752,363,72389,7754,312,7442,74064,48746,25318,46718,23551,23167,8280,1502,284,36652
3/1/2023,VA,Virginia,Warren,51187,8801,5983,2818,7829,21,7808,972,20,952,8049,5233,2816,6012,3584,2428,1103,195,61,4653
3/1/2023,VA,Virginia,Washington,51191,15646,7613,8033,13105,28,13077,2541,27,2514,14864,6834,8030,12823,5447,7376,2598,548,114,9563
3/1/2023,VA,Virginia,Waynesboro City,51820,5184,3499,1685,4446,23,4423,738,16,722,4872,3189,1683,4103,2490,1613,939,114,37,3013
3/1/2023,VA,Virginia,Westmoreland,51193,5551,3846,1705,5006,24,4982,545,19,526,5052,3347,1705,3596,2054,1542,866,140,30,2560
3/1/2023,VA,Virginia,Williamsburg City,51830,3119,2166,953,2867,*,*,252,*,*,2888,1935,953,2179,1325,854,320,*,*,1814
3/1/2023,VA,Virginia,Winchester City,51840,5685,3984,1701,4955,19,4936,730,21,709,5198,3498,1700,4069,2544,1525,986,131,32,2920
3/1/2023,VA,Virginia,Wise,51195,10526,3638,6888,7606,28,7578,2920,31,2889,10006,3120,6886,8455,2492,5963,2549,440,109,5357
3/1/2023,VA,Virginia,Wythe,51197,8098,4307,3791,6524,33,6491,1574,14,1560,7683,3893,3790,6602,3074,3528,1742,293,62,4505
3/1/2023,VA,Virginia,York,51199,13567,10146,3421,12615,39,12576,952,41,911,12452,9031,3421,7228,4182,3046,864,158,36,6170
